filename,width,height,class,xmin,ymin,xmax,ymax,centerx,centery,b-width,b-height
../../CUB_200_2011/images\001.Black_footed_Albatross/Black_Footed_Albatross_0046_18.jpg,500,335,001.Black_footed_Albatross,60,27,385,331,222,179,325,304
../../CUB_200_2011/images\001.Black_footed_Albatross/Black_Footed_Albatross_0009_34.jpg,500,336,001.Black_footed_Albatross,139,30,292,294,215,162,153,264
../../CUB_200_2011/images\001.Black_footed_Albatross/Black_Footed_Albatross_0002_55.jpg,500,347,001.Black_footed_Albatross,14,112,402,298,208,205,388,186
../../CUB_200_2011/images\001.Black_footed_Albatross/Black_Footed_Albatross_0074_59.jpg,415,500,001.Black_footed_Albatross,112,90,367,332,239,211,255,242
../../CUB_200_2011/images\001.Black_footed_Albatross/Black_Footed_Albatross_0014_89.jpg,331,380,001.Black_footed_Albatross,70,50,204,353,137,201,134,303
../../CUB_200_2011/images\001.Black_footed_Albatross/Black_Footed_Albatross_0085_92.jpg,500,470,001.Black_footed_Albatross,33,53,284,448,158,250,251,395
../../CUB_200_2011/images\001.Black_footed_Albatross/Black_Footed_Albatross_0031_100.jpg,500,340,001.Black_footed_Albatross,7,75,427,337,217,206,420,262
../../CUB_200_2011/images\001.Black_footed_Albatross/Black_Footed_Albatross_0051_796103.jpg,500,391,001.Black_footed_Albatross,78,86,411,244,244,165,333,158
../../CUB_200_2011/images\001.Black_footed_Albatross/Black_Footed_Albatross_0010_796097.jpg,500,416,001.Black_footed_Albatross,112,76,333,265,222,170,221,189
../../CUB_200_2011/images\001.Black_footed_Albatross/Black_Footed_Albatross_0025_796057.jpg,250,208,001.Black_footed_Albatross,27,4,226,205,126,104,199,201
../../CUB_200_2011/images\001.Black_footed_Albatross/Black_Footed_Albatross_0023_796059.jpg,350,350,001.Black_footed_Albatross,1,52,343,312,172,182,342,260
../../CUB_200_2011/images\001.Black_footed_Albatross/Black_Footed_Albatross_0086_796062.jpg,420,280,001.Black_footed_Albatross,47,21,226,270,136,145,179,249
../../CUB_200_2011/images\001.Black_footed_Albatross/Black_Footed_Albatross_0049_796063.jpg,307,500,001.Black_footed_Albatross,36,32,233,489,134,260,197,457
../../CUB_200_2011/images\001.Black_footed_Albatross/Black_Footed_Albatross_0006_796065.jpg,350,350,001.Black_footed_Albatross,37,40,299,224,168,132,262,184
../../CUB_200_2011/images\001.Black_footed_Albatross/Black_Footed_Albatross_0040_796066.jpg,500,379,001.Black_footed_Albatross,23,80,418,317,220,198,395,237
../../CUB_200_2011/images\001.Black_footed_Albatross/Black_Footed_Albatross_0016_796067.jpg,500,357,001.Black_footed_Albatross,141,87,397,298,269,192,256,211
../../CUB_200_2011/images\001.Black_footed_Albatross/Black_Footed_Albatross_0065_796068.jpg,350,350,001.Black_footed_Albatross,40,38,294,247,167,142,254,209
../../CUB_200_2011/images\001.Black_footed_Albatross/Black_Footed_Albatross_0089_796069.jpg,500,334,001.Black_footed_Albatross,45,58,299,307,172,182,254,249
../../CUB_200_2011/images\001.Black_footed_Albatross/Black_Footed_Albatross_0042_796071.jpg,500,356,001.Black_footed_Albatross,135,83,439,264,287,173,304,181
../../CUB_200_2011/images\001.Black_footed_Albatross/Black_Footed_Albatross_0067_170.jpg,333,500,001.Black_footed_Albatross,23,195,278,317,150,256,255,122
../../CUB_200_2011/images\001.Black_footed_Albatross/Black_Footed_Albatross_0060_796076.jpg,320,240,001.Black_footed_Albatross,11,77,292,216,151,146,281,139
../../CUB_200_2011/images\001.Black_footed_Albatross/Black_Footed_Albatross_0090_796077.jpg,216,136,001.Black_footed_Albatross,5,4,215,134,110,69,210,130
../../CUB_200_2011/images\001.Black_footed_Albatross/Black_Footed_Albatross_0056_796078.jpg,500,390,001.Black_footed_Albatross,154,93,342,258,248,175,188,165
../../CUB_200_2011/images\001.Black_footed_Albatross/Black_Footed_Albatross_0061_796082.jpg,240,187,001.Black_footed_Albatross,50,25,206,164,128,94,156,139
../../CUB_200_2011/images\001.Black_footed_Albatross/Black_Footed_Albatross_0008_796083.jpg,500,357,001.Black_footed_Albatross,172,106,437,320,304,213,265,214
../../CUB_200_2011/images\001.Black_footed_Albatross/Black_Footed_Albatross_0033_796086.jpg,500,375,001.Black_footed_Albatross,37,61,446,241,241,151,409,180
../../CUB_200_2011/images\001.Black_footed_Albatross/Black_Footed_Albatross_0024_796089.jpg,500,414,001.Black_footed_Albatross,65,62,374,407,219,234,309,345
../../CUB_200_2011/images\001.Black_footed_Albatross/Black_Footed_Albatross_0005_796090.jpg,500,335,001.Black_footed_Albatross,1,2,500,288,250,145,499,286
../../CUB_200_2011/images\001.Black_footed_Albatross/Black_Footed_Albatross_0026_796095.jpg,500,332,001.Black_footed_Albatross,97,3,332,257,214,130,235,254
../../CUB_200_2011/images\001.Black_footed_Albatross/Black_Footed_Albatross_0080_796096.jpg,376,322,001.Black_footed_Albatross,90,29,314,240,202,134,224,211
../../CUB_200_2011/images\001.Black_footed_Albatross/Black_Footed_Albatross_0047_796064.jpg,500,360,001.Black_footed_Albatross,38,15,352,316,195,165,314,301
../../CUB_200_2011/images\001.Black_footed_Albatross/Black_Footed_Albatross_0017_796098.jpg,500,392,001.Black_footed_Albatross,20,91,436,294,228,192,416,203
../../CUB_200_2011/images\001.Black_footed_Albatross/Black_Footed_Albatross_0064_796101.jpg,400,333,001.Black_footed_Albatross,82,52,342,312,212,182,260,260
../../CUB_200_2011/images\001.Black_footed_Albatross/Black_Footed_Albatross_0076_417.jpg,500,441,001.Black_footed_Albatross,66,115,426,329,246,222,360,214
../../CUB_200_2011/images\001.Black_footed_Albatross/Black_Footed_Albatross_0019_796104.jpg,500,338,001.Black_footed_Albatross,19,18,483,312,251,165,464,294
../../CUB_200_2011/images\001.Black_footed_Albatross/Black_Footed_Albatross_0057_796106.jpg,500,337,001.Black_footed_Albatross,72,40,358,265,215,152,286,225
../../CUB_200_2011/images\001.Black_footed_Albatross/Black_Footed_Albatross_0041_796108.jpg,500,500,001.Black_footed_Albatross,216,119,437,273,326,196,221,154
../../CUB_200_2011/images\001.Black_footed_Albatross/Black_Footed_Albatross_0053_796109.jpg,455,450,001.Black_footed_Albatross,40,4,408,449,224,226,368,445
../../CUB_200_2011/images\001.Black_footed_Albatross/Black_Footed_Albatross_0001_796111.jpg,320,223,001.Black_footed_Albatross,69,57,268,198,168,127,199,141
../../CUB_200_2011/images\001.Black_footed_Albatross/Black_Footed_Albatross_0071_796113.jpg,389,500,001.Black_footed_Albatross,130,29,332,422,231,225,202,393
../../CUB_200_2011/images\001.Black_footed_Albatross/Black_Footed_Albatross_0077_796114.jpg,450,500,001.Black_footed_Albatross,53,46,355,363,204,204,302,317
../../CUB_200_2011/images\001.Black_footed_Albatross/Black_Footed_Albatross_0032_796115.jpg,500,383,001.Black_footed_Albatross,25,17,393,316,209,166,368,299
../../CUB_200_2011/images\001.Black_footed_Albatross/Black_Footed_Albatross_0038_212.jpg,500,332,001.Black_footed_Albatross,137,64,424,220,280,142,287,156
../../CUB_200_2011/images\001.Black_footed_Albatross/Black_Footed_Albatross_0037_796120.jpg,448,272,001.Black_footed_Albatross,111,42,244,261,177,151,133,219
../../CUB_200_2011/images\001.Black_footed_Albatross/Black_Footed_Albatross_0082_796121.jpg,500,375,001.Black_footed_Albatross,58,51,446,262,252,156,388,211
../../CUB_200_2011/images\001.Black_footed_Albatross/Black_Footed_Albatross_0079_796122.jpg,260,359,001.Black_footed_Albatross,13,28,225,311,119,169,212,283
../../CUB_200_2011/images\001.Black_footed_Albatross/Black_Footed_Albatross_0050_796125.jpg,500,275,001.Black_footed_Albatross,5,127,501,258,253,192,496,131
../../CUB_200_2011/images\001.Black_footed_Albatross/Black_Footed_Albatross_0078_796126.jpg,346,500,001.Black_footed_Albatross,113,260,240,390,176,325,127,130
../../CUB_200_2011/images\001.Black_footed_Albatross/Black_Footed_Albatross_0036_796127.jpg,500,375,001.Black_footed_Albatross,49,69,302,280,175,174,253,211
../../CUB_200_2011/images\001.Black_footed_Albatross/Black_Footed_Albatross_0045_796129.jpg,500,332,001.Black_footed_Albatross,24,144,457,274,240,209,433,130
../../CUB_200_2011/images\001.Black_footed_Albatross/Black_Footed_Albatross_0039_796132.jpg,500,500,001.Black_footed_Albatross,151,152,461,352,306,252,310,200
../../CUB_200_2011/images\001.Black_footed_Albatross/Black_Footed_Albatross_0088_796133.jpg,335,400,001.Black_footed_Albatross,157,45,260,369,208,207,103,324
../../CUB_200_2011/images\001.Black_footed_Albatross/Black_Footed_Albatross_0068_796135.jpg,500,385,001.Black_footed_Albatross,60,29,492,384,276,206,432,355
../../CUB_200_2011/images\001.Black_footed_Albatross/Black_Footed_Albatross_0003_796136.jpg,500,375,001.Black_footed_Albatross,131,36,343,340,237,188,212,304
../../CUB_200_2011/images\001.Black_footed_Albatross/Black_Footed_Albatross_0007_796138.jpg,500,301,001.Black_footed_Albatross,152,86,272,227,212,156,120,141
../../CUB_200_2011/images\001.Black_footed_Albatross/Black_Footed_Albatross_0069_796139.jpg,200,200,001.Black_footed_Albatross,2,45,191,165,96,105,189,120
../../CUB_200_2011/images\001.Black_footed_Albatross/Black_Footed_Albatross_0035_796140.jpg,500,333,001.Black_footed_Albatross,214,87,418,266,316,176,204,179
../../CUB_200_2011/images\001.Black_footed_Albatross/Black_Footed_Albatross_0063_796141.jpg,288,192,001.Black_footed_Albatross,46,24,243,141,144,82,197,117
../../CUB_200_2011/images\001.Black_footed_Albatross/Black_Footed_Albatross_0058_796074.jpg,500,334,001.Black_footed_Albatross,72,29,296,291,184,160,224,262
../../CUB_200_2011/images\001.Black_footed_Albatross/Black_Footed_Albatross_0081_426.jpg,500,320,001.Black_footed_Albatross,96,77,356,247,226,162,260,170
../../CUB_200_2011/images\002.Laysan_Albatross/Laysan_Albatross_0002_1027.jpg,500,375,002.Laysan_Albatross,144,40,477,205,310,122,333,165
../../CUB_200_2011/images\002.Laysan_Albatross/Laysan_Albatross_0003_1033.jpg,500,375,002.Laysan_Albatross,202,28,366,368,284,198,164,340
../../CUB_200_2011/images\002.Laysan_Albatross/Laysan_Albatross_0082_524.jpg,500,375,002.Laysan_Albatross,72,68,455,293,263,180,383,225
../../CUB_200_2011/images\002.Laysan_Albatross/Laysan_Albatross_0044_784.jpg,500,271,002.Laysan_Albatross,60,128,498,234,279,181,438,106
../../CUB_200_2011/images\002.Laysan_Albatross/Laysan_Albatross_0070_788.jpg,332,500,002.Laysan_Albatross,32,35,291,396,161,215,259,361
../../CUB_200_2011/images\002.Laysan_Albatross/Laysan_Albatross_0050_870.jpg,500,333,002.Laysan_Albatross,41,79,428,281,234,180,387,202
../../CUB_200_2011/images\002.Laysan_Albatross/Laysan_Albatross_0071_792.jpg,500,333,002.Laysan_Albatross,156,35,282,294,219,164,126,259
../../CUB_200_2011/images\002.Laysan_Albatross/Laysan_Albatross_0053_543.jpg,500,333,002.Laysan_Albatross,108,123,338,272,223,197,230,149
../../CUB_200_2011/images\002.Laysan_Albatross/Laysan_Albatross_0081_800.jpg,500,372,002.Laysan_Albatross,82,75,390,335,236,205,308,260
../../CUB_200_2011/images\002.Laysan_Albatross/Laysan_Albatross_0001_545.jpg,339,500,002.Laysan_Albatross,89,172,197,318,143,245,108,146
../../CUB_200_2011/images\002.Laysan_Albatross/Laysan_Albatross_0023_1059.jpg,500,375,002.Laysan_Albatross,83,124,294,374,188,249,211,250
../../CUB_200_2011/images\002.Laysan_Albatross/Laysan_Albatross_0065_809.jpg,500,375,002.Laysan_Albatross,75,80,450,357,262,218,375,277
../../CUB_200_2011/images\002.Laysan_Albatross/Laysan_Albatross_0061_563.jpg,500,333,002.Laysan_Albatross,41,31,425,291,233,161,384,260
../../CUB_200_2011/images\002.Laysan_Albatross/Laysan_Albatross_0085_564.jpg,500,367,002.Laysan_Albatross,45,31,313,337,179,184,268,306
../../CUB_200_2011/images\002.Laysan_Albatross/Laysan_Albatross_0005_565.jpg,500,333,002.Laysan_Albatross,38,91,354,284,196,187,316,193
../../CUB_200_2011/images\002.Laysan_Albatross/Laysan_Albatross_0060_777.jpg,500,314,002.Laysan_Albatross,137,72,339,283,238,177,202,211
../../CUB_200_2011/images\002.Laysan_Albatross/Laysan_Albatross_0055_570.jpg,500,332,002.Laysan_Albatross,15,25,424,299,219,162,409,274
../../CUB_200_2011/images\002.Laysan_Albatross/Laysan_Albatross_0025_571.jpg,500,281,002.Laysan_Albatross,193,46,395,241,294,143,202,195
../../CUB_200_2011/images\002.Laysan_Albatross/Laysan_Albatross_0080_821.jpg,500,429,002.Laysan_Albatross,99,115,415,399,257,257,316,284
../../CUB_200_2011/images\002.Laysan_Albatross/Laysan_Albatross_0092_834.jpg,500,333,002.Laysan_Albatross,71,50,383,286,227,168,312,236
../../CUB_200_2011/images\002.Laysan_Albatross/Laysan_Albatross_0013_910.jpg,500,333,002.Laysan_Albatross,67,25,425,273,246,149,358,248
../../CUB_200_2011/images\002.Laysan_Albatross/Laysan_Albatross_0091_602.jpg,500,385,002.Laysan_Albatross,109,13,385,308,247,160,276,295
../../CUB_200_2011/images\002.Laysan_Albatross/Laysan_Albatross_0102_611.jpg,500,500,002.Laysan_Albatross,35,114,453,330,244,222,418,216
../../CUB_200_2011/images\002.Laysan_Albatross/Laysan_Albatross_0099_869.jpg,500,500,002.Laysan_Albatross,41,89,419,393,230,241,378,304
../../CUB_200_2011/images\002.Laysan_Albatross/Laysan_Albatross_0017_614.jpg,375,500,002.Laysan_Albatross,8,75,358,499,183,287,350,424
../../CUB_200_2011/images\002.Laysan_Albatross/Laysan_Albatross_0047_619.jpg,500,478,002.Laysan_Albatross,157,36,352,401,254,218,195,365
../../CUB_200_2011/images\002.Laysan_Albatross/Laysan_Albatross_0035_876.jpg,500,347,002.Laysan_Albatross,30,7,467,328,248,167,437,321
../../CUB_200_2011/images\002.Laysan_Albatross/Laysan_Albatross_0098_621.jpg,500,375,002.Laysan_Albatross,58,91,390,347,224,219,332,256
../../CUB_200_2011/images\002.Laysan_Albatross/Laysan_Albatross_0088_883.jpg,500,334,002.Laysan_Albatross,84,25,369,332,226,178,285,307
../../CUB_200_2011/images\002.Laysan_Albatross/Laysan_Albatross_0034_628.jpg,500,333,002.Laysan_Albatross,193,53,437,307,315,180,244,254
../../CUB_200_2011/images\002.Laysan_Albatross/Laysan_Albatross_0104_630.jpg,500,306,002.Laysan_Albatross,119,42,237,165,178,103,118,123
../../CUB_200_2011/images\002.Laysan_Albatross/Laysan_Albatross_0058_637.jpg,500,333,002.Laysan_Albatross,18,60,477,299,247,179,459,239
../../CUB_200_2011/images\002.Laysan_Albatross/Laysan_Albatross_0028_643.jpg,500,375,002.Laysan_Albatross,135,120,336,258,235,189,201,138
../../CUB_200_2011/images\002.Laysan_Albatross/Laysan_Albatross_0033_658.jpg,500,334,002.Laysan_Albatross,45,10,367,291,206,150,322,281
../../CUB_200_2011/images\002.Laysan_Albatross/Laysan_Albatross_0075_668.jpg,500,340,002.Laysan_Albatross,120,60,221,278,170,169,101,218
../../CUB_200_2011/images\002.Laysan_Albatross/Laysan_Albatross_0076_671.jpg,500,375,002.Laysan_Albatross,151,23,425,374,288,198,274,351
../../CUB_200_2011/images\002.Laysan_Albatross/Laysan_Albatross_0096_673.jpg,500,375,002.Laysan_Albatross,46,71,449,351,247,211,403,280
../../CUB_200_2011/images\002.Laysan_Albatross/Laysan_Albatross_0064_674.jpg,500,333,002.Laysan_Albatross,118,19,340,313,229,166,222,294
../../CUB_200_2011/images\002.Laysan_Albatross/Laysan_Albatross_0039_924.jpg,500,312,002.Laysan_Albatross,24,53,385,234,204,143,361,181
../../CUB_200_2011/images\002.Laysan_Albatross/Laysan_Albatross_0049_918.jpg,500,340,002.Laysan_Albatross,13,58,486,301,249,179,473,243
../../CUB_200_2011/images\002.Laysan_Albatross/Laysan_Albatross_0012_696.jpg,500,307,002.Laysan_Albatross,125,72,431,221,278,146,306,149
../../CUB_200_2011/images\002.Laysan_Albatross/Laysan_Albatross_0056_500.jpg,500,341,002.Laysan_Albatross,92,47,423,307,257,177,331,260
../../CUB_200_2011/images\002.Laysan_Albatross/Laysan_Albatross_0037_699.jpg,500,333,002.Laysan_Albatross,152,41,339,312,245,176,187,271
../../CUB_200_2011/images\002.Laysan_Albatross/Laysan_Albatross_0006_702.jpg,333,500,002.Laysan_Albatross,83,90,328,484,205,287,245,394
../../CUB_200_2011/images\002.Laysan_Albatross/Laysan_Albatross_0073_927.jpg,500,333,002.Laysan_Albatross,127,55,379,237,253,146,252,182
../../CUB_200_2011/images\002.Laysan_Albatross/Laysan_Albatross_0042_801.jpg,500,333,002.Laysan_Albatross,116,18,399,332,257,175,283,314
../../CUB_200_2011/images\002.Laysan_Albatross/Laysan_Albatross_0004_930.jpg,500,375,002.Laysan_Albatross,64,94,351,317,207,205,287,223
../../CUB_200_2011/images\002.Laysan_Albatross/Laysan_Albatross_0093_725.jpg,500,334,002.Laysan_Albatross,138,88,258,244,198,166,120,156
../../CUB_200_2011/images\002.Laysan_Albatross/Laysan_Albatross_0068_726.jpg,333,500,002.Laysan_Albatross,43,62,329,494,186,278,286,432
../../CUB_200_2011/images\002.Laysan_Albatross/Laysan_Albatross_0040_472.jpg,500,397,002.Laysan_Albatross,148,115,297,308,222,211,149,193
../../CUB_200_2011/images\002.Laysan_Albatross/Laysan_Albatross_0100_735.jpg,500,337,002.Laysan_Albatross,136,66,307,309,221,187,171,243
../../CUB_200_2011/images\002.Laysan_Albatross/Laysan_Albatross_0021_737.jpg,500,385,002.Laysan_Albatross,140,100,377,299,258,199,237,199
../../CUB_200_2011/images\002.Laysan_Albatross/Laysan_Albatross_0029_482.jpg,500,333,002.Laysan_Albatross,31,52,408,224,219,138,377,172
../../CUB_200_2011/images\002.Laysan_Albatross/Laysan_Albatross_0059_488.jpg,500,334,002.Laysan_Albatross,26,53,357,264,191,158,331,211
../../CUB_200_2011/images\002.Laysan_Albatross/Laysan_Albatross_0018_492.jpg,500,335,002.Laysan_Albatross,183,80,420,280,301,180,237,200
../../CUB_200_2011/images\002.Laysan_Albatross/Laysan_Albatross_0083_756.jpg,500,333,002.Laysan_Albatross,128,109,349,307,238,208,221,198
../../CUB_200_2011/images\002.Laysan_Albatross/Laysan_Albatross_0094_1013.jpg,500,331,002.Laysan_Albatross,165,48,331,316,248,182,166,268
../../CUB_200_2011/images\002.Laysan_Albatross/Laysan_Albatross_0103_504.jpg,500,375,002.Laysan_Albatross,145,42,327,330,236,186,182,288
../../CUB_200_2011/images\002.Laysan_Albatross/Laysan_Albatross_0079_506.jpg,500,375,002.Laysan_Albatross,92,69,458,338,275,203,366,269
../../CUB_200_2011/images\002.Laysan_Albatross/Laysan_Albatross_0051_1020.jpg,500,375,002.Laysan_Albatross,77,93,240,271,158,182,163,178
../../CUB_200_2011/images\003.Sooty_Albatross/Sooty_Albatross_0038_1065.jpg,500,320,003.Sooty_Albatross,196,96,418,243,307,169,222,147
../../CUB_200_2011/images\003.Sooty_Albatross/Sooty_Albatross_0031_1066.jpg,500,357,003.Sooty_Albatross,102,128,498,276,300,202,396,148
../../CUB_200_2011/images\003.Sooty_Albatross/Sooty_Albatross_0001_1071.jpg,330,500,003.Sooty_Albatross,105,133,273,416,189,274,168,283
../../CUB_200_2011/images\003.Sooty_Albatross/Sooty_Albatross_0016_1075.jpg,500,334,003.Sooty_Albatross,169,41,349,290,259,165,180,249
../../CUB_200_2011/images\003.Sooty_Albatross/Sooty_Albatross_0043_1076.jpg,375,500,003.Sooty_Albatross,1,134,317,479,159,306,316,345
../../CUB_200_2011/images\003.Sooty_Albatross/Sooty_Albatross_0003_1078.jpg,500,357,003.Sooty_Albatross,36,63,484,315,260,189,448,252
../../CUB_200_2011/images\003.Sooty_Albatross/Sooty_Albatross_0077_1080.jpg,500,335,003.Sooty_Albatross,92,117,419,238,255,177,327,121
../../CUB_200_2011/images\003.Sooty_Albatross/Sooty_Albatross_0063_1101.jpg,500,356,003.Sooty_Albatross,55,49,231,199,143,124,176,150
../../CUB_200_2011/images\003.Sooty_Albatross/Sooty_Albatross_0044_1105.jpg,500,332,003.Sooty_Albatross,206,107,346,222,276,164,140,115
../../CUB_200_2011/images\003.Sooty_Albatross/Sooty_Albatross_0071_1116.jpg,500,392,003.Sooty_Albatross,98,24,338,337,218,180,240,313
../../CUB_200_2011/images\003.Sooty_Albatross/Sooty_Albatross_0070_796346.jpg,480,360,003.Sooty_Albatross,114,30,319,311,216,170,205,281
../../CUB_200_2011/images\003.Sooty_Albatross/Sooty_Albatross_0030_1122.jpg,500,333,003.Sooty_Albatross,75,2,472,332,273,167,397,330
../../CUB_200_2011/images\003.Sooty_Albatross/Sooty_Albatross_0054_796347.jpg,500,379,003.Sooty_Albatross,86,57,216,327,151,192,130,270
../../CUB_200_2011/images\003.Sooty_Albatross/Sooty_Albatross_0033_1128.jpg,500,332,003.Sooty_Albatross,49,75,415,232,232,153,366,157
../../CUB_200_2011/images\003.Sooty_Albatross/Sooty_Albatross_0048_1130.jpg,500,333,003.Sooty_Albatross,33,118,268,291,150,204,235,173
../../CUB_200_2011/images\003.Sooty_Albatross/Sooty_Albatross_0032_1149.jpg,500,375,003.Sooty_Albatross,121,74,270,208,195,141,149,134
../../CUB_200_2011/images\003.Sooty_Albatross/Sooty_Albatross_0034_1154.jpg,400,500,003.Sooty_Albatross,134,96,257,385,195,240,123,289
../../CUB_200_2011/images\003.Sooty_Albatross/Sooty_Albatross_0055_1160.jpg,500,333,003.Sooty_Albatross,165,34,453,330,309,182,288,296
../../CUB_200_2011/images\003.Sooty_Albatross/Sooty_Albatross_0024_1161.jpg,350,500,003.Sooty_Albatross,98,140,279,387,188,263,181,247
../../CUB_200_2011/images\003.Sooty_Albatross/Sooty_Albatross_0045_1162.jpg,500,500,003.Sooty_Albatross,6,1,499,498,252,249,493,497
../../CUB_200_2011/images\003.Sooty_Albatross/Sooty_Albatross_0073_1171.jpg,354,500,003.Sooty_Albatross,89,168,249,413,169,290,160,245
../../CUB_200_2011/images\003.Sooty_Albatross/Sooty_Albatross_0074_1221.jpg,500,334,003.Sooty_Albatross,9,67,321,319,165,193,312,252
../../CUB_200_2011/images\003.Sooty_Albatross/Sooty_Albatross_0021_796339.jpg,300,284,003.Sooty_Albatross,1,14,251,262,126,138,250,248
../../CUB_200_2011/images\003.Sooty_Albatross/Sooty_Albatross_0005_796342.jpg,437,376,003.Sooty_Albatross,1,15,416,317,208,166,415,302
../../CUB_200_2011/images\003.Sooty_Albatross/Sooty_Albatross_0064_796343.jpg,500,335,003.Sooty_Albatross,191,51,424,304,307,177,233,253
../../CUB_200_2011/images\003.Sooty_Albatross/Sooty_Albatross_0042_1210.jpg,500,322,003.Sooty_Albatross,0,67,212,230,106,148,212,163
../../CUB_200_2011/images\003.Sooty_Albatross/Sooty_Albatross_0046_1211.jpg,500,333,003.Sooty_Albatross,122,35,499,332,310,183,377,297
../../CUB_200_2011/images\003.Sooty_Albatross/Sooty_Albatross_0017_796349.jpg,500,302,003.Sooty_Albatross,105,77,372,236,238,156,267,159
../../CUB_200_2011/images\003.Sooty_Albatross/Sooty_Albatross_0049_796350.jpg,225,354,003.Sooty_Albatross,16,36,206,325,111,180,190,289
../../CUB_200_2011/images\003.Sooty_Albatross/Sooty_Albatross_0050_796351.jpg,500,364,003.Sooty_Albatross,12,9,478,316,245,162,466,307
../../CUB_200_2011/images\003.Sooty_Albatross/Sooty_Albatross_0075_796352.jpg,500,217,003.Sooty_Albatross,14,39,469,206,241,122,455,167
../../CUB_200_2011/images\003.Sooty_Albatross/Sooty_Albatross_0068_796353.jpg,500,333,003.Sooty_Albatross,165,55,293,274,229,164,128,219
../../CUB_200_2011/images\003.Sooty_Albatross/Sooty_Albatross_0057_796354.jpg,250,188,003.Sooty_Albatross,37,35,179,176,108,105,142,141
../../CUB_200_2011/images\003.Sooty_Albatross/Sooty_Albatross_0010_796355.jpg,500,333,003.Sooty_Albatross,113,91,400,244,256,167,287,153
../../CUB_200_2011/images\003.Sooty_Albatross/Sooty_Albatross_0029_796357.jpg,500,400,003.Sooty_Albatross,15,46,425,384,220,215,410,338
../../CUB_200_2011/images\003.Sooty_Albatross/Sooty_Albatross_0069_796358.jpg,500,345,003.Sooty_Albatross,145,104,362,319,253,211,217,215
../../CUB_200_2011/images\003.Sooty_Albatross/Sooty_Albatross_0020_796359.jpg,450,352,003.Sooty_Albatross,136,6,358,346,247,176,222,340
../../CUB_200_2011/images\003.Sooty_Albatross/Sooty_Albatross_0058_796360.jpg,409,450,003.Sooty_Albatross,22,13,347,441,184,227,325,428
../../CUB_200_2011/images\003.Sooty_Albatross/Sooty_Albatross_0025_796361.jpg,500,411,003.Sooty_Albatross,0,0,400,378,200,189,400,378
../../CUB_200_2011/images\003.Sooty_Albatross/Sooty_Albatross_0041_796364.jpg,500,370,003.Sooty_Albatross,139,33,476,352,307,192,337,319
../../CUB_200_2011/images\003.Sooty_Albatross/Sooty_Albatross_0076_796365.jpg,500,334,003.Sooty_Albatross,247,62,464,313,355,187,217,251
../../CUB_200_2011/images\003.Sooty_Albatross/Sooty_Albatross_0004_796366.jpg,500,480,003.Sooty_Albatross,123,46,390,454,256,250,267,408
../../CUB_200_2011/images\003.Sooty_Albatross/Sooty_Albatross_0065_796367.jpg,500,484,003.Sooty_Albatross,55,65,374,429,214,247,319,364
../../CUB_200_2011/images\003.Sooty_Albatross/Sooty_Albatross_0072_796371.jpg,500,333,003.Sooty_Albatross,0,74,443,274,221,174,443,200
../../CUB_200_2011/images\003.Sooty_Albatross/Sooty_Albatross_0007_796372.jpg,500,335,003.Sooty_Albatross,14,7,491,334,252,170,477,327
../../CUB_200_2011/images\003.Sooty_Albatross/Sooty_Albatross_0014_796373.jpg,500,313,003.Sooty_Albatross,22,98,471,290,246,194,449,192
../../CUB_200_2011/images\003.Sooty_Albatross/Sooty_Albatross_0051_796374.jpg,466,282,003.Sooty_Albatross,27,37,310,269,168,153,283,232
../../CUB_200_2011/images\003.Sooty_Albatross/Sooty_Albatross_0040_796375.jpg,391,500,003.Sooty_Albatross,96,58,342,409,219,233,246,351
../../CUB_200_2011/images\003.Sooty_Albatross/Sooty_Albatross_0067_796376.jpg,500,375,003.Sooty_Albatross,177,13,351,346,264,179,174,333
../../CUB_200_2011/images\003.Sooty_Albatross/Sooty_Albatross_0066_796382.jpg,500,399,003.Sooty_Albatross,132,82,400,288,266,185,268,206
../../CUB_200_2011/images\003.Sooty_Albatross/Sooty_Albatross_0036_796387.jpg,500,330,003.Sooty_Albatross,150,44,306,236,228,140,156,192
../../CUB_200_2011/images\003.Sooty_Albatross/Sooty_Albatross_0079_796389.jpg,298,320,003.Sooty_Albatross,37,18,259,308,148,163,222,290
../../CUB_200_2011/images\003.Sooty_Albatross/Sooty_Albatross_0006_796390.jpg,500,333,003.Sooty_Albatross,209,1,354,327,281,164,145,326
../../CUB_200_2011/images\003.Sooty_Albatross/Sooty_Albatross_0019_796391.jpg,500,334,003.Sooty_Albatross,236,36,359,151,297,93,123,115
../../CUB_200_2011/images\003.Sooty_Albatross/Sooty_Albatross_0002_796395.jpg,500,309,003.Sooty_Albatross,95,65,474,250,284,157,379,185
../../CUB_200_2011/images\003.Sooty_Albatross/Sooty_Albatross_0022_796398.jpg,350,397,003.Sooty_Albatross,20,18,334,385,177,201,314,367
../../CUB_200_2011/images\003.Sooty_Albatross/Sooty_Albatross_0023_796401.jpg,280,420,003.Sooty_Albatross,19,9,202,414,110,211,183,405
../../CUB_200_2011/images\003.Sooty_Albatross/Sooty_Albatross_0013_796402.jpg,320,240,003.Sooty_Albatross,77,38,248,196,162,117,171,158
../../CUB_200_2011/images\004.Groove_billed_Ani/Groove_Billed_Ani_0068_1538.jpg,500,372,004.Groove_billed_Ani,214,30,365,357,289,193,151,327
../../CUB_200_2011/images\004.Groove_billed_Ani/Groove_Billed_Ani_0094_1540.jpg,500,400,004.Groove_billed_Ani,17,87,450,349,233,218,433,262
../../CUB_200_2011/images\004.Groove_billed_Ani/Groove_Billed_Ani_0033_1494.jpg,500,375,004.Groove_billed_Ani,140,76,281,373,210,224,141,297
../../CUB_200_2011/images\004.Groove_billed_Ani/Groove_Billed_Ani_0069_1546.jpg,500,500,004.Groove_billed_Ani,62,108,370,418,216,263,308,310
../../CUB_200_2011/images\004.Groove_billed_Ani/Groove_Billed_Ani_0080_1549.jpg,500,357,004.Groove_billed_Ani,113,88,329,356,221,222,216,268
../../CUB_200_2011/images\004.Groove_billed_Ani/Groove_Billed_Ani_0071_1559.jpg,333,500,004.Groove_billed_Ani,61,41,291,455,176,248,230,414
../../CUB_200_2011/images\004.Groove_billed_Ani/Groove_Billed_Ani_0037_1560.jpg,500,333,004.Groove_billed_Ani,226,140,389,249,307,194,163,109
../../CUB_200_2011/images\004.Groove_billed_Ani/Groove_Billed_Ani_0017_1561.jpg,500,375,004.Groove_billed_Ani,63,90,498,289,280,189,435,199
../../CUB_200_2011/images\004.Groove_billed_Ani/Groove_Billed_Ani_0105_1562.jpg,500,371,004.Groove_billed_Ani,115,62,438,348,276,205,323,286
../../CUB_200_2011/images\004.Groove_billed_Ani/Groove_Billed_Ani_0090_1567.jpg,500,333,004.Groove_billed_Ani,71,43,391,288,231,165,320,245
../../CUB_200_2011/images\004.Groove_billed_Ani/Groove_Billed_Ani_0019_1585.jpg,500,333,004.Groove_billed_Ani,200,149,311,266,255,207,111,117
../../CUB_200_2011/images\004.Groove_billed_Ani/Groove_Billed_Ani_0031_1588.jpg,500,334,004.Groove_billed_Ani,166,113,399,265,282,189,233,152
../../CUB_200_2011/images\004.Groove_billed_Ani/Groove_Billed_Ani_0107_1590.jpg,500,375,004.Groove_billed_Ani,170,73,315,285,242,179,145,212
../../CUB_200_2011/images\004.Groove_billed_Ani/Groove_Billed_Ani_0035_1591.jpg,453,500,004.Groove_billed_Ani,62,28,296,383,179,205,234,355
../../CUB_200_2011/images\004.Groove_billed_Ani/Groove_Billed_Ani_0109_1592.jpg,333,500,004.Groove_billed_Ani,86,100,247,429,166,264,161,329
../../CUB_200_2011/images\004.Groove_billed_Ani/Groove_Billed_Ani_0036_1604.jpg,500,375,004.Groove_billed_Ani,61,52,438,342,249,197,377,290
../../CUB_200_2011/images\004.Groove_billed_Ani/Groove_Billed_Ani_0085_1612.jpg,500,375,004.Groove_billed_Ani,205,140,387,313,296,226,182,173
../../CUB_200_2011/images\004.Groove_billed_Ani/Groove_Billed_Ani_0018_1613.jpg,500,332,004.Groove_billed_Ani,228,28,415,309,321,168,187,281
../../CUB_200_2011/images\004.Groove_billed_Ani/Groove_Billed_Ani_0007_1615.jpg,500,333,004.Groove_billed_Ani,166,86,373,300,269,193,207,214
../../CUB_200_2011/images\004.Groove_billed_Ani/Groove_Billed_Ani_0075_1617.jpg,500,416,004.Groove_billed_Ani,174,29,438,399,306,214,264,370
../../CUB_200_2011/images\004.Groove_billed_Ani/Groove_Billed_Ani_0029_1620.jpg,418,500,004.Groove_billed_Ani,102,103,311,445,206,274,209,342
../../CUB_200_2011/images\004.Groove_billed_Ani/Groove_Billed_Ani_0108_1639.jpg,500,444,004.Groove_billed_Ani,103,46,277,374,190,210,174,328
../../CUB_200_2011/images\004.Groove_billed_Ani/Groove_Billed_Ani_0100_1646.jpg,500,333,004.Groove_billed_Ani,165,86,291,242,228,164,126,156
../../CUB_200_2011/images\004.Groove_billed_Ani/Groove_Billed_Ani_0051_1650.jpg,400,500,004.Groove_billed_Ani,92,94,305,389,198,241,213,295
../../CUB_200_2011/images\004.Groove_billed_Ani/Groove_Billed_Ani_0015_1653.jpg,420,280,004.Groove_billed_Ani,102,56,219,232,160,144,117,176
../../CUB_200_2011/images\004.Groove_billed_Ani/Groove_Billed_Ani_0076_1661.jpg,500,344,004.Groove_billed_Ani,247,135,353,306,300,220,106,171
../../CUB_200_2011/images\004.Groove_billed_Ani/Groove_Billed_Ani_0046_1663.jpg,500,478,004.Groove_billed_Ani,68,157,310,377,189,267,242,220
../../CUB_200_2011/images\004.Groove_billed_Ani/Groove_Billed_Ani_0002_1670.jpg,500,360,004.Groove_billed_Ani,24,58,456,296,240,177,432,238
../../CUB_200_2011/images\004.Groove_billed_Ani/Groove_Billed_Ani_0053_1672.jpg,500,367,004.Groove_billed_Ani,169,105,389,326,279,215,220,221
../../CUB_200_2011/images\004.Groove_billed_Ani/Groove_Billed_Ani_0088_1678.jpg,500,375,004.Groove_billed_Ani,131,101,306,331,218,216,175,230
../../CUB_200_2011/images\004.Groove_billed_Ani/Groove_Billed_Ani_0072_1696.jpg,479,500,004.Groove_billed_Ani,147,142,295,350,221,246,148,208
../../CUB_200_2011/images\004.Groove_billed_Ani/Groove_Billed_Ani_0082_1697.jpg,500,375,004.Groove_billed_Ani,178,28,302,314,240,171,124,286
../../CUB_200_2011/images\004.Groove_billed_Ani/Groove_Billed_Ani_0101_1700.jpg,357,500,004.Groove_billed_Ani,65,54,219,428,142,241,154,374
../../CUB_200_2011/images\004.Groove_billed_Ani/Groove_Billed_Ani_0010_1704.jpg,500,337,004.Groove_billed_Ani,184,99,301,292,242,195,117,193
../../CUB_200_2011/images\004.Groove_billed_Ani/Groove_Billed_Ani_0047_1706.jpg,500,349,004.Groove_billed_Ani,115,59,444,314,279,186,329,255
../../CUB_200_2011/images\004.Groove_billed_Ani/Groove_Billed_Ani_0040_1715.jpg,444,500,004.Groove_billed_Ani,120,144,359,401,239,272,239,257
../../CUB_200_2011/images\004.Groove_billed_Ani/Groove_Billed_Ani_0077_1724.jpg,308,500,004.Groove_billed_Ani,22,103,255,417,138,260,233,314
../../CUB_200_2011/images\004.Groove_billed_Ani/Groove_Billed_Ani_0091_1728.jpg,500,335,004.Groove_billed_Ani,34,138,321,296,177,217,287,158
../../CUB_200_2011/images\004.Groove_billed_Ani/Groove_Billed_Ani_0074_1730.jpg,500,374,004.Groove_billed_Ani,143,70,309,325,226,197,166,255
../../CUB_200_2011/images\004.Groove_billed_Ani/Groove_Billed_Ani_0044_1731.jpg,500,375,004.Groove_billed_Ani,110,67,499,300,304,183,389,233
../../CUB_200_2011/images\004.Groove_billed_Ani/Groove_Billed_Ani_0059_1480.jpg,400,500,004.Groove_billed_Ani,187,60,321,315,254,187,134,255
../../CUB_200_2011/images\004.Groove_billed_Ani/Groove_Billed_Ani_0023_1485.jpg,500,333,004.Groove_billed_Ani,110,75,238,331,174,203,128,256
../../CUB_200_2011/images\004.Groove_billed_Ani/Groove_Billed_Ani_0004_1528.jpg,500,332,004.Groove_billed_Ani,290,97,435,239,362,168,145,142
../../CUB_200_2011/images\004.Groove_billed_Ani/Groove_Billed_Ani_0056_1493.jpg,500,392,004.Groove_billed_Ani,45,43,315,385,180,214,270,342
../../CUB_200_2011/images\004.Groove_billed_Ani/Groove_Billed_Ani_0005_1750.jpg,500,375,004.Groove_billed_Ani,58,54,499,374,278,214,441,320
../../CUB_200_2011/images\004.Groove_billed_Ani/Groove_Billed_Ani_0058_1751.jpg,500,383,004.Groove_billed_Ani,160,65,316,299,238,182,156,234
../../CUB_200_2011/images\004.Groove_billed_Ani/Groove_Billed_Ani_0027_1754.jpg,500,375,004.Groove_billed_Ani,89,34,317,373,203,203,228,339
../../CUB_200_2011/images\004.Groove_billed_Ani/Groove_Billed_Ani_0014_1755.jpg,375,500,004.Groove_billed_Ani,94,22,316,492,205,257,222,470
../../CUB_200_2011/images\004.Groove_billed_Ani/Groove_Billed_Ani_0055_1501.jpg,500,333,004.Groove_billed_Ani,123,49,429,249,276,149,306,200
../../CUB_200_2011/images\004.Groove_billed_Ani/Groove_Billed_Ani_0065_1502.jpg,397,500,004.Groove_billed_Ani,110,52,329,420,219,236,219,368
../../CUB_200_2011/images\004.Groove_billed_Ani/Groove_Billed_Ani_0060_1505.jpg,347,500,004.Groove_billed_Ani,122,64,298,402,210,233,176,338
../../CUB_200_2011/images\004.Groove_billed_Ani/Groove_Billed_Ani_0006_1763.jpg,500,333,004.Groove_billed_Ani,188,151,385,266,286,208,197,115
../../CUB_200_2011/images\004.Groove_billed_Ani/Groove_Billed_Ani_0087_1765.jpg,500,375,004.Groove_billed_Ani,91,53,341,274,216,163,250,221
../../CUB_200_2011/images\004.Groove_billed_Ani/Groove_Billed_Ani_0061_1510.jpg,333,500,004.Groove_billed_Ani,116,37,260,490,188,263,144,453
../../CUB_200_2011/images\004.Groove_billed_Ani/Groove_Billed_Ani_0062_1767.jpg,500,375,004.Groove_billed_Ani,114,86,416,371,265,228,302,285
../../CUB_200_2011/images\004.Groove_billed_Ani/Groove_Billed_Ani_0092_1516.jpg,500,398,004.Groove_billed_Ani,155,118,377,302,266,210,222,184
../../CUB_200_2011/images\004.Groove_billed_Ani/Groove_Billed_Ani_0032_1776.jpg,500,375,004.Groove_billed_Ani,156,25,354,374,255,199,198,349
../../CUB_200_2011/images\004.Groove_billed_Ani/Groove_Billed_Ani_0009_1522.jpg,500,477,004.Groove_billed_Ani,215,59,326,412,270,235,111,353
../../CUB_200_2011/images\004.Groove_billed_Ani/Groove_Billed_Ani_0078_1780.jpg,343,367,004.Groove_billed_Ani,55,46,176,165,115,105,121,119
../../CUB_200_2011/images\004.Groove_billed_Ani/Groove_Billed_Ani_0012_1784.jpg,500,378,004.Groove_billed_Ani,183,98,297,315,240,206,114,217
../../CUB_200_2011/images\005.Crested_Auklet/Crested_Auklet_0006_1813.jpg,500,400,005.Crested_Auklet,204,60,356,341,280,200,152,281
../../CUB_200_2011/images\005.Crested_Auklet/Crested_Auklet_0042_794902.jpg,348,500,005.Crested_Auklet,48,68,215,482,131,275,167,414
../../CUB_200_2011/images\005.Crested_Auklet/Crested_Auklet_0061_794904.jpg,334,500,005.Crested_Auklet,101,64,266,468,183,266,165,404
../../CUB_200_2011/images\005.Crested_Auklet/Crested_Auklet_0018_1817.jpg,333,500,005.Crested_Auklet,52,51,330,499,191,275,278,448
../../CUB_200_2011/images\005.Crested_Auklet/Crested_Auklet_0010_794907.jpg,334,500,005.Crested_Auklet,22,45,247,418,134,231,225,373
../../CUB_200_2011/images\005.Crested_Auklet/Crested_Auklet_0041_794910.jpg,300,254,005.Crested_Auklet,1,14,296,238,148,126,295,224
../../CUB_200_2011/images\005.Crested_Auklet/Crested_Auklet_0029_1824.jpg,326,500,005.Crested_Auklet,25,39,272,499,148,269,247,460
../../CUB_200_2011/images\005.Crested_Auklet/Crested_Auklet_0044_1825.jpg,500,375,005.Crested_Auklet,124,116,359,361,241,238,235,245
../../CUB_200_2011/images\005.Crested_Auklet/Crested_Auklet_0013_794914.jpg,261,320,005.Crested_Auklet,39,59,214,271,126,165,175,212
../../CUB_200_2011/images\005.Crested_Auklet/Crested_Auklet_0047_794918.jpg,200,200,005.Crested_Auklet,32,43,170,171,101,107,138,128
../../CUB_200_2011/images\005.Crested_Auklet/Crested_Auklet_0005_794922.jpg,334,500,005.Crested_Auklet,130,59,306,459,218,259,176,400
../../CUB_200_2011/images\005.Crested_Auklet/Crested_Auklet_0019_794925.jpg,200,273,005.Crested_Auklet,31,9,170,264,100,136,139,255
../../CUB_200_2011/images\005.Crested_Auklet/Crested_Auklet_0011_794927.jpg,500,478,005.Crested_Auklet,156,54,392,477,274,265,236,423
../../CUB_200_2011/images\005.Crested_Auklet/Crested_Auklet_0059_794929.jpg,214,320,005.Crested_Auklet,11,8,212,310,111,159,201,302
../../CUB_200_2011/images\005.Crested_Auklet/Crested_Auklet_0032_794931.jpg,500,328,005.Crested_Auklet,113,15,330,327,221,171,217,312
../../CUB_200_2011/images\005.Crested_Auklet/Crested_Auklet_0057_794932.jpg,337,500,005.Crested_Auklet,5,25,313,484,159,254,308,459
../../CUB_200_2011/images\005.Crested_Auklet/Crested_Auklet_0021_794938.jpg,317,500,005.Crested_Auklet,45,23,301,470,173,246,256,447
../../CUB_200_2011/images\005.Crested_Auklet/Crested_Auklet_0045_794940.jpg,271,404,005.Crested_Auklet,10,69,230,368,120,218,220,299
../../CUB_200_2011/images\005.Crested_Auklet/Crested_Auklet_0001_794941.jpg,324,480,005.Crested_Auklet,34,141,285,472,159,306,251,331
../../CUB_200_2011/images\005.Crested_Auklet/Crested_Auklet_0039_794944.jpg,344,500,005.Crested_Auklet,114,75,257,413,185,244,143,338
../../CUB_200_2011/images\005.Crested_Auklet/Crested_Auklet_0074_794949.jpg,271,404,005.Crested_Auklet,53,62,195,342,124,202,142,280
../../CUB_200_2011/images\005.Crested_Auklet/Crested_Auklet_0028_794951.jpg,271,404,005.Crested_Auklet,84,101,201,352,142,226,117,251
../../CUB_200_2011/images\005.Crested_Auklet/Crested_Auklet_0052_794952.jpg,271,404,005.Crested_Auklet,30,132,206,366,118,249,176,234
../../CUB_200_2011/images\005.Crested_Auklet/Crested_Auklet_0012_794960.jpg,279,381,005.Crested_Auklet,98,57,220,343,159,200,122,286
../../CUB_200_2011/images\005.Crested_Auklet/Crested_Auklet_0003_794962.jpg,500,375,005.Crested_Auklet,60,54,286,318,173,186,226,264
../../CUB_200_2011/images\005.Crested_Auklet/Crested_Auklet_0033_794964.jpg,500,333,005.Crested_Auklet,252,54,363,265,307,159,111,211
../../CUB_200_2011/images\005.Crested_Auklet/Crested_Auklet_0053_794966.jpg,500,493,005.Crested_Auklet,118,9,389,475,253,242,271,466
../../CUB_200_2011/images\005.Crested_Auklet/Crested_Auklet_0062_794968.jpg,243,280,005.Crested_Auklet,58,50,186,241,122,145,128,191
../../CUB_200_2011/images\005.Crested_Auklet/Crested_Auklet_0073_785248.jpg,500,333,005.Crested_Auklet,209,22,405,150,307,86,196,128
../../CUB_200_2011/images\005.Crested_Auklet/Crested_Auklet_0067_785249.jpg,500,399,005.Crested_Auklet,317,96,446,365,381,230,129,269
../../CUB_200_2011/images\005.Crested_Auklet/Crested_Auklet_0066_785251.jpg,425,500,005.Crested_Auklet,52,63,347,487,199,275,295,424
../../CUB_200_2011/images\005.Crested_Auklet/Crested_Auklet_0076_785252.jpg,410,500,005.Crested_Auklet,60,66,323,462,191,264,263,396
../../CUB_200_2011/images\005.Crested_Auklet/Crested_Auklet_0068_785253.jpg,500,334,005.Crested_Auklet,236,125,383,238,309,181,147,113
../../CUB_200_2011/images\005.Crested_Auklet/Crested_Auklet_0071_785255.jpg,500,375,005.Crested_Auklet,0,0,500,375,250,187,500,375
../../CUB_200_2011/images\005.Crested_Auklet/Crested_Auklet_0077_785257.jpg,436,500,005.Crested_Auklet,189,235,294,378,241,306,105,143
../../CUB_200_2011/images\005.Crested_Auklet/Crested_Auklet_0069_785258.jpg,500,339,005.Crested_Auklet,78,73,186,193,132,133,108,120
../../CUB_200_2011/images\005.Crested_Auklet/Crested_Auklet_0075_785259.jpg,500,375,005.Crested_Auklet,130,145,276,262,203,203,146,117
../../CUB_200_2011/images\005.Crested_Auklet/Crested_Auklet_0072_785260.jpg,500,363,005.Crested_Auklet,177,146,363,319,270,232,186,173
../../CUB_200_2011/images\005.Crested_Auklet/Crested_Auklet_0070_785261.jpg,500,403,005.Crested_Auklet,133,20,442,375,287,197,309,355
../../CUB_200_2011/images\005.Crested_Auklet/Crested_Auklet_0063_794901.jpg,500,402,005.Crested_Auklet,38,17,426,376,232,196,388,359
../../CUB_200_2011/images\005.Crested_Auklet/Crested_Auklet_0036_794905.jpg,301,465,005.Crested_Auklet,6,6,283,428,144,217,277,422
../../CUB_200_2011/images\005.Crested_Auklet/Crested_Auklet_0030_794937.jpg,500,421,005.Crested_Auklet,177,27,354,414,265,220,177,387
../../CUB_200_2011/images\005.Crested_Auklet/Crested_Auklet_0040_794912.jpg,335,500,005.Crested_Auklet,10,157,193,431,101,294,183,274
../../CUB_200_2011/images\005.Crested_Auklet/Crested_Auklet_0048_1791.jpg,376,500,005.Crested_Auklet,120,82,241,225,180,153,121,143
../../CUB_200_2011/images\006.Least_Auklet/Least_Auklet_0035_1888.jpg,500,400,006.Least_Auklet,82,22,469,384,275,203,387,362
../../CUB_200_2011/images\006.Least_Auklet/Least_Auklet_0050_1924.jpg,400,500,006.Least_Auklet,90,125,270,438,180,281,180,313
../../CUB_200_2011/images\006.Least_Auklet/Least_Auklet_0058_1931.jpg,500,333,006.Least_Auklet,205,94,398,306,301,200,193,212
../../CUB_200_2011/images\006.Least_Auklet/Least_Auklet_0014_1901.jpg,500,375,006.Least_Auklet,144,31,336,364,240,197,192,333
../../CUB_200_2011/images\006.Least_Auklet/Least_Auklet_0016_1903.jpg,419,500,006.Least_Auklet,59,34,340,484,199,259,281,450
../../CUB_200_2011/images\006.Least_Auklet/Least_Auklet_0040_795100.jpg,300,286,006.Least_Auklet,89,52,225,226,157,139,136,174
../../CUB_200_2011/images\006.Least_Auklet/Least_Auklet_0015_795065.jpg,500,374,006.Least_Auklet,99,102,294,311,196,206,195,209
../../CUB_200_2011/images\006.Least_Auklet/Least_Auklet_0026_795066.jpg,500,333,006.Least_Auklet,96,61,286,266,191,163,190,205
../../CUB_200_2011/images\006.Least_Auklet/Least_Auklet_0043_795067.jpg,360,430,006.Least_Auklet,92,90,218,292,155,191,126,202
../../CUB_200_2011/images\006.Least_Auklet/Least_Auklet_0032_795068.jpg,390,500,006.Least_Auklet,23,78,277,404,150,241,254,326
../../CUB_200_2011/images\006.Least_Auklet/Least_Auklet_0045_795069.jpg,326,500,006.Least_Auklet,28,133,195,411,111,272,167,278
../../CUB_200_2011/images\006.Least_Auklet/Least_Auklet_0008_795071.jpg,140,153,006.Least_Auklet,5,4,136,153,70,78,131,149
../../CUB_200_2011/images\006.Least_Auklet/Least_Auklet_0012_795074.jpg,500,375,006.Least_Auklet,157,50,343,342,250,196,186,292
../../CUB_200_2011/images\006.Least_Auklet/Least_Auklet_0018_795077.jpg,334,500,006.Least_Auklet,54,118,249,415,151,266,195,297
../../CUB_200_2011/images\006.Least_Auklet/Least_Auklet_0020_795080.jpg,488,500,006.Least_Auklet,57,90,357,403,207,246,300,313
../../CUB_200_2011/images\006.Least_Auklet/Least_Auklet_0039_795081.jpg,500,375,006.Least_Auklet,42,36,246,374,144,205,204,338
../../CUB_200_2011/images\006.Least_Auklet/Least_Auklet_0017_795084.jpg,370,500,006.Least_Auklet,81,107,273,436,177,271,192,329
../../CUB_200_2011/images\006.Least_Auklet/Least_Auklet_0025_795087.jpg,324,500,006.Least_Auklet,103,89,210,232,156,160,107,143
../../CUB_200_2011/images\006.Least_Auklet/Least_Auklet_0052_795088.jpg,200,300,006.Least_Auklet,74,89,178,241,126,165,104,152
../../CUB_200_2011/images\006.Least_Auklet/Least_Auklet_0027_795091.jpg,334,500,006.Least_Auklet,95,111,322,421,208,266,227,310
../../CUB_200_2011/images\006.Least_Auklet/Least_Auklet_0010_795092.jpg,220,330,006.Least_Auklet,62,65,208,305,135,185,146,240
../../CUB_200_2011/images\006.Least_Auklet/Least_Auklet_0028_795094.jpg,350,350,006.Least_Auklet,69,59,272,279,170,169,203,220
../../CUB_200_2011/images\006.Least_Auklet/Least_Auklet_0060_795095.jpg,500,333,006.Least_Auklet,120,37,325,299,222,168,205,262
../../CUB_200_2011/images\006.Least_Auklet/Least_Auklet_0034_795096.jpg,300,450,006.Least_Auklet,24,21,265,438,144,229,241,417
../../CUB_200_2011/images\006.Least_Auklet/Least_Auklet_0042_1874.jpg,500,334,006.Least_Auklet,75,58,343,280,209,169,268,222
../../CUB_200_2011/images\006.Least_Auklet/Least_Auklet_0055_795106.jpg,500,457,006.Least_Auklet,52,35,425,406,238,220,373,371
../../CUB_200_2011/images\006.Least_Auklet/Least_Auklet_0041_795107.jpg,227,350,006.Least_Auklet,56,54,191,294,123,174,135,240
../../CUB_200_2011/images\006.Least_Auklet/Least_Auklet_0011_795109.jpg,208,216,006.Least_Auklet,14,8,193,215,103,111,179,207
../../CUB_200_2011/images\006.Least_Auklet/Least_Auklet_0004_795112.jpg,429,340,006.Least_Auklet,120,120,323,221,221,170,203,101
../../CUB_200_2011/images\006.Least_Auklet/Least_Auklet_0023_1898.jpg,500,333,006.Least_Auklet,116,95,388,317,252,206,272,222
../../CUB_200_2011/images\006.Least_Auklet/Least_Auklet_0030_795116.jpg,381,249,006.Least_Auklet,80,82,231,244,155,163,151,162
../../CUB_200_2011/images\006.Least_Auklet/Least_Auklet_0046_795118.jpg,360,360,006.Least_Auklet,109,94,273,306,191,200,164,212
../../CUB_200_2011/images\006.Least_Auklet/Least_Auklet_0005_795119.jpg,271,404,006.Least_Auklet,31,107,201,325,116,216,170,218
../../CUB_200_2011/images\006.Least_Auklet/Least_Auklet_0024_795120.jpg,271,404,006.Least_Auklet,1,106,193,402,97,254,192,296
../../CUB_200_2011/images\006.Least_Auklet/Least_Auklet_0029_795122.jpg,404,271,006.Least_Auklet,95,69,256,199,175,134,161,130
../../CUB_200_2011/images\006.Least_Auklet/Least_Auklet_0007_795123.jpg,200,262,006.Least_Auklet,17,25,195,262,106,143,178,237
../../CUB_200_2011/images\006.Least_Auklet/Least_Auklet_0057_795126.jpg,359,500,006.Least_Auklet,175,217,332,396,253,306,157,179
../../CUB_200_2011/images\006.Least_Auklet/Least_Auklet_0021_795127.jpg,500,426,006.Least_Auklet,122,70,350,331,236,200,228,261
../../CUB_200_2011/images\006.Least_Auklet/Least_Auklet_0054_795130.jpg,277,500,006.Least_Auklet,85,87,232,319,158,203,147,232
../../CUB_200_2011/images\006.Least_Auklet/Least_Auklet_0038_795132.jpg,500,373,006.Least_Auklet,134,74,266,236,200,155,132,162
../../CUB_200_2011/images\006.Least_Auklet/Least_Auklet_0063_795134.jpg,438,500,006.Least_Auklet,21,10,410,471,215,240,389,461
../../CUB_200_2011/images\007.Parakeet_Auklet/Parakeet_Auklet_0004_795921.jpg,398,500,007.Parakeet_Auklet,71,77,339,421,205,249,268,344
../../CUB_200_2011/images\007.Parakeet_Auklet/Parakeet_Auklet_0017_795924.jpg,500,366,007.Parakeet_Auklet,138,55,476,314,307,184,338,259
../../CUB_200_2011/images\007.Parakeet_Auklet/Parakeet_Auklet_0027_795925.jpg,355,500,007.Parakeet_Auklet,56,89,245,462,150,275,189,373
../../CUB_200_2011/images\007.Parakeet_Auklet/Parakeet_Auklet_0056_795926.jpg,500,356,007.Parakeet_Auklet,13,42,362,354,187,198,349,312
../../CUB_200_2011/images\007.Parakeet_Auklet/Parakeet_Auklet_0012_795927.jpg,348,500,007.Parakeet_Auklet,106,92,303,380,204,236,197,288
../../CUB_200_2011/images\007.Parakeet_Auklet/Parakeet_Auklet_0072_795929.jpg,335,500,007.Parakeet_Auklet,194,139,305,384,249,261,111,245
../../CUB_200_2011/images\007.Parakeet_Auklet/Parakeet_Auklet_0030_795930.jpg,365,500,007.Parakeet_Auklet,71,66,217,294,144,180,146,228
../../CUB_200_2011/images\007.Parakeet_Auklet/Parakeet_Auklet_0007_795932.jpg,365,243,007.Parakeet_Auklet,117,45,223,233,170,139,106,188
../../CUB_200_2011/images\007.Parakeet_Auklet/Parakeet_Auklet_0041_795933.jpg,230,178,007.Parakeet_Auklet,40,22,153,173,96,97,113,151
../../CUB_200_2011/images\007.Parakeet_Auklet/Parakeet_Auklet_0035_795934.jpg,350,466,007.Parakeet_Auklet,66,87,271,365,168,226,205,278
../../CUB_200_2011/images\007.Parakeet_Auklet/Parakeet_Auklet_0038_795935.jpg,352,500,007.Parakeet_Auklet,68,133,344,434,206,283,276,301
../../CUB_200_2011/images\007.Parakeet_Auklet/Parakeet_Auklet_0069_795936.jpg,500,408,007.Parakeet_Auklet,138,73,429,385,283,229,291,312
../../CUB_200_2011/images\007.Parakeet_Auklet/Parakeet_Auklet_0073_795939.jpg,500,344,007.Parakeet_Auklet,145,94,269,257,207,175,124,163
../../CUB_200_2011/images\007.Parakeet_Auklet/Parakeet_Auklet_0058_795942.jpg,319,480,007.Parakeet_Auklet,126,147,295,392,210,269,169,245
../../CUB_200_2011/images\007.Parakeet_Auklet/Parakeet_Auklet_0036_795943.jpg,500,375,007.Parakeet_Auklet,162,11,336,375,249,193,174,364
../../CUB_200_2011/images\007.Parakeet_Auklet/Parakeet_Auklet_0028_795944.jpg,357,500,007.Parakeet_Auklet,120,172,303,450,211,311,183,278
../../CUB_200_2011/images\007.Parakeet_Auklet/Parakeet_Auklet_0020_795947.jpg,351,500,007.Parakeet_Auklet,88,96,310,481,199,288,222,385
../../CUB_200_2011/images\007.Parakeet_Auklet/Parakeet_Auklet_0043_795948.jpg,500,333,007.Parakeet_Auklet,185,6,343,323,264,164,158,317
../../CUB_200_2011/images\007.Parakeet_Auklet/Parakeet_Auklet_0045_795953.jpg,363,500,007.Parakeet_Auklet,105,96,352,414,228,255,247,318
../../CUB_200_2011/images\007.Parakeet_Auklet/Parakeet_Auklet_0064_795954.jpg,351,500,007.Parakeet_Auklet,94,92,319,432,206,262,225,340
../../CUB_200_2011/images\007.Parakeet_Auklet/Parakeet_Auklet_0039_795955.jpg,500,375,007.Parakeet_Auklet,112,31,274,309,193,170,162,278
../../CUB_200_2011/images\007.Parakeet_Auklet/Parakeet_Auklet_0047_795956.jpg,369,500,007.Parakeet_Auklet,50,164,239,443,144,303,189,279
../../CUB_200_2011/images\007.Parakeet_Auklet/Parakeet_Auklet_0050_795957.jpg,500,363,007.Parakeet_Auklet,149,64,429,334,289,199,280,270
../../CUB_200_2011/images\007.Parakeet_Auklet/Parakeet_Auklet_0062_795958.jpg,363,500,007.Parakeet_Auklet,48,107,261,426,154,266,213,319
../../CUB_200_2011/images\007.Parakeet_Auklet/Parakeet_Auklet_0031_795960.jpg,500,334,007.Parakeet_Auklet,92,39,283,239,187,139,191,200
../../CUB_200_2011/images\007.Parakeet_Auklet/Parakeet_Auklet_0042_795961.jpg,500,348,007.Parakeet_Auklet,123,32,487,308,305,170,364,276
../../CUB_200_2011/images\007.Parakeet_Auklet/Parakeet_Auklet_0026_795962.jpg,334,500,007.Parakeet_Auklet,81,141,254,487,167,314,173,346
../../CUB_200_2011/images\007.Parakeet_Auklet/Parakeet_Auklet_0055_795963.jpg,500,334,007.Parakeet_Auklet,218,48,444,285,331,166,226,237
../../CUB_200_2011/images\007.Parakeet_Auklet/Parakeet_Auklet_0067_795964.jpg,334,500,007.Parakeet_Auklet,50,81,199,294,124,187,149,213
../../CUB_200_2011/images\007.Parakeet_Auklet/Parakeet_Auklet_0080_795965.jpg,500,360,007.Parakeet_Auklet,169,89,398,329,283,209,229,240
../../CUB_200_2011/images\007.Parakeet_Auklet/Parakeet_Auklet_0015_795966.jpg,350,350,007.Parakeet_Auklet,61,83,297,224,179,153,236,141
../../CUB_200_2011/images\007.Parakeet_Auklet/Parakeet_Auklet_0065_795969.jpg,300,254,007.Parakeet_Auklet,60,49,236,191,148,120,176,142
../../CUB_200_2011/images\007.Parakeet_Auklet/Parakeet_Auklet_0013_795970.jpg,500,375,007.Parakeet_Auklet,33,72,395,311,214,191,362,239
../../CUB_200_2011/images\007.Parakeet_Auklet/Parakeet_Auklet_0051_795971.jpg,500,333,007.Parakeet_Auklet,164,84,342,312,253,198,178,228
../../CUB_200_2011/images\007.Parakeet_Auklet/Parakeet_Auklet_0001_795972.jpg,334,500,007.Parakeet_Auklet,90,100,315,414,202,257,225,314
../../CUB_200_2011/images\007.Parakeet_Auklet/Parakeet_Auklet_0059_795973.jpg,500,334,007.Parakeet_Auklet,65,47,256,163,160,105,191,116
../../CUB_200_2011/images\007.Parakeet_Auklet/Parakeet_Auklet_0040_795974.jpg,497,500,007.Parakeet_Auklet,248,170,389,396,318,283,141,226
../../CUB_200_2011/images\007.Parakeet_Auklet/Parakeet_Auklet_0025_795975.jpg,458,500,007.Parakeet_Auklet,114,92,343,418,228,255,229,326
../../CUB_200_2011/images\007.Parakeet_Auklet/Parakeet_Auklet_0074_795976.jpg,500,341,007.Parakeet_Auklet,78,61,489,340,283,200,411,279
../../CUB_200_2011/images\007.Parakeet_Auklet/Parakeet_Auklet_0016_795977.jpg,500,344,007.Parakeet_Auklet,185,49,417,321,301,185,232,272
../../CUB_200_2011/images\007.Parakeet_Auklet/Parakeet_Auklet_0048_795980.jpg,334,500,007.Parakeet_Auklet,81,62,270,474,175,268,189,412
../../CUB_200_2011/images\007.Parakeet_Auklet/Parakeet_Auklet_0075_795981.jpg,500,500,007.Parakeet_Auklet,142,111,340,438,241,274,198,327
../../CUB_200_2011/images\007.Parakeet_Auklet/Parakeet_Auklet_0003_795982.jpg,333,500,007.Parakeet_Auklet,90,57,314,474,202,265,224,417
../../CUB_200_2011/images\007.Parakeet_Auklet/Parakeet_Auklet_0032_795986.jpg,121,170,007.Parakeet_Auklet,9,40,118,169,63,104,109,129
../../CUB_200_2011/images\007.Parakeet_Auklet/Parakeet_Auklet_0019_795987.jpg,229,284,007.Parakeet_Auklet,0,22,197,283,98,152,197,261
../../CUB_200_2011/images\007.Parakeet_Auklet/Parakeet_Auklet_0061_795990.jpg,365,500,007.Parakeet_Auklet,48,82,282,391,165,236,234,309
../../CUB_200_2011/images\007.Parakeet_Auklet/Parakeet_Auklet_0008_795992.jpg,500,395,007.Parakeet_Auklet,123,30,382,377,252,203,259,347
../../CUB_200_2011/images\007.Parakeet_Auklet/Parakeet_Auklet_0034_795994.jpg,360,430,007.Parakeet_Auklet,47,76,228,325,137,200,181,249
../../CUB_200_2011/images\007.Parakeet_Auklet/Parakeet_Auklet_0010_795995.jpg,366,500,007.Parakeet_Auklet,49,155,279,399,164,277,230,244
../../CUB_200_2011/images\007.Parakeet_Auklet/Parakeet_Auklet_0070_795998.jpg,200,150,007.Parakeet_Auklet,9,12,163,149,86,80,154,137
../../CUB_200_2011/images\007.Parakeet_Auklet/Parakeet_Auklet_0076_796001.jpg,358,500,007.Parakeet_Auklet,86,90,254,445,170,267,168,355
../../CUB_200_2011/images\007.Parakeet_Auklet/Parakeet_Auklet_0078_2004.jpg,333,500,007.Parakeet_Auklet,73,67,250,468,161,267,177,401
../../CUB_200_2011/images\007.Parakeet_Auklet/Parakeet_Auklet_0024_2045.jpg,401,500,007.Parakeet_Auklet,178,129,313,284,245,206,135,155
../../CUB_200_2011/images\008.Rhinoceros_Auklet/Rhinoceros_Auklet_0028_2056.jpg,500,335,008.Rhinoceros_Auklet,28,72,466,239,247,155,438,167
../../CUB_200_2011/images\008.Rhinoceros_Auklet/Rhinoceros_Auklet_0020_2195.jpg,500,500,008.Rhinoceros_Auklet,172,148,389,283,280,215,217,135
../../CUB_200_2011/images\008.Rhinoceros_Auklet/Rhinoceros_Auklet_0021_2089.jpg,500,323,008.Rhinoceros_Auklet,0,10,495,322,247,166,495,312
../../CUB_200_2011/images\008.Rhinoceros_Auklet/Rhinoceros_Auklet_0043_2096.jpg,500,393,008.Rhinoceros_Auklet,0,6,360,392,180,199,360,386
../../CUB_200_2011/images\008.Rhinoceros_Auklet/Rhinoceros_Auklet_0042_2101.jpg,500,333,008.Rhinoceros_Auklet,3,78,468,332,235,205,465,254
../../CUB_200_2011/images\008.Rhinoceros_Auklet/Rhinoceros_Auklet_0027_797496.jpg,500,333,008.Rhinoceros_Auklet,30,112,387,289,208,200,357,177
../../CUB_200_2011/images\008.Rhinoceros_Auklet/Rhinoceros_Auklet_0034_797497.jpg,420,280,008.Rhinoceros_Auklet,76,61,237,163,156,112,161,102
../../CUB_200_2011/images\008.Rhinoceros_Auklet/Rhinoceros_Auklet_0037_797499.jpg,500,405,008.Rhinoceros_Auklet,202,67,411,363,306,215,209,296
../../CUB_200_2011/images\008.Rhinoceros_Auklet/Rhinoceros_Auklet_0023_797501.jpg,500,375,008.Rhinoceros_Auklet,160,87,275,190,217,138,115,103
../../CUB_200_2011/images\008.Rhinoceros_Auklet/Rhinoceros_Auklet_0044_797502.jpg,247,149,008.Rhinoceros_Auklet,49,19,223,124,136,71,174,105
../../CUB_200_2011/images\008.Rhinoceros_Auklet/Rhinoceros_Auklet_0040_797503.jpg,391,500,008.Rhinoceros_Auklet,90,98,300,409,195,253,210,311
../../CUB_200_2011/images\008.Rhinoceros_Auklet/Rhinoceros_Auklet_0016_2114.jpg,500,396,008.Rhinoceros_Auklet,69,60,425,312,247,186,356,252
../../CUB_200_2011/images\008.Rhinoceros_Auklet/Rhinoceros_Auklet_0025_797508.jpg,500,396,008.Rhinoceros_Auklet,127,108,361,223,244,165,234,115
../../CUB_200_2011/images\008.Rhinoceros_Auklet/Rhinoceros_Auklet_0030_797509.jpg,500,363,008.Rhinoceros_Auklet,54,99,351,215,202,157,297,116
../../CUB_200_2011/images\008.Rhinoceros_Auklet/Rhinoceros_Auklet_0051_797510.jpg,400,320,008.Rhinoceros_Auklet,126,82,287,214,206,148,161,132
../../CUB_200_2011/images\008.Rhinoceros_Auklet/Rhinoceros_Auklet_0006_797512.jpg,350,291,008.Rhinoceros_Auklet,46,38,345,195,195,116,299,157
../../CUB_200_2011/images\008.Rhinoceros_Auklet/Rhinoceros_Auklet_0019_797513.jpg,400,290,008.Rhinoceros_Auklet,52,75,223,252,137,163,171,177
../../CUB_200_2011/images\008.Rhinoceros_Auklet/Rhinoceros_Auklet_0041_797515.jpg,400,294,008.Rhinoceros_Auklet,14,34,384,222,199,128,370,188
../../CUB_200_2011/images\008.Rhinoceros_Auklet/Rhinoceros_Auklet_0032_797516.jpg,468,276,008.Rhinoceros_Auklet,87,7,453,268,270,137,366,261
../../CUB_200_2011/images\008.Rhinoceros_Auklet/Rhinoceros_Auklet_0018_797517.jpg,500,334,008.Rhinoceros_Auklet,105,54,409,220,257,137,304,166
../../CUB_200_2011/images\008.Rhinoceros_Auklet/Rhinoceros_Auklet_0031_797518.jpg,500,375,008.Rhinoceros_Auklet,48,61,417,344,232,202,369,283
../../CUB_200_2011/images\008.Rhinoceros_Auklet/Rhinoceros_Auklet_0026_797519.jpg,420,280,008.Rhinoceros_Auklet,77,77,310,187,193,132,233,110
../../CUB_200_2011/images\008.Rhinoceros_Auklet/Rhinoceros_Auklet_0029_797520.jpg,500,375,008.Rhinoceros_Auklet,127,92,301,245,214,168,174,153
../../CUB_200_2011/images\008.Rhinoceros_Auklet/Rhinoceros_Auklet_0007_797521.jpg,418,300,008.Rhinoceros_Auklet,25,43,276,208,150,125,251,165
../../CUB_200_2011/images\008.Rhinoceros_Auklet/Rhinoceros_Auklet_0014_797522.jpg,400,287,008.Rhinoceros_Auklet,23,47,352,221,187,134,329,174
../../CUB_200_2011/images\008.Rhinoceros_Auklet/Rhinoceros_Auklet_0024_797529.jpg,415,271,008.Rhinoceros_Auklet,88,37,319,228,203,132,231,191
../../CUB_200_2011/images\008.Rhinoceros_Auklet/Rhinoceros_Auklet_0011_797530.jpg,300,278,008.Rhinoceros_Auklet,8,18,297,278,152,148,289,260
../../CUB_200_2011/images\008.Rhinoceros_Auklet/Rhinoceros_Auklet_0008_797531.jpg,500,293,008.Rhinoceros_Auklet,96,79,409,191,252,135,313,112
../../CUB_200_2011/images\008.Rhinoceros_Auklet/Rhinoceros_Auklet_0046_797532.jpg,250,167,008.Rhinoceros_Auklet,51,27,189,137,120,82,138,110
../../CUB_200_2011/images\008.Rhinoceros_Auklet/Rhinoceros_Auklet_0050_797534.jpg,500,500,008.Rhinoceros_Auklet,71,84,481,410,276,247,410,326
../../CUB_200_2011/images\008.Rhinoceros_Auklet/Rhinoceros_Auklet_0003_797535.jpg,400,253,008.Rhinoceros_Auklet,86,42,363,225,224,133,277,183
../../CUB_200_2011/images\008.Rhinoceros_Auklet/Rhinoceros_Auklet_0045_797536.jpg,500,375,008.Rhinoceros_Auklet,33,168,280,270,156,219,247,102
../../CUB_200_2011/images\008.Rhinoceros_Auklet/Rhinoceros_Auklet_0013_797537.jpg,250,328,008.Rhinoceros_Auklet,56,71,202,246,129,158,146,175
../../CUB_200_2011/images\008.Rhinoceros_Auklet/Rhinoceros_Auklet_0001_797538.jpg,250,202,008.Rhinoceros_Auklet,72,35,205,140,138,87,133,105
../../CUB_200_2011/images\008.Rhinoceros_Auklet/Rhinoceros_Auklet_0009_797539.jpg,160,128,008.Rhinoceros_Auklet,20,20,152,125,86,72,132,105
../../CUB_200_2011/images\008.Rhinoceros_Auklet/Rhinoceros_Auklet_0004_797541.jpg,500,350,008.Rhinoceros_Auklet,19,36,375,337,197,186,356,301
../../CUB_200_2011/images\008.Rhinoceros_Auklet/Rhinoceros_Auklet_0049_797543.jpg,230,158,008.Rhinoceros_Auklet,40,31,195,140,117,85,155,109
../../CUB_200_2011/images\008.Rhinoceros_Auklet/Rhinoceros_Auklet_0038_797544.jpg,500,273,008.Rhinoceros_Auklet,13,107,343,253,178,180,330,146
../../CUB_200_2011/images\008.Rhinoceros_Auklet/Rhinoceros_Auklet_0010_797545.jpg,500,265,008.Rhinoceros_Auklet,59,15,325,190,192,102,266,175
../../CUB_200_2011/images\008.Rhinoceros_Auklet/Rhinoceros_Auklet_0017_2155.jpg,500,375,008.Rhinoceros_Auklet,31,119,279,285,155,202,248,166
../../CUB_200_2011/images\008.Rhinoceros_Auklet/Rhinoceros_Auklet_0015_2160.jpg,500,407,008.Rhinoceros_Auklet,145,103,367,292,256,197,222,189
../../CUB_200_2011/images\008.Rhinoceros_Auklet/Rhinoceros_Auklet_0012_2161.jpg,500,358,008.Rhinoceros_Auklet,161,82,326,231,243,156,165,149
../../CUB_200_2011/images\008.Rhinoceros_Auklet/Rhinoceros_Auklet_0048_2162.jpg,500,375,008.Rhinoceros_Auklet,109,72,379,305,244,188,270,233
../../CUB_200_2011/images\008.Rhinoceros_Auklet/Rhinoceros_Auklet_0035_2166.jpg,500,333,008.Rhinoceros_Auklet,146,96,431,245,288,170,285,149
../../CUB_200_2011/images\008.Rhinoceros_Auklet/Rhinoceros_Auklet_0033_2169.jpg,500,375,008.Rhinoceros_Auklet,54,75,358,304,206,189,304,229
../../CUB_200_2011/images\008.Rhinoceros_Auklet/Rhinoceros_Auklet_0022_2170.jpg,500,333,008.Rhinoceros_Auklet,227,130,415,232,321,181,188,102
../../CUB_200_2011/images\008.Rhinoceros_Auklet/Rhinoceros_Auklet_0005_2111.jpg,500,500,008.Rhinoceros_Auklet,4,29,499,499,251,264,495,470
../../CUB_200_2011/images\008.Rhinoceros_Auklet/Rhinoceros_Auklet_0039_2174.jpg,500,333,008.Rhinoceros_Auklet,157,111,263,211,210,161,106,100
../../CUB_200_2011/images\009.Brewer_Blackbird/Brewer_Blackbird_0099_2560.jpg,500,319,009.Brewer_Blackbird,107,34,497,316,302,175,390,282
../../CUB_200_2011/images\009.Brewer_Blackbird/Brewer_Blackbird_0139_2567.jpg,334,500,009.Brewer_Blackbird,7,122,303,486,155,304,296,364
../../CUB_200_2011/images\009.Brewer_Blackbird/Brewer_Blackbird_0140_2586.jpg,375,500,009.Brewer_Blackbird,90,77,282,390,186,233,192,313
../../CUB_200_2011/images\009.Brewer_Blackbird/Brewer_Blackbird_0082_2593.jpg,500,375,009.Brewer_Blackbird,77,41,322,326,199,183,245,285
../../CUB_200_2011/images\009.Brewer_Blackbird/Brewer_Blackbird_0135_2607.jpg,375,500,009.Brewer_Blackbird,90,119,271,429,180,274,181,310
../../CUB_200_2011/images\009.Brewer_Blackbird/Brewer_Blackbird_0106_2608.jpg,500,350,009.Brewer_Blackbird,104,120,303,278,203,199,199,158
../../CUB_200_2011/images\009.Brewer_Blackbird/Brewer_Blackbird_0095_2610.jpg,500,375,009.Brewer_Blackbird,76,77,369,352,222,214,293,275
../../CUB_200_2011/images\009.Brewer_Blackbird/Brewer_Blackbird_0035_2611.jpg,500,311,009.Brewer_Blackbird,73,72,483,264,278,168,410,192
../../CUB_200_2011/images\009.Brewer_Blackbird/Brewer_Blackbird_0111_2613.jpg,500,333,009.Brewer_Blackbird,117,48,441,253,279,150,324,205
../../CUB_200_2011/images\009.Brewer_Blackbird/Brewer_Blackbird_0009_2616.jpg,500,423,009.Brewer_Blackbird,102,104,429,284,265,194,327,180
../../CUB_200_2011/images\009.Brewer_Blackbird/Brewer_Blackbird_0102_2620.jpg,500,386,009.Brewer_Blackbird,201,114,437,305,319,209,236,191
../../CUB_200_2011/images\009.Brewer_Blackbird/Brewer_Blackbird_0087_2622.jpg,500,369,009.Brewer_Blackbird,192,181,488,352,340,266,296,171
../../CUB_200_2011/images\009.Brewer_Blackbird/Brewer_Blackbird_0026_2625.jpg,500,298,009.Brewer_Blackbird,42,37,383,258,212,147,341,221
../../CUB_200_2011/images\009.Brewer_Blackbird/Brewer_Blackbird_0101_2630.jpg,423,500,009.Brewer_Blackbird,71,144,260,463,165,303,189,319
../../CUB_200_2011/images\009.Brewer_Blackbird/Brewer_Blackbird_0054_2631.jpg,500,464,009.Brewer_Blackbird,85,137,375,330,230,233,290,193
../../CUB_200_2011/images\009.Brewer_Blackbird/Brewer_Blackbird_0096_2634.jpg,500,402,009.Brewer_Blackbird,166,53,377,302,271,177,211,249
../../CUB_200_2011/images\009.Brewer_Blackbird/Brewer_Blackbird_0142_2636.jpg,500,333,009.Brewer_Blackbird,153,77,410,328,281,202,257,251
../../CUB_200_2011/images\009.Brewer_Blackbird/Brewer_Blackbird_0041_2653.jpg,500,439,009.Brewer_Blackbird,101,95,344,287,222,191,243,192
../../CUB_200_2011/images\009.Brewer_Blackbird/Brewer_Blackbird_0090_2658.jpg,500,400,009.Brewer_Blackbird,64,27,392,238,228,132,328,211
../../CUB_200_2011/images\009.Brewer_Blackbird/Brewer_Blackbird_0078_2659.jpg,500,402,009.Brewer_Blackbird,50,42,272,361,161,201,222,319
../../CUB_200_2011/images\009.Brewer_Blackbird/Brewer_Blackbird_0017_2668.jpg,500,334,009.Brewer_Blackbird,212,111,376,235,294,173,164,124
../../CUB_200_2011/images\009.Brewer_Blackbird/Brewer_Blackbird_0014_2679.jpg,459,500,009.Brewer_Blackbird,271,32,395,485,333,258,124,453
../../CUB_200_2011/images\009.Brewer_Blackbird/Brewer_Blackbird_0137_2680.jpg,500,500,009.Brewer_Blackbird,161,41,336,415,248,228,175,374
../../CUB_200_2011/images\009.Brewer_Blackbird/Brewer_Blackbird_0028_2682.jpg,500,333,009.Brewer_Blackbird,47,26,424,293,235,159,377,267
../../CUB_200_2011/images\009.Brewer_Blackbird/Brewer_Blackbird_0046_2688.jpg,494,500,009.Brewer_Blackbird,214,98,442,364,328,231,228,266
../../CUB_200_2011/images\009.Brewer_Blackbird/Brewer_Blackbird_0012_2691.jpg,500,352,009.Brewer_Blackbird,103,83,289,238,196,160,186,155
../../CUB_200_2011/images\009.Brewer_Blackbird/Brewer_Blackbird_0066_2693.jpg,500,364,009.Brewer_Blackbird,9,104,330,276,169,190,321,172
../../CUB_200_2011/images\009.Brewer_Blackbird/Brewer_Blackbird_0032_2214.jpg,500,332,009.Brewer_Blackbird,128,38,379,308,253,173,251,270
../../CUB_200_2011/images\009.Brewer_Blackbird/Brewer_Blackbird_0016_2225.jpg,500,334,009.Brewer_Blackbird,101,63,334,250,217,156,233,187
../../CUB_200_2011/images\009.Brewer_Blackbird/Brewer_Blackbird_0104_2230.jpg,300,200,009.Brewer_Blackbird,76,25,229,176,152,100,153,151
../../CUB_200_2011/images\009.Brewer_Blackbird/Brewer_Blackbird_0025_2231.jpg,500,375,009.Brewer_Blackbird,204,14,487,281,345,147,283,267
../../CUB_200_2011/images\009.Brewer_Blackbird/Brewer_Blackbird_0109_2232.jpg,500,364,009.Brewer_Blackbird,202,143,342,296,272,219,140,153
../../CUB_200_2011/images\009.Brewer_Blackbird/Brewer_Blackbird_0080_2234.jpg,500,333,009.Brewer_Blackbird,149,48,426,235,287,141,277,187
../../CUB_200_2011/images\009.Brewer_Blackbird/Brewer_Blackbird_0127_2235.jpg,500,375,009.Brewer_Blackbird,159,72,450,242,304,157,291,170
../../CUB_200_2011/images\009.Brewer_Blackbird/Brewer_Blackbird_0049_2258.jpg,500,355,009.Brewer_Blackbird,96,114,387,269,241,191,291,155
../../CUB_200_2011/images\009.Brewer_Blackbird/Brewer_Blackbird_0018_2261.jpg,500,332,009.Brewer_Blackbird,144,88,408,277,276,182,264,189
../../CUB_200_2011/images\009.Brewer_Blackbird/Brewer_Blackbird_0030_2268.jpg,500,448,009.Brewer_Blackbird,16,80,433,334,224,207,417,254
../../CUB_200_2011/images\009.Brewer_Blackbird/Brewer_Blackbird_0010_2269.jpg,480,397,009.Brewer_Blackbird,28,34,445,352,236,193,417,318
../../CUB_200_2011/images\009.Brewer_Blackbird/Brewer_Blackbird_0061_2270.jpg,357,500,009.Brewer_Blackbird,56,83,333,404,194,243,277,321
../../CUB_200_2011/images\009.Brewer_Blackbird/Brewer_Blackbird_0103_2273.jpg,500,375,009.Brewer_Blackbird,140,53,331,314,235,183,191,261
../../CUB_200_2011/images\009.Brewer_Blackbird/Brewer_Blackbird_0074_2277.jpg,500,243,009.Brewer_Blackbird,48,86,174,190,111,138,126,104
../../CUB_200_2011/images\009.Brewer_Blackbird/Brewer_Blackbird_0002_2278.jpg,500,466,009.Brewer_Blackbird,134,126,341,396,237,261,207,270
../../CUB_200_2011/images\009.Brewer_Blackbird/Brewer_Blackbird_0115_2279.jpg,500,333,009.Brewer_Blackbird,242,71,449,245,345,158,207,174
../../CUB_200_2011/images\009.Brewer_Blackbird/Brewer_Blackbird_0015_2286.jpg,500,415,009.Brewer_Blackbird,74,112,311,351,192,231,237,239
../../CUB_200_2011/images\009.Brewer_Blackbird/Brewer_Blackbird_0131_2289.jpg,500,375,009.Brewer_Blackbird,117,86,485,283,301,184,368,197
../../CUB_200_2011/images\009.Brewer_Blackbird/Brewer_Blackbird_0064_2290.jpg,500,321,009.Brewer_Blackbird,147,29,440,309,293,169,293,280
../../CUB_200_2011/images\009.Brewer_Blackbird/Brewer_Blackbird_0132_2293.jpg,500,374,009.Brewer_Blackbird,54,33,286,355,170,194,232,322
../../CUB_200_2011/images\009.Brewer_Blackbird/Brewer_Blackbird_0038_2294.jpg,500,358,009.Brewer_Blackbird,35,18,408,350,221,184,373,332
../../CUB_200_2011/images\009.Brewer_Blackbird/Brewer_Blackbird_0042_2302.jpg,500,362,009.Brewer_Blackbird,9,16,497,355,253,185,488,339
../../CUB_200_2011/images\009.Brewer_Blackbird/Brewer_Blackbird_0045_2303.jpg,500,500,009.Brewer_Blackbird,3,43,387,427,195,235,384,384
../../CUB_200_2011/images\009.Brewer_Blackbird/Brewer_Blackbird_0065_2310.jpg,333,500,009.Brewer_Blackbird,73,112,263,412,168,262,190,300
../../CUB_200_2011/images\009.Brewer_Blackbird/Brewer_Blackbird_0097_2322.jpg,500,375,009.Brewer_Blackbird,62,33,499,374,280,203,437,341
../../CUB_200_2011/images\009.Brewer_Blackbird/Brewer_Blackbird_0133_2324.jpg,408,500,009.Brewer_Blackbird,58,48,349,443,203,245,291,395
../../CUB_200_2011/images\009.Brewer_Blackbird/Brewer_Blackbird_0070_2325.jpg,402,500,009.Brewer_Blackbird,65,224,388,462,226,343,323,238
../../CUB_200_2011/images\009.Brewer_Blackbird/Brewer_Blackbird_0116_2327.jpg,500,352,009.Brewer_Blackbird,214,42,436,332,325,187,222,290
../../CUB_200_2011/images\009.Brewer_Blackbird/Brewer_Blackbird_0027_2329.jpg,500,400,009.Brewer_Blackbird,218,82,452,376,335,229,234,294
../../CUB_200_2011/images\009.Brewer_Blackbird/Brewer_Blackbird_0112_2340.jpg,500,398,009.Brewer_Blackbird,21,43,426,371,223,207,405,328
../../CUB_200_2011/images\009.Brewer_Blackbird/Brewer_Blackbird_0079_2343.jpg,500,491,009.Brewer_Blackbird,82,52,408,428,245,240,326,376
../../CUB_200_2011/images\009.Brewer_Blackbird/Brewer_Blackbird_0004_2345.jpg,500,497,009.Brewer_Blackbird,95,73,377,393,236,233,282,320
../../CUB_200_2011/images\010.Red_winged_Blackbird/Red_Winged_Blackbird_0091_4096.jpg,500,439,010.Red_winged_Blackbird,187,129,318,355,252,242,131,226
../../CUB_200_2011/images\010.Red_winged_Blackbird/Red_Winged_Blackbird_0059_4612.jpg,500,356,010.Red_winged_Blackbird,130,124,481,329,305,226,351,205
../../CUB_200_2011/images\010.Red_winged_Blackbird/Red_Winged_Blackbird_0054_4625.jpg,400,500,010.Red_winged_Blackbird,138,137,264,397,201,267,126,260
../../CUB_200_2011/images\010.Red_winged_Blackbird/Red_Winged_Blackbird_0022_4483.jpg,374,500,010.Red_winged_Blackbird,110,144,281,300,195,222,171,156
../../CUB_200_2011/images\010.Red_winged_Blackbird/Red_Winged_Blackbird_0017_4116.jpg,500,400,010.Red_winged_Blackbird,218,39,423,399,320,219,205,360
../../CUB_200_2011/images\010.Red_winged_Blackbird/Red_Winged_Blackbird_0079_4527.jpg,500,335,010.Red_winged_Blackbird,75,74,330,264,202,169,255,190
../../CUB_200_2011/images\010.Red_winged_Blackbird/Red_Winged_Blackbird_0075_4953.jpg,500,375,010.Red_winged_Blackbird,208,180,308,288,258,234,100,108
../../CUB_200_2011/images\010.Red_winged_Blackbird/Red_Winged_Blackbird_0005_5636.jpg,500,322,010.Red_winged_Blackbird,147,39,284,316,215,177,137,277
../../CUB_200_2011/images\010.Red_winged_Blackbird/Red_Winged_Blackbird_0058_4141.jpg,500,375,010.Red_winged_Blackbird,141,148,314,322,227,235,173,174
../../CUB_200_2011/images\010.Red_winged_Blackbird/Red_Winged_Blackbird_0074_4146.jpg,500,301,010.Red_winged_Blackbird,204,101,384,223,294,162,180,122
../../CUB_200_2011/images\010.Red_winged_Blackbird/Red_Winged_Blackbird_0042_3635.jpg,347,500,010.Red_winged_Blackbird,21,178,311,323,166,250,290,145
../../CUB_200_2011/images\010.Red_winged_Blackbird/Red_Winged_Blackbird_0049_5598.jpg,342,500,010.Red_winged_Blackbird,88,101,322,283,205,192,234,182
../../CUB_200_2011/images\010.Red_winged_Blackbird/Red_Winged_Blackbird_0023_5257.jpg,420,498,010.Red_winged_Blackbird,112,143,330,362,221,252,218,219
../../CUB_200_2011/images\010.Red_winged_Blackbird/Red_Winged_Blackbird_0093_5948.jpg,375,500,010.Red_winged_Blackbird,77,95,232,317,154,206,155,222
../../CUB_200_2011/images\010.Red_winged_Blackbird/Red_Winged_Blackbird_0064_4936.jpg,500,386,010.Red_winged_Blackbird,39,128,334,316,186,222,295,188
../../CUB_200_2011/images\010.Red_winged_Blackbird/Red_Winged_Blackbird_0104_3918.jpg,500,334,010.Red_winged_Blackbird,159,90,268,229,213,159,109,139
../../CUB_200_2011/images\010.Red_winged_Blackbird/Red_Winged_Blackbird_0060_4688.jpg,500,355,010.Red_winged_Blackbird,121,103,475,294,298,198,354,191
../../CUB_200_2011/images\010.Red_winged_Blackbird/Red_Winged_Blackbird_0024_4180.jpg,500,332,010.Red_winged_Blackbird,74,15,499,331,286,173,425,316
../../CUB_200_2011/images\010.Red_winged_Blackbird/Red_Winged_Blackbird_0061_4196.jpg,500,317,010.Red_winged_Blackbird,15,90,381,294,198,192,366,204
../../CUB_200_2011/images\010.Red_winged_Blackbird/Red_Winged_Blackbird_0089_4188.jpg,500,348,010.Red_winged_Blackbird,142,68,474,280,308,174,332,212
../../CUB_200_2011/images\010.Red_winged_Blackbird/Red_Winged_Blackbird_0101_6244.jpg,500,332,010.Red_winged_Blackbird,82,60,364,271,223,165,282,211
../../CUB_200_2011/images\010.Red_winged_Blackbird/Red_Winged_Blackbird_0028_4709.jpg,408,500,010.Red_winged_Blackbird,52,142,303,344,177,243,251,202
../../CUB_200_2011/images\010.Red_winged_Blackbird/Red_Winged_Blackbird_0109_4454.jpg,500,397,010.Red_winged_Blackbird,4,67,461,327,232,197,457,260
../../CUB_200_2011/images\010.Red_winged_Blackbird/Red_Winged_Blackbird_0001_3695.jpg,500,398,010.Red_winged_Blackbird,149,137,359,338,254,237,210,201
../../CUB_200_2011/images\010.Red_winged_Blackbird/Red_Winged_Blackbird_0053_4072.jpg,500,375,010.Red_winged_Blackbird,136,97,286,267,211,182,150,170
../../CUB_200_2011/images\010.Red_winged_Blackbird/Red_Winged_Blackbird_0006_6005.jpg,500,333,010.Red_winged_Blackbird,142,49,498,291,320,170,356,242
../../CUB_200_2011/images\010.Red_winged_Blackbird/Red_Winged_Blackbird_0007_3706.jpg,500,278,010.Red_winged_Blackbird,72,53,487,235,279,144,415,182
../../CUB_200_2011/images\010.Red_winged_Blackbird/Red_Winged_Blackbird_0012_6015.jpg,500,339,010.Red_winged_Blackbird,116,81,372,274,244,177,256,193
../../CUB_200_2011/images\010.Red_winged_Blackbird/Red_Winged_Blackbird_0013_5762.jpg,473,500,010.Red_winged_Blackbird,60,68,325,435,192,251,265,367
../../CUB_200_2011/images\010.Red_winged_Blackbird/Red_Winged_Blackbird_0062_4233.jpg,357,500,010.Red_winged_Blackbird,115,106,300,444,207,275,185,338
../../CUB_200_2011/images\010.Red_winged_Blackbird/Red_Winged_Blackbird_0099_3985.jpg,446,500,010.Red_winged_Blackbird,82,92,399,457,240,274,317,365
../../CUB_200_2011/images\010.Red_winged_Blackbird/Red_Winged_Blackbird_0046_4242.jpg,500,335,010.Red_winged_Blackbird,108,39,232,212,170,125,124,173
../../CUB_200_2011/images\010.Red_winged_Blackbird/Red_Winged_Blackbird_0071_3988.jpg,500,333,010.Red_winged_Blackbird,2,58,479,316,240,187,477,258
../../CUB_200_2011/images\010.Red_winged_Blackbird/Red_Winged_Blackbird_0027_4123.jpg,500,318,010.Red_winged_Blackbird,200,75,419,317,309,196,219,242
../../CUB_200_2011/images\010.Red_winged_Blackbird/Red_Winged_Blackbird_0032_4004.jpg,356,500,010.Red_winged_Blackbird,36,97,332,425,184,261,296,328
../../CUB_200_2011/images\010.Red_winged_Blackbird/Red_Winged_Blackbird_0088_4007.jpg,500,353,010.Red_winged_Blackbird,41,28,479,302,260,165,438,274
../../CUB_200_2011/images\010.Red_winged_Blackbird/Red_Winged_Blackbird_0040_4522.jpg,500,333,010.Red_winged_Blackbird,156,45,324,296,240,170,168,251
../../CUB_200_2011/images\010.Red_winged_Blackbird/Red_Winged_Blackbird_0010_6386.jpg,424,500,010.Red_winged_Blackbird,25,56,381,458,203,257,356,402
../../CUB_200_2011/images\010.Red_winged_Blackbird/Red_Winged_Blackbird_0045_4526.jpg,400,500,010.Red_winged_Blackbird,53,158,306,344,179,251,253,186
../../CUB_200_2011/images\010.Red_winged_Blackbird/Red_Winged_Blackbird_0014_3761.jpg,333,500,010.Red_winged_Blackbird,63,106,305,413,184,259,242,307
../../CUB_200_2011/images\010.Red_winged_Blackbird/Red_Winged_Blackbird_0021_3767.jpg,500,335,010.Red_winged_Blackbird,108,54,457,334,282,194,349,280
../../CUB_200_2011/images\010.Red_winged_Blackbird/Red_Winged_Blackbird_0065_4026.jpg,500,372,010.Red_winged_Blackbird,189,139,412,325,300,232,223,186
../../CUB_200_2011/images\010.Red_winged_Blackbird/Red_Winged_Blackbird_0039_4285.jpg,333,500,010.Red_winged_Blackbird,85,151,245,356,165,253,160,205
../../CUB_200_2011/images\010.Red_winged_Blackbird/Red_Winged_Blackbird_0081_6081.jpg,500,409,010.Red_winged_Blackbird,237,137,433,360,335,248,196,223
../../CUB_200_2011/images\010.Red_winged_Blackbird/Red_Winged_Blackbird_0029_4804.jpg,500,375,010.Red_winged_Blackbird,184,93,418,260,301,176,234,167
../../CUB_200_2011/images\010.Red_winged_Blackbird/Red_Winged_Blackbird_0052_5575.jpg,500,400,010.Red_winged_Blackbird,104,78,371,346,237,212,267,268
../../CUB_200_2011/images\010.Red_winged_Blackbird/Red_Winged_Blackbird_0096_5019.jpg,500,375,010.Red_winged_Blackbird,29,98,427,319,228,208,398,221
../../CUB_200_2011/images\010.Red_winged_Blackbird/Red_Winged_Blackbird_0066_5070.jpg,500,342,010.Red_winged_Blackbird,94,115,347,237,220,176,253,122
../../CUB_200_2011/images\010.Red_winged_Blackbird/Red_Winged_Blackbird_0009_5841.jpg,500,364,010.Red_winged_Blackbird,75,84,369,305,222,194,294,221
../../CUB_200_2011/images\010.Red_winged_Blackbird/Red_Winged_Blackbird_0020_4050.jpg,500,400,010.Red_winged_Blackbird,228,137,422,362,325,249,194,225
../../CUB_200_2011/images\010.Red_winged_Blackbird/Red_Winged_Blackbird_0011_5845.jpg,500,375,010.Red_winged_Blackbird,255,125,413,241,334,183,158,116
../../CUB_200_2011/images\010.Red_winged_Blackbird/Red_Winged_Blackbird_0085_5846.jpg,365,500,010.Red_winged_Blackbird,103,83,288,492,195,287,185,409
../../CUB_200_2011/images\010.Red_winged_Blackbird/Red_Winged_Blackbird_0047_3802.jpg,500,333,010.Red_winged_Blackbird,193,129,346,279,269,204,153,150
../../CUB_200_2011/images\010.Red_winged_Blackbird/Red_Winged_Blackbird_0025_5342.jpg,500,375,010.Red_winged_Blackbird,50,146,202,248,126,197,152,102
../../CUB_200_2011/images\010.Red_winged_Blackbird/Red_Winged_Blackbird_0094_5856.jpg,354,500,010.Red_winged_Blackbird,95,145,289,373,192,259,194,228
../../CUB_200_2011/images\010.Red_winged_Blackbird/Red_Winged_Blackbird_0105_4842.jpg,500,406,010.Red_winged_Blackbird,170,97,361,321,265,209,191,224
../../CUB_200_2011/images\010.Red_winged_Blackbird/Red_Winged_Blackbird_0072_4338.jpg,500,333,010.Red_winged_Blackbird,141,84,400,312,270,198,259,228
../../CUB_200_2011/images\010.Red_winged_Blackbird/Red_Winged_Blackbird_0044_5621.jpg,500,475,010.Red_winged_Blackbird,17,24,474,474,245,249,457,450
../../CUB_200_2011/images\010.Red_winged_Blackbird/Red_Winged_Blackbird_0055_4345.jpg,500,333,010.Red_winged_Blackbird,145,88,449,283,297,185,304,195
../../CUB_200_2011/images\010.Red_winged_Blackbird/Red_Winged_Blackbird_0078_5372.jpg,500,375,010.Red_winged_Blackbird,133,61,388,276,260,168,255,215
../../CUB_200_2011/images\011.Rusty_Blackbird/Rusty_Blackbird_0086_6658.jpg,400,500,011.Rusty_Blackbird,139,91,313,417,226,254,174,326
../../CUB_200_2011/images\011.Rusty_Blackbird/Rusty_Blackbird_0113_6664.jpg,500,331,011.Rusty_Blackbird,113,79,440,252,276,165,327,173
../../CUB_200_2011/images\011.Rusty_Blackbird/Rusty_Blackbird_0055_6923.jpg,500,375,011.Rusty_Blackbird,75,123,358,345,216,234,283,222
../../CUB_200_2011/images\011.Rusty_Blackbird/Rusty_Blackbird_0054_6676.jpg,500,429,011.Rusty_Blackbird,63,90,407,401,235,245,344,311
../../CUB_200_2011/images\011.Rusty_Blackbird/Rusty_Blackbird_0020_6679.jpg,500,333,011.Rusty_Blackbird,50,65,229,250,139,157,179,185
../../CUB_200_2011/images\011.Rusty_Blackbird/Rusty_Blackbird_0016_6684.jpg,500,333,011.Rusty_Blackbird,10,10,475,323,242,166,465,313
../../CUB_200_2011/images\011.Rusty_Blackbird/Rusty_Blackbird_0104_6685.jpg,500,386,011.Rusty_Blackbird,161,126,387,266,274,196,226,140
../../CUB_200_2011/images\011.Rusty_Blackbird/Rusty_Blackbird_0043_2597.jpg,500,375,011.Rusty_Blackbird,144,80,399,257,271,168,255,177
../../CUB_200_2011/images\011.Rusty_Blackbird/Rusty_Blackbird_0091_6695.jpg,500,305,011.Rusty_Blackbird,73,11,477,285,275,148,404,274
../../CUB_200_2011/images\011.Rusty_Blackbird/Rusty_Blackbird_0109_6698.jpg,500,375,011.Rusty_Blackbird,161,43,348,360,254,201,187,317
../../CUB_200_2011/images\011.Rusty_Blackbird/Rusty_Blackbird_0031_6699.jpg,500,423,011.Rusty_Blackbird,6,8,471,410,238,209,465,402
../../CUB_200_2011/images\011.Rusty_Blackbird/Rusty_Blackbird_0019_6704.jpg,500,391,011.Rusty_Blackbird,121,72,418,307,269,189,297,235
../../CUB_200_2011/images\011.Rusty_Blackbird/Rusty_Blackbird_0081_6967.jpg,500,350,011.Rusty_Blackbird,133,100,449,256,291,178,316,156
../../CUB_200_2011/images\011.Rusty_Blackbird/Rusty_Blackbird_0085_6713.jpg,500,500,011.Rusty_Blackbird,72,71,490,486,281,278,418,415
../../CUB_200_2011/images\011.Rusty_Blackbird/Rusty_Blackbird_0051_6715.jpg,500,383,011.Rusty_Blackbird,139,60,478,308,308,184,339,248
../../CUB_200_2011/images\011.Rusty_Blackbird/Rusty_Blackbird_0076_6716.jpg,500,357,011.Rusty_Blackbird,85,115,367,261,226,188,282,146
../../CUB_200_2011/images\011.Rusty_Blackbird/Rusty_Blackbird_0075_6717.jpg,500,296,011.Rusty_Blackbird,106,43,371,295,238,169,265,252
../../CUB_200_2011/images\011.Rusty_Blackbird/Rusty_Blackbird_0087_6727.jpg,500,493,011.Rusty_Blackbird,113,99,439,366,276,232,326,267
../../CUB_200_2011/images\011.Rusty_Blackbird/Rusty_Blackbird_0122_6736.jpg,500,333,011.Rusty_Blackbird,95,64,365,302,230,183,270,238
../../CUB_200_2011/images\011.Rusty_Blackbird/Rusty_Blackbird_0112_3415.jpg,500,357,011.Rusty_Blackbird,145,165,266,292,205,228,121,127
../../CUB_200_2011/images\011.Rusty_Blackbird/Rusty_Blackbird_0073_6744.jpg,418,218,011.Rusty_Blackbird,88,37,315,151,201,94,227,114
../../CUB_200_2011/images\011.Rusty_Blackbird/Rusty_Blackbird_0003_6749.jpg,500,464,011.Rusty_Blackbird,94,91,352,449,223,270,258,358
../../CUB_200_2011/images\011.Rusty_Blackbird/Rusty_Blackbird_0023_6752.jpg,500,333,011.Rusty_Blackbird,174,25,448,327,311,176,274,302
../../CUB_200_2011/images\011.Rusty_Blackbird/Rusty_Blackbird_0047_7009.jpg,334,500,011.Rusty_Blackbird,80,165,258,272,169,218,178,107
../../CUB_200_2011/images\011.Rusty_Blackbird/Rusty_Blackbird_0017_6755.jpg,500,357,011.Rusty_Blackbird,56,50,456,205,256,127,400,155
../../CUB_200_2011/images\011.Rusty_Blackbird/Rusty_Blackbird_0060_6756.jpg,500,330,011.Rusty_Blackbird,41,77,328,293,184,185,287,216
../../CUB_200_2011/images\011.Rusty_Blackbird/Rusty_Blackbird_0114_6760.jpg,500,375,011.Rusty_Blackbird,2,46,438,373,220,209,436,327
../../CUB_200_2011/images\011.Rusty_Blackbird/Rusty_Blackbird_0120_6762.jpg,500,375,011.Rusty_Blackbird,22,151,391,329,206,240,369,178
../../CUB_200_2011/images\011.Rusty_Blackbird/Rusty_Blackbird_0026_6768.jpg,500,357,011.Rusty_Blackbird,83,141,342,319,212,230,259,178
../../CUB_200_2011/images\011.Rusty_Blackbird/Rusty_Blackbird_0005_6771.jpg,500,333,011.Rusty_Blackbird,24,57,484,313,254,185,460,256
../../CUB_200_2011/images\011.Rusty_Blackbird/Rusty_Blackbird_0011_7028.jpg,500,335,011.Rusty_Blackbird,58,94,365,306,211,200,307,212
../../CUB_200_2011/images\011.Rusty_Blackbird/Rusty_Blackbird_0102_6590.jpg,500,328,011.Rusty_Blackbird,29,42,354,260,191,151,325,218
../../CUB_200_2011/images\011.Rusty_Blackbird/Rusty_Blackbird_0006_6633.jpg,500,411,011.Rusty_Blackbird,188,92,308,310,248,201,120,218
../../CUB_200_2011/images\011.Rusty_Blackbird/Rusty_Blackbird_0001_6548.jpg,500,333,011.Rusty_Blackbird,88,39,393,318,240,178,305,279
../../CUB_200_2011/images\011.Rusty_Blackbird/Rusty_Blackbird_0052_7035.jpg,500,352,011.Rusty_Blackbird,61,134,287,289,174,211,226,155
../../CUB_200_2011/images\011.Rusty_Blackbird/Rusty_Blackbird_0057_6935.jpg,500,377,011.Rusty_Blackbird,137,105,310,271,223,188,173,166
../../CUB_200_2011/images\011.Rusty_Blackbird/Rusty_Blackbird_0111_3220.jpg,500,379,011.Rusty_Blackbird,114,91,367,307,240,199,253,216
../../CUB_200_2011/images\011.Rusty_Blackbird/Rusty_Blackbird_0036_6550.jpg,500,407,011.Rusty_Blackbird,93,83,472,401,282,242,379,318
../../CUB_200_2011/images\011.Rusty_Blackbird/Rusty_Blackbird_0105_6937.jpg,418,500,011.Rusty_Blackbird,81,121,339,419,210,270,258,298
../../CUB_200_2011/images\011.Rusty_Blackbird/Rusty_Blackbird_0022_6808.jpg,500,368,011.Rusty_Blackbird,140,65,413,295,276,180,273,230
../../CUB_200_2011/images\011.Rusty_Blackbird/Rusty_Blackbird_0100_6597.jpg,500,441,011.Rusty_Blackbird,88,121,317,265,202,193,229,144
../../CUB_200_2011/images\011.Rusty_Blackbird/Rusty_Blackbird_0092_2727.jpg,500,334,011.Rusty_Blackbird,160,106,287,249,223,177,127,143
../../CUB_200_2011/images\011.Rusty_Blackbird/Rusty_Blackbird_0094_6582.jpg,500,489,011.Rusty_Blackbird,96,64,390,458,243,261,294,394
../../CUB_200_2011/images\011.Rusty_Blackbird/Rusty_Blackbird_0107_6839.jpg,468,500,011.Rusty_Blackbird,32,110,281,375,156,242,249,265
../../CUB_200_2011/images\011.Rusty_Blackbird/Rusty_Blackbird_0074_6585.jpg,500,373,011.Rusty_Blackbird,161,65,398,346,279,205,237,281
../../CUB_200_2011/images\011.Rusty_Blackbird/Rusty_Blackbird_0096_6846.jpg,500,400,011.Rusty_Blackbird,86,148,410,300,248,224,324,152
../../CUB_200_2011/images\011.Rusty_Blackbird/Rusty_Blackbird_0027_6593.jpg,500,333,011.Rusty_Blackbird,88,56,256,192,172,124,168,136
../../CUB_200_2011/images\011.Rusty_Blackbird/Rusty_Blackbird_0009_6853.jpg,497,500,011.Rusty_Blackbird,177,175,335,341,256,258,158,166
../../CUB_200_2011/images\011.Rusty_Blackbird/Rusty_Blackbird_0056_6856.jpg,500,401,011.Rusty_Blackbird,151,98,311,321,231,209,160,223
../../CUB_200_2011/images\011.Rusty_Blackbird/Rusty_Blackbird_0108_6867.jpg,500,349,011.Rusty_Blackbird,210,120,366,269,288,194,156,149
../../CUB_200_2011/images\011.Rusty_Blackbird/Rusty_Blackbird_0080_6877.jpg,500,332,011.Rusty_Blackbird,102,49,249,182,175,115,147,133
../../CUB_200_2011/images\011.Rusty_Blackbird/Rusty_Blackbird_0033_6879.jpg,500,333,011.Rusty_Blackbird,87,68,282,224,184,146,195,156
../../CUB_200_2011/images\011.Rusty_Blackbird/Rusty_Blackbird_0101_6880.jpg,500,318,011.Rusty_Blackbird,195,92,402,230,298,161,207,138
../../CUB_200_2011/images\011.Rusty_Blackbird/Rusty_Blackbird_0015_6885.jpg,500,375,011.Rusty_Blackbird,181,156,365,265,273,210,184,109
../../CUB_200_2011/images\011.Rusty_Blackbird/Rusty_Blackbird_0048_6632.jpg,500,353,011.Rusty_Blackbird,127,142,493,324,310,233,366,182
../../CUB_200_2011/images\011.Rusty_Blackbird/Rusty_Blackbird_0093_6628.jpg,500,332,011.Rusty_Blackbird,84,26,322,174,203,100,238,148
../../CUB_200_2011/images\011.Rusty_Blackbird/Rusty_Blackbird_0121_6637.jpg,500,384,011.Rusty_Blackbird,152,136,439,336,295,236,287,200
../../CUB_200_2011/images\011.Rusty_Blackbird/Rusty_Blackbird_0032_6611.jpg,500,333,011.Rusty_Blackbird,118,117,297,313,207,215,179,196
../../CUB_200_2011/images\011.Rusty_Blackbird/Rusty_Blackbird_0013_6902.jpg,500,333,011.Rusty_Blackbird,138,106,419,230,278,168,281,124
../../CUB_200_2011/images\011.Rusty_Blackbird/Rusty_Blackbird_0082_6906.jpg,500,334,011.Rusty_Blackbird,140,14,474,186,307,100,334,172
../../CUB_200_2011/images\012.Yellow_headed_Blackbird/Yellow_Headed_Blackbird_0108_7937.jpg,500,333,012.Yellow_headed_Blackbird,189,112,340,233,264,172,151,121
../../CUB_200_2011/images\012.Yellow_headed_Blackbird/Yellow_Headed_Blackbird_0074_8452.jpg,500,391,012.Yellow_headed_Blackbird,66,95,393,319,229,207,327,224
../../CUB_200_2011/images\012.Yellow_headed_Blackbird/Yellow_Headed_Blackbird_0031_8456.jpg,286,500,012.Yellow_headed_Blackbird,120,202,272,452,196,327,152,250
../../CUB_200_2011/images\012.Yellow_headed_Blackbird/Yellow_Headed_Blackbird_0095_8458.jpg,446,500,012.Yellow_headed_Blackbird,115,102,400,417,257,259,285,315
../../CUB_200_2011/images\012.Yellow_headed_Blackbird/Yellow_Headed_Blackbird_0015_8207.jpg,500,333,012.Yellow_headed_Blackbird,183,88,306,269,244,178,123,181
../../CUB_200_2011/images\012.Yellow_headed_Blackbird/Yellow_Headed_Blackbird_0061_8208.jpg,333,500,012.Yellow_headed_Blackbird,142,176,242,402,192,289,100,226
../../CUB_200_2011/images\012.Yellow_headed_Blackbird/Yellow_Headed_Blackbird_0065_8481.jpg,500,375,012.Yellow_headed_Blackbird,140,94,253,349,196,221,113,255
../../CUB_200_2011/images\012.Yellow_headed_Blackbird/Yellow_Headed_Blackbird_0086_8487.jpg,412,500,012.Yellow_headed_Blackbird,127,93,272,384,199,238,145,291
../../CUB_200_2011/images\012.Yellow_headed_Blackbird/Yellow_Headed_Blackbird_0057_8236.jpg,500,368,012.Yellow_headed_Blackbird,71,96,262,258,166,177,191,162
../../CUB_200_2011/images\012.Yellow_headed_Blackbird/Yellow_Headed_Blackbird_0082_8577.jpg,500,336,012.Yellow_headed_Blackbird,53,42,424,208,238,125,371,166
../../CUB_200_2011/images\012.Yellow_headed_Blackbird/Yellow_Headed_Blackbird_0008_8756.jpg,500,375,012.Yellow_headed_Blackbird,22,28,480,319,251,173,458,291
../../CUB_200_2011/images\012.Yellow_headed_Blackbird/Yellow_Headed_Blackbird_0009_8248.jpg,500,333,012.Yellow_headed_Blackbird,152,64,276,246,214,155,124,182
../../CUB_200_2011/images\012.Yellow_headed_Blackbird/Yellow_Headed_Blackbird_0043_8250.jpg,500,333,012.Yellow_headed_Blackbird,202,47,414,293,308,170,212,246
../../CUB_200_2011/images\012.Yellow_headed_Blackbird/Yellow_Headed_Blackbird_0017_8511.jpg,328,500,012.Yellow_headed_Blackbird,37,110,306,444,171,277,269,334
../../CUB_200_2011/images\012.Yellow_headed_Blackbird/Yellow_Headed_Blackbird_0088_8257.jpg,360,240,012.Yellow_headed_Blackbird,114,32,245,209,179,120,131,177
../../CUB_200_2011/images\012.Yellow_headed_Blackbird/Yellow_Headed_Blackbird_0025_8262.jpg,333,500,012.Yellow_headed_Blackbird,18,84,289,400,153,242,271,316
../../CUB_200_2011/images\012.Yellow_headed_Blackbird/Yellow_Headed_Blackbird_0041_8264.jpg,500,375,012.Yellow_headed_Blackbird,100,117,310,239,205,178,210,122
../../CUB_200_2011/images\012.Yellow_headed_Blackbird/Yellow_Headed_Blackbird_0018_8588.jpg,349,500,012.Yellow_headed_Blackbird,171,117,280,280,225,198,109,163
../../CUB_200_2011/images\012.Yellow_headed_Blackbird/Yellow_Headed_Blackbird_0109_8271.jpg,500,334,012.Yellow_headed_Blackbird,195,125,359,299,277,212,164,174
../../CUB_200_2011/images\012.Yellow_headed_Blackbird/Yellow_Headed_Blackbird_0034_7736.jpg,500,334,012.Yellow_headed_Blackbird,136,110,318,323,227,216,182,213
../../CUB_200_2011/images\012.Yellow_headed_Blackbird/Yellow_Headed_Blackbird_0079_8535.jpg,412,500,012.Yellow_headed_Blackbird,131,136,341,451,236,293,210,315
../../CUB_200_2011/images\012.Yellow_headed_Blackbird/Yellow_Headed_Blackbird_0040_7514.jpg,363,500,012.Yellow_headed_Blackbird,166,163,336,474,251,318,170,311
../../CUB_200_2011/images\012.Yellow_headed_Blackbird/Yellow_Headed_Blackbird_0026_8545.jpg,418,500,012.Yellow_headed_Blackbird,129,140,333,328,231,234,204,188
../../CUB_200_2011/images\012.Yellow_headed_Blackbird/Yellow_Headed_Blackbird_0049_8548.jpg,500,371,012.Yellow_headed_Blackbird,156,106,313,272,234,189,157,166
../../CUB_200_2011/images\012.Yellow_headed_Blackbird/Yellow_Headed_Blackbird_0020_8549.jpg,500,334,012.Yellow_headed_Blackbird,135,110,298,245,216,177,163,135
../../CUB_200_2011/images\012.Yellow_headed_Blackbird/Yellow_Headed_Blackbird_0091_8555.jpg,500,335,012.Yellow_headed_Blackbird,210,150,368,285,289,217,158,135
../../CUB_200_2011/images\012.Yellow_headed_Blackbird/Yellow_Headed_Blackbird_0083_8300.jpg,500,406,012.Yellow_headed_Blackbird,54,97,335,279,194,188,281,182
../../CUB_200_2011/images\012.Yellow_headed_Blackbird/Yellow_Headed_Blackbird_0062_8310.jpg,500,367,012.Yellow_headed_Blackbird,140,83,304,288,222,185,164,205
../../CUB_200_2011/images\012.Yellow_headed_Blackbird/Yellow_Headed_Blackbird_0042_8574.jpg,401,500,012.Yellow_headed_Blackbird,106,176,226,290,166,233,120,114
../../CUB_200_2011/images\012.Yellow_headed_Blackbird/Yellow_Headed_Blackbird_0089_8326.jpg,500,482,012.Yellow_headed_Blackbird,148,104,287,473,217,288,139,369
../../CUB_200_2011/images\012.Yellow_headed_Blackbird/Yellow_Headed_Blackbird_0024_8586.jpg,500,375,012.Yellow_headed_Blackbird,153,89,354,312,253,200,201,223
../../CUB_200_2011/images\012.Yellow_headed_Blackbird/Yellow_Headed_Blackbird_0077_8332.jpg,500,375,012.Yellow_headed_Blackbird,190,80,378,299,284,189,188,219
../../CUB_200_2011/images\012.Yellow_headed_Blackbird/Yellow_Headed_Blackbird_0003_8337.jpg,500,386,012.Yellow_headed_Blackbird,136,84,276,339,206,211,140,255
../../CUB_200_2011/images\012.Yellow_headed_Blackbird/Yellow_Headed_Blackbird_0080_8601.jpg,500,337,012.Yellow_headed_Blackbird,170,20,291,320,230,170,121,300
../../CUB_200_2011/images\012.Yellow_headed_Blackbird/Yellow_Headed_Blackbird_0023_7325.jpg,500,326,012.Yellow_headed_Blackbird,228,48,447,305,337,176,219,257
../../CUB_200_2011/images\012.Yellow_headed_Blackbird/Yellow_Headed_Blackbird_0058_8350.jpg,500,332,012.Yellow_headed_Blackbird,196,94,356,295,276,194,160,201
../../CUB_200_2011/images\012.Yellow_headed_Blackbird/Yellow_Headed_Blackbird_0055_8357.jpg,500,337,012.Yellow_headed_Blackbird,151,99,330,274,240,186,179,175
../../CUB_200_2011/images\012.Yellow_headed_Blackbird/Yellow_Headed_Blackbird_0087_8358.jpg,500,332,012.Yellow_headed_Blackbird,111,120,290,277,200,198,179,157
../../CUB_200_2011/images\012.Yellow_headed_Blackbird/Yellow_Headed_Blackbird_0038_8689.jpg,442,500,012.Yellow_headed_Blackbird,104,107,288,392,196,249,184,285
../../CUB_200_2011/images\012.Yellow_headed_Blackbird/Yellow_Headed_Blackbird_0013_8362.jpg,500,454,012.Yellow_headed_Blackbird,116,57,448,390,282,223,332,333
../../CUB_200_2011/images\012.Yellow_headed_Blackbird/Yellow_Headed_Blackbird_0085_8363.jpg,500,332,012.Yellow_headed_Blackbird,161,75,322,259,241,167,161,184
../../CUB_200_2011/images\012.Yellow_headed_Blackbird/Yellow_Headed_Blackbird_0007_8366.jpg,500,443,012.Yellow_headed_Blackbird,183,69,324,401,253,235,141,332
../../CUB_200_2011/images\012.Yellow_headed_Blackbird/Yellow_Headed_Blackbird_0098_8367.jpg,500,375,012.Yellow_headed_Blackbird,98,102,368,280,233,191,270,178
../../CUB_200_2011/images\012.Yellow_headed_Blackbird/Yellow_Headed_Blackbird_0072_8606.jpg,358,500,012.Yellow_headed_Blackbird,72,104,357,454,214,279,285,350
../../CUB_200_2011/images\012.Yellow_headed_Blackbird/Yellow_Headed_Blackbird_0051_8387.jpg,500,358,012.Yellow_headed_Blackbird,117,88,312,301,214,194,195,213
../../CUB_200_2011/images\012.Yellow_headed_Blackbird/Yellow_Headed_Blackbird_0059_8079.jpg,500,333,012.Yellow_headed_Blackbird,102,77,300,275,201,176,198,198
../../CUB_200_2011/images\012.Yellow_headed_Blackbird/Yellow_Headed_Blackbird_0100_8407.jpg,500,332,012.Yellow_headed_Blackbird,42,111,309,272,175,191,267,161
../../CUB_200_2011/images\012.Yellow_headed_Blackbird/Yellow_Headed_Blackbird_0053_8410.jpg,500,375,012.Yellow_headed_Blackbird,1,128,339,299,170,213,338,171
../../CUB_200_2011/images\012.Yellow_headed_Blackbird/Yellow_Headed_Blackbird_0056_8455.jpg,500,488,012.Yellow_headed_Blackbird,165,153,474,388,319,270,309,235
../../CUB_200_2011/images\012.Yellow_headed_Blackbird/Yellow_Headed_Blackbird_0070_8583.jpg,500,325,012.Yellow_headed_Blackbird,124,89,281,305,202,197,157,216
../../CUB_200_2011/images\012.Yellow_headed_Blackbird/Yellow_Headed_Blackbird_0102_8441.jpg,400,500,012.Yellow_headed_Blackbird,136,247,380,434,258,340,244,187
../../CUB_200_2011/images\012.Yellow_headed_Blackbird/Yellow_Headed_Blackbird_0084_8435.jpg,447,500,012.Yellow_headed_Blackbird,109,110,401,425,255,267,292,315
../../CUB_200_2011/images\012.Yellow_headed_Blackbird/Yellow_Headed_Blackbird_0047_7929.jpg,306,460,012.Yellow_headed_Blackbird,1,100,300,376,150,238,299,276
../../CUB_200_2011/images\012.Yellow_headed_Blackbird/Yellow_Headed_Blackbird_0073_8442.jpg,500,375,012.Yellow_headed_Blackbird,152,56,411,357,281,206,259,301
../../CUB_200_2011/images\012.Yellow_headed_Blackbird/Yellow_Headed_Blackbird_0012_8443.jpg,500,333,012.Yellow_headed_Blackbird,180,89,441,324,310,206,261,235
../../CUB_200_2011/images\012.Yellow_headed_Blackbird/Yellow_Headed_Blackbird_0035_8447.jpg,500,333,012.Yellow_headed_Blackbird,116,123,290,312,203,217,174,189
../../CUB_200_2011/images\013.Bobolink/Bobolink_0107_10252.jpg,500,334,013.Bobolink,104,61,428,255,266,158,324,194
../../CUB_200_2011/images\013.Bobolink/Bobolink_0007_9246.jpg,369,500,013.Bobolink,48,73,230,235,139,154,182,162
../../CUB_200_2011/images\013.Bobolink/Bobolink_0104_10273.jpg,500,333,013.Bobolink,207,94,363,265,285,179,156,171
../../CUB_200_2011/images\013.Bobolink/Bobolink_0001_9261.jpg,500,375,013.Bobolink,88,77,351,347,219,212,263,270
../../CUB_200_2011/images\013.Bobolink/Bobolink_0115_9265.jpg,500,375,013.Bobolink,139,89,296,241,217,165,157,152
../../CUB_200_2011/images\013.Bobolink/Bobolink_0039_9779.jpg,401,500,013.Bobolink,126,121,351,410,238,265,225,289
../../CUB_200_2011/images\013.Bobolink/Bobolink_0102_10807.jpg,500,394,013.Bobolink,96,119,252,282,174,200,156,163
../../CUB_200_2011/images\013.Bobolink/Bobolink_0033_10809.jpg,500,375,013.Bobolink,69,113,380,270,224,191,311,157
../../CUB_200_2011/images\013.Bobolink/Bobolink_0094_9823.jpg,500,375,013.Bobolink,145,63,403,319,274,191,258,256
../../CUB_200_2011/images\013.Bobolink/Bobolink_0008_9289.jpg,500,375,013.Bobolink,192,70,382,281,287,175,190,211
../../CUB_200_2011/images\013.Bobolink/Bobolink_0099_9314.jpg,500,375,013.Bobolink,83,29,353,361,218,195,270,332
../../CUB_200_2011/images\013.Bobolink/Bobolink_0101_9811.jpg,500,368,013.Bobolink,94,41,274,330,184,185,180,289
../../CUB_200_2011/images\013.Bobolink/Bobolink_0050_9821.jpg,335,500,013.Bobolink,99,125,293,416,196,270,194,291
../../CUB_200_2011/images\013.Bobolink/Bobolink_0074_9311.jpg,500,328,013.Bobolink,161,93,284,214,222,153,123,121
../../CUB_200_2011/images\013.Bobolink/Bobolink_0120_10859.jpg,500,385,013.Bobolink,295,111,425,294,360,202,130,183
../../CUB_200_2011/images\013.Bobolink/Bobolink_0097_10861.jpg,500,371,013.Bobolink,167,107,295,259,231,183,128,152
../../CUB_200_2011/images\013.Bobolink/Bobolink_0109_9869.jpg,395,500,013.Bobolink,84,228,223,385,153,306,139,157
../../CUB_200_2011/images\013.Bobolink/Bobolink_0013_9367.jpg,500,441,013.Bobolink,171,127,315,339,243,233,144,212
../../CUB_200_2011/images\013.Bobolink/Bobolink_0065_9375.jpg,500,357,013.Bobolink,5,71,240,329,122,200,235,258
../../CUB_200_2011/images\013.Bobolink/Bobolink_0018_9402.jpg,500,306,013.Bobolink,171,117,271,219,221,168,100,102
../../CUB_200_2011/images\013.Bobolink/Bobolink_0119_10430.jpg,500,461,013.Bobolink,76,115,293,422,184,268,217,307
../../CUB_200_2011/images\013.Bobolink/Bobolink_0126_11458.jpg,500,427,013.Bobolink,149,136,317,303,233,219,168,167
../../CUB_200_2011/images\013.Bobolink/Bobolink_0052_9423.jpg,500,332,013.Bobolink,178,80,360,211,269,145,182,131
../../CUB_200_2011/images\013.Bobolink/Bobolink_0081_9439.jpg,500,471,013.Bobolink,248,65,381,216,314,140,133,151
../../CUB_200_2011/images\013.Bobolink/Bobolink_0048_9988.jpg,376,500,013.Bobolink,77,98,307,455,192,276,230,357
../../CUB_200_2011/images\013.Bobolink/Bobolink_0044_9990.jpg,500,333,013.Bobolink,239,111,393,218,316,164,154,107
../../CUB_200_2011/images\013.Bobolink/Bobolink_0067_11533.jpg,500,323,013.Bobolink,81,115,235,267,158,191,154,152
../../CUB_200_2011/images\013.Bobolink/Bobolink_0110_9496.jpg,333,500,013.Bobolink,65,121,199,241,132,181,134,120
../../CUB_200_2011/images\013.Bobolink/Bobolink_0071_9503.jpg,333,500,013.Bobolink,87,85,309,421,198,253,222,336
../../CUB_200_2011/images\013.Bobolink/Bobolink_0128_9947.jpg,500,304,013.Bobolink,207,60,349,212,278,136,142,152
../../CUB_200_2011/images\013.Bobolink/Bobolink_0092_10026.jpg,394,480,013.Bobolink,8,36,377,457,192,246,369,421
../../CUB_200_2011/images\013.Bobolink/Bobolink_0014_11055.jpg,500,370,013.Bobolink,165,117,346,320,255,218,181,203
../../CUB_200_2011/images\013.Bobolink/Bobolink_0026_11057.jpg,500,390,013.Bobolink,56,201,237,386,146,293,181,185
../../CUB_200_2011/images\013.Bobolink/Bobolink_0019_10552.jpg,396,500,013.Bobolink,96,121,302,348,199,234,206,227
../../CUB_200_2011/images\013.Bobolink/Bobolink_0059_10041.jpg,500,333,013.Bobolink,83,28,309,314,196,171,226,286
../../CUB_200_2011/images\013.Bobolink/Bobolink_0112_11073.jpg,500,333,013.Bobolink,141,37,321,305,231,171,180,268
../../CUB_200_2011/images\013.Bobolink/Bobolink_0057_10051.jpg,333,500,013.Bobolink,53,130,177,396,115,263,124,266
../../CUB_200_2011/images\013.Bobolink/Bobolink_0049_9540.jpg,500,388,013.Bobolink,71,89,384,350,227,219,313,261
../../CUB_200_2011/images\013.Bobolink/Bobolink_0027_10569.jpg,500,374,013.Bobolink,144,133,301,274,222,203,157,141
../../CUB_200_2011/images\013.Bobolink/Bobolink_0002_11085.jpg,500,376,013.Bobolink,19,47,283,253,151,150,264,206
../../CUB_200_2011/images\013.Bobolink/Bobolink_0076_11093.jpg,500,357,013.Bobolink,50,78,294,271,172,174,244,193
../../CUB_200_2011/images\013.Bobolink/Bobolink_0131_9578.jpg,500,333,013.Bobolink,117,95,266,281,191,188,149,186
../../CUB_200_2011/images\013.Bobolink/Bobolink_0064_10092.jpg,500,318,013.Bobolink,84,68,454,300,269,184,370,232
../../CUB_200_2011/images\013.Bobolink/Bobolink_0035_11117.jpg,402,500,013.Bobolink,32,132,284,425,158,278,252,293
../../CUB_200_2011/images\013.Bobolink/Bobolink_0043_10607.jpg,400,500,013.Bobolink,146,66,346,412,246,239,200,346
../../CUB_200_2011/images\013.Bobolink/Bobolink_0056_9080.jpg,500,373,013.Bobolink,208,114,479,331,343,222,271,217
../../CUB_200_2011/images\013.Bobolink/Bobolink_0069_9085.jpg,378,500,013.Bobolink,92,91,312,455,202,273,220,364
../../CUB_200_2011/images\013.Bobolink/Bobolink_0021_10623.jpg,500,383,013.Bobolink,141,61,416,345,278,203,275,284
../../CUB_200_2011/images\013.Bobolink/Bobolink_0070_10624.jpg,500,336,013.Bobolink,58,93,190,251,124,172,132,158
../../CUB_200_2011/images\013.Bobolink/Bobolink_0114_10627.jpg,500,500,013.Bobolink,33,14,484,496,258,255,451,482
../../CUB_200_2011/images\013.Bobolink/Bobolink_0133_9618.jpg,500,360,013.Bobolink,37,71,234,281,135,176,197,210
../../CUB_200_2011/images\013.Bobolink/Bobolink_0106_9126.jpg,500,340,013.Bobolink,169,74,333,233,251,153,164,159
../../CUB_200_2011/images\013.Bobolink/Bobolink_0053_10166.jpg,500,333,013.Bobolink,289,126,412,273,350,199,123,147
../../CUB_200_2011/images\013.Bobolink/Bobolink_0124_10182.jpg,360,288,013.Bobolink,93,76,287,272,190,174,194,196
../../CUB_200_2011/images\013.Bobolink/Bobolink_0040_9681.jpg,386,500,013.Bobolink,18,79,302,456,160,267,284,377
../../CUB_200_2011/images\013.Bobolink/Bobolink_0117_10215.jpg,500,348,013.Bobolink,123,85,471,327,297,206,348,242
../../CUB_200_2011/images\013.Bobolink/Bobolink_0032_10217.jpg,500,333,013.Bobolink,90,59,318,332,204,195,228,273
../../CUB_200_2011/images\013.Bobolink/Bobolink_0020_9194.jpg,500,334,013.Bobolink,66,38,274,260,170,149,208,222
../../CUB_200_2011/images\013.Bobolink/Bobolink_0079_10736.jpg,500,375,013.Bobolink,121,141,332,307,226,224,211,166
../../CUB_200_2011/images\013.Bobolink/Bobolink_0047_9204.jpg,387,500,013.Bobolink,15,95,319,416,167,255,304,321
../../CUB_200_2011/images\014.Indigo_Bunting/Indigo_Bunting_0005_13832.jpg,500,375,014.Indigo_Bunting,90,57,277,372,183,214,187,315
../../CUB_200_2011/images\014.Indigo_Bunting/Indigo_Bunting_0014_14167.jpg,500,302,014.Indigo_Bunting,194,19,296,282,245,150,102,263
../../CUB_200_2011/images\014.Indigo_Bunting/Indigo_Bunting_0002_12163.jpg,438,500,014.Indigo_Bunting,45,65,283,359,164,212,238,294
../../CUB_200_2011/images\014.Indigo_Bunting/Indigo_Bunting_0068_13081.jpg,432,288,014.Indigo_Bunting,61,25,358,249,209,137,297,224
../../CUB_200_2011/images\014.Indigo_Bunting/Indigo_Bunting_0040_11805.jpg,500,333,014.Indigo_Bunting,161,34,364,310,262,172,203,276
../../CUB_200_2011/images\014.Indigo_Bunting/Indigo_Bunting_0075_12835.jpg,467,500,014.Indigo_Bunting,38,90,239,349,138,219,201,259
../../CUB_200_2011/images\014.Indigo_Bunting/Indigo_Bunting_0063_11820.jpg,500,492,014.Indigo_Bunting,140,84,298,398,219,241,158,314
../../CUB_200_2011/images\014.Indigo_Bunting/Indigo_Bunting_0028_12335.jpg,500,333,014.Indigo_Bunting,278,159,492,285,385,222,214,126
../../CUB_200_2011/images\014.Indigo_Bunting/Indigo_Bunting_0037_14128.jpg,477,279,014.Indigo_Bunting,127,87,288,238,207,162,161,151
../../CUB_200_2011/images\014.Indigo_Bunting/Indigo_Bunting_0044_14389.jpg,500,366,014.Indigo_Bunting,105,24,443,319,274,171,338,295
../../CUB_200_2011/images\014.Indigo_Bunting/Indigo_Bunting_0017_11574.jpg,500,333,014.Indigo_Bunting,129,22,365,313,247,167,236,291
../../CUB_200_2011/images\014.Indigo_Bunting/Indigo_Bunting_0027_11579.jpg,500,420,014.Indigo_Bunting,77,170,260,346,168,258,183,176
../../CUB_200_2011/images\014.Indigo_Bunting/Indigo_Bunting_0001_12469.jpg,500,333,014.Indigo_Bunting,36,112,392,285,214,198,356,173
../../CUB_200_2011/images\014.Indigo_Bunting/Indigo_Bunting_0066_12869.jpg,500,392,014.Indigo_Bunting,49,79,441,333,245,206,392,254
../../CUB_200_2011/images\014.Indigo_Bunting/Indigo_Bunting_0084_11848.jpg,500,356,014.Indigo_Bunting,114,82,283,234,198,158,169,152
../../CUB_200_2011/images\014.Indigo_Bunting/Indigo_Bunting_0049_13641.jpg,500,333,014.Indigo_Bunting,86,141,258,319,172,230,172,178
../../CUB_200_2011/images\014.Indigo_Bunting/Indigo_Bunting_0059_11596.jpg,500,357,014.Indigo_Bunting,0,46,488,348,244,197,488,302
../../CUB_200_2011/images\014.Indigo_Bunting/Indigo_Bunting_0053_13391.jpg,500,375,014.Indigo_Bunting,208,112,328,228,268,170,120,116
../../CUB_200_2011/images\014.Indigo_Bunting/Indigo_Bunting_0015_12632.jpg,500,333,014.Indigo_Bunting,228,47,448,169,338,108,220,122
../../CUB_200_2011/images\014.Indigo_Bunting/Indigo_Bunting_0016_13661.jpg,333,500,014.Indigo_Bunting,85,141,196,397,140,269,111,256
../../CUB_200_2011/images\014.Indigo_Bunting/Indigo_Bunting_0080_13416.jpg,367,500,014.Indigo_Bunting,194,214,312,437,253,325,118,223
../../CUB_200_2011/images\014.Indigo_Bunting/Indigo_Bunting_0018_11883.jpg,500,474,014.Indigo_Bunting,71,120,383,409,227,264,312,289
../../CUB_200_2011/images\014.Indigo_Bunting/Indigo_Bunting_0073_13933.jpg,411,500,014.Indigo_Bunting,150,145,389,384,269,264,239,239
../../CUB_200_2011/images\014.Indigo_Bunting/Indigo_Bunting_0072_14197.jpg,500,359,014.Indigo_Bunting,257,61,391,298,324,179,134,237
../../CUB_200_2011/images\014.Indigo_Bunting/Indigo_Bunting_0056_12637.jpg,500,333,014.Indigo_Bunting,18,18,499,327,258,172,481,309
../../CUB_200_2011/images\014.Indigo_Bunting/Indigo_Bunting_0071_11639.jpg,500,372,014.Indigo_Bunting,165,139,298,264,231,201,133,125
../../CUB_200_2011/images\014.Indigo_Bunting/Indigo_Bunting_0082_11907.jpg,500,375,014.Indigo_Bunting,82,223,199,333,140,278,117,110
../../CUB_200_2011/images\014.Indigo_Bunting/Indigo_Bunting_0004_13195.jpg,500,375,014.Indigo_Bunting,102,128,292,324,197,226,190,196
../../CUB_200_2011/images\014.Indigo_Bunting/Indigo_Bunting_0022_12781.jpg,333,500,014.Indigo_Bunting,41,87,225,499,133,293,184,412
../../CUB_200_2011/images\014.Indigo_Bunting/Indigo_Bunting_0036_13716.jpg,402,500,014.Indigo_Bunting,108,133,301,392,204,262,193,259
../../CUB_200_2011/images\014.Indigo_Bunting/Indigo_Bunting_0013_12949.jpg,500,375,014.Indigo_Bunting,128,56,252,299,190,177,124,243
../../CUB_200_2011/images\014.Indigo_Bunting/Indigo_Bunting_0076_12950.jpg,500,333,014.Indigo_Bunting,301,64,476,230,388,147,175,166
../../CUB_200_2011/images\014.Indigo_Bunting/Indigo_Bunting_0021_13979.jpg,500,342,014.Indigo_Bunting,14,78,330,301,172,189,316,223
../../CUB_200_2011/images\014.Indigo_Bunting/Indigo_Bunting_0060_14495.jpg,500,375,014.Indigo_Bunting,213,74,324,332,268,203,111,258
../../CUB_200_2011/images\014.Indigo_Bunting/Indigo_Bunting_0055_13473.jpg,500,455,014.Indigo_Bunting,187,108,335,318,261,213,148,210
../../CUB_200_2011/images\014.Indigo_Bunting/Indigo_Bunting_0041_13987.jpg,500,375,014.Indigo_Bunting,218,273,407,374,312,323,189,101
../../CUB_200_2011/images\014.Indigo_Bunting/Indigo_Bunting_0047_12966.jpg,500,345,014.Indigo_Bunting,153,95,341,263,247,179,188,168
../../CUB_200_2011/images\014.Indigo_Bunting/Indigo_Bunting_0058_12207.jpg,500,375,014.Indigo_Bunting,58,70,274,376,166,223,216,306
../../CUB_200_2011/images\014.Indigo_Bunting/Indigo_Bunting_0034_12464.jpg,500,384,014.Indigo_Bunting,118,131,314,286,216,208,196,155
../../CUB_200_2011/images\014.Indigo_Bunting/Indigo_Bunting_0054_12213.jpg,500,375,014.Indigo_Bunting,128,107,377,262,252,184,249,155
../../CUB_200_2011/images\014.Indigo_Bunting/Indigo_Bunting_0032_12215.jpg,484,500,014.Indigo_Bunting,54,118,281,409,167,263,227,291
../../CUB_200_2011/images\014.Indigo_Bunting/Indigo_Bunting_0025_12532.jpg,500,357,014.Indigo_Bunting,119,93,271,316,195,204,152,223
../../CUB_200_2011/images\014.Indigo_Bunting/Indigo_Bunting_0026_11964.jpg,500,400,014.Indigo_Bunting,119,78,263,215,191,146,144,137
../../CUB_200_2011/images\014.Indigo_Bunting/Indigo_Bunting_0052_11893.jpg,400,500,014.Indigo_Bunting,91,149,310,323,200,236,219,174
../../CUB_200_2011/images\014.Indigo_Bunting/Indigo_Bunting_0029_13761.jpg,500,422,014.Indigo_Bunting,86,145,292,306,189,225,206,161
../../CUB_200_2011/images\014.Indigo_Bunting/Indigo_Bunting_0010_13000.jpg,500,340,014.Indigo_Bunting,109,37,416,314,262,175,307,277
../../CUB_200_2011/images\014.Indigo_Bunting/Indigo_Bunting_0078_11852.jpg,434,500,014.Indigo_Bunting,127,117,281,360,204,238,154,243
../../CUB_200_2011/images\014.Indigo_Bunting/Indigo_Bunting_0061_13259.jpg,500,375,014.Indigo_Bunting,51,62,358,325,204,193,307,263
../../CUB_200_2011/images\014.Indigo_Bunting/Indigo_Bunting_0050_11811.jpg,500,333,014.Indigo_Bunting,274,25,478,233,376,129,204,208
../../CUB_200_2011/images\014.Indigo_Bunting/Indigo_Bunting_0039_12756.jpg,500,425,014.Indigo_Bunting,120,150,247,318,183,234,127,168
../../CUB_200_2011/images\014.Indigo_Bunting/Indigo_Bunting_0085_11991.jpg,500,399,014.Indigo_Bunting,142,90,357,286,249,188,215,196
../../CUB_200_2011/images\014.Indigo_Bunting/Indigo_Bunting_0065_14558.jpg,500,375,014.Indigo_Bunting,95,121,212,242,153,181,117,121
../../CUB_200_2011/images\014.Indigo_Bunting/Indigo_Bunting_0051_12837.jpg,500,368,014.Indigo_Bunting,89,110,231,305,160,207,142,195
../../CUB_200_2011/images\014.Indigo_Bunting/Indigo_Bunting_0033_12777.jpg,333,500,014.Indigo_Bunting,52,147,312,347,182,247,260,200
../../CUB_200_2011/images\014.Indigo_Bunting/Indigo_Bunting_0077_14060.jpg,500,333,014.Indigo_Bunting,145,75,326,236,235,155,181,161
../../CUB_200_2011/images\014.Indigo_Bunting/Indigo_Bunting_0006_14317.jpg,500,500,014.Indigo_Bunting,7,105,438,393,222,249,431,288
../../CUB_200_2011/images\014.Indigo_Bunting/Indigo_Bunting_0024_13523.jpg,500,333,014.Indigo_Bunting,102,145,285,285,193,215,183,140
../../CUB_200_2011/images\014.Indigo_Bunting/Indigo_Bunting_0031_13300.jpg,500,306,014.Indigo_Bunting,66,84,381,220,223,152,315,136
../../CUB_200_2011/images\014.Indigo_Bunting/Indigo_Bunting_0003_13049.jpg,500,372,014.Indigo_Bunting,88,72,434,328,261,200,346,256
../../CUB_200_2011/images\014.Indigo_Bunting/Indigo_Bunting_0074_12829.jpg,500,282,014.Indigo_Bunting,174,52,483,278,328,165,309,226
../../CUB_200_2011/images\015.Lazuli_Bunting/Lazuli_Bunting_0073_14594.jpg,500,366,015.Lazuli_Bunting,51,77,363,303,207,190,312,226
../../CUB_200_2011/images\015.Lazuli_Bunting/Lazuli_Bunting_0074_14854.jpg,500,400,015.Lazuli_Bunting,199,95,393,326,296,210,194,231
../../CUB_200_2011/images\015.Lazuli_Bunting/Lazuli_Bunting_0102_14605.jpg,500,332,015.Lazuli_Bunting,61,68,239,260,150,164,178,192
../../CUB_200_2011/images\015.Lazuli_Bunting/Lazuli_Bunting_0047_14863.jpg,456,500,015.Lazuli_Bunting,139,123,329,372,234,247,190,249
../../CUB_200_2011/images\015.Lazuli_Bunting/Lazuli_Bunting_0034_14864.jpg,420,280,015.Lazuli_Bunting,29,47,258,224,143,135,229,177
../../CUB_200_2011/images\015.Lazuli_Bunting/Lazuli_Bunting_0101_14873.jpg,500,400,015.Lazuli_Bunting,37,151,324,361,180,256,287,210
../../CUB_200_2011/images\015.Lazuli_Bunting/Lazuli_Bunting_0052_14618.jpg,500,230,015.Lazuli_Bunting,184,27,353,203,268,115,169,176
../../CUB_200_2011/images\015.Lazuli_Bunting/Lazuli_Bunting_0085_14627.jpg,439,500,015.Lazuli_Bunting,112,93,362,424,237,258,250,331
../../CUB_200_2011/images\015.Lazuli_Bunting/Lazuli_Bunting_0089_14598.jpg,500,342,015.Lazuli_Bunting,27,58,249,301,138,179,222,243
../../CUB_200_2011/images\015.Lazuli_Bunting/Lazuli_Bunting_0004_14887.jpg,489,500,015.Lazuli_Bunting,216,159,363,425,289,292,147,266
../../CUB_200_2011/images\015.Lazuli_Bunting/Lazuli_Bunting_0080_14893.jpg,500,333,015.Lazuli_Bunting,71,89,353,237,212,163,282,148
../../CUB_200_2011/images\015.Lazuli_Bunting/Lazuli_Bunting_0027_14895.jpg,500,420,015.Lazuli_Bunting,69,87,369,266,219,176,300,179
../../CUB_200_2011/images\015.Lazuli_Bunting/Lazuli_Bunting_0041_15152.jpg,500,375,015.Lazuli_Bunting,215,51,323,319,269,185,108,268
../../CUB_200_2011/images\015.Lazuli_Bunting/Lazuli_Bunting_0061_15155.jpg,468,500,015.Lazuli_Bunting,138,100,405,469,271,284,267,369
../../CUB_200_2011/images\015.Lazuli_Bunting/Lazuli_Bunting_0009_15163.jpg,500,500,015.Lazuli_Bunting,76,153,266,458,171,305,190,305
../../CUB_200_2011/images\015.Lazuli_Bunting/Lazuli_Bunting_0078_15164.jpg,430,500,015.Lazuli_Bunting,157,239,297,386,227,312,140,147
../../CUB_200_2011/images\015.Lazuli_Bunting/Lazuli_Bunting_0092_14656.jpg,500,322,015.Lazuli_Bunting,222,86,373,193,297,139,151,107
../../CUB_200_2011/images\015.Lazuli_Bunting/Lazuli_Bunting_0066_14914.jpg,436,500,015.Lazuli_Bunting,139,178,307,349,223,263,168,171
../../CUB_200_2011/images\015.Lazuli_Bunting/Lazuli_Bunting_0010_14915.jpg,500,428,015.Lazuli_Bunting,180,120,338,371,259,245,158,251
../../CUB_200_2011/images\015.Lazuli_Bunting/Lazuli_Bunting_0001_14916.jpg,500,400,015.Lazuli_Bunting,120,155,294,294,207,224,174,139
../../CUB_200_2011/images\015.Lazuli_Bunting/Lazuli_Bunting_0076_14662.jpg,415,500,015.Lazuli_Bunting,69,191,205,441,137,316,136,250
../../CUB_200_2011/images\015.Lazuli_Bunting/Lazuli_Bunting_0095_14919.jpg,500,409,015.Lazuli_Bunting,265,93,462,257,363,175,197,164
../../CUB_200_2011/images\015.Lazuli_Bunting/Lazuli_Bunting_0035_14920.jpg,500,500,015.Lazuli_Bunting,179,182,369,359,274,270,190,177
../../CUB_200_2011/images\015.Lazuli_Bunting/Lazuli_Bunting_0070_14665.jpg,500,485,015.Lazuli_Bunting,50,132,380,376,215,254,330,244
../../CUB_200_2011/images\015.Lazuli_Bunting/Lazuli_Bunting_0040_14923.jpg,170,453,015.Lazuli_Bunting,45,154,168,380,106,267,123,226
../../CUB_200_2011/images\015.Lazuli_Bunting/Lazuli_Bunting_0026_14669.jpg,371,500,015.Lazuli_Bunting,143,187,280,441,211,314,137,254
../../CUB_200_2011/images\015.Lazuli_Bunting/Lazuli_Bunting_0067_14672.jpg,500,375,015.Lazuli_Bunting,213,94,402,347,307,220,189,253
../../CUB_200_2011/images\015.Lazuli_Bunting/Lazuli_Bunting_0008_15195.jpg,500,382,015.Lazuli_Bunting,122,96,253,295,187,195,131,199
../../CUB_200_2011/images\015.Lazuli_Bunting/Lazuli_Bunting_0032_14778.jpg,432,288,015.Lazuli_Bunting,162,40,284,267,223,153,122,227
../../CUB_200_2011/images\015.Lazuli_Bunting/Lazuli_Bunting_0021_14686.jpg,500,334,015.Lazuli_Bunting,243,87,423,232,333,159,180,145
../../CUB_200_2011/images\015.Lazuli_Bunting/Lazuli_Bunting_0015_14690.jpg,424,500,015.Lazuli_Bunting,213,117,319,284,266,200,106,167
../../CUB_200_2011/images\015.Lazuli_Bunting/Lazuli_Bunting_0028_14950.jpg,264,500,015.Lazuli_Bunting,38,82,217,382,127,232,179,300
../../CUB_200_2011/images\015.Lazuli_Bunting/Lazuli_Bunting_0045_14954.jpg,500,473,015.Lazuli_Bunting,88,135,257,392,172,263,169,257
../../CUB_200_2011/images\015.Lazuli_Bunting/Lazuli_Bunting_0107_14705.jpg,484,500,015.Lazuli_Bunting,118,126,342,407,230,266,224,281
../../CUB_200_2011/images\015.Lazuli_Bunting/Lazuli_Bunting_0081_14709.jpg,400,500,015.Lazuli_Bunting,115,170,223,392,169,281,108,222
../../CUB_200_2011/images\015.Lazuli_Bunting/Lazuli_Bunting_0094_11894.jpg,500,318,015.Lazuli_Bunting,161,88,418,220,289,154,257,132
../../CUB_200_2011/images\015.Lazuli_Bunting/Lazuli_Bunting_0054_14714.jpg,333,500,015.Lazuli_Bunting,99,176,251,400,175,288,152,224
../../CUB_200_2011/images\015.Lazuli_Bunting/Lazuli_Bunting_0030_14986.jpg,500,326,015.Lazuli_Bunting,174,72,317,262,245,167,143,190
../../CUB_200_2011/images\015.Lazuli_Bunting/Lazuli_Bunting_0086_14992.jpg,309,500,015.Lazuli_Bunting,106,178,238,364,172,271,132,186
../../CUB_200_2011/images\015.Lazuli_Bunting/Lazuli_Bunting_0046_14787.jpg,500,381,015.Lazuli_Bunting,164,120,398,332,281,226,234,212
../../CUB_200_2011/images\015.Lazuli_Bunting/Lazuli_Bunting_0097_14617.jpg,500,345,015.Lazuli_Bunting,101,95,323,326,212,210,222,231
../../CUB_200_2011/images\015.Lazuli_Bunting/Lazuli_Bunting_0059_14749.jpg,500,359,015.Lazuli_Bunting,136,90,236,334,186,212,100,244
../../CUB_200_2011/images\015.Lazuli_Bunting/Lazuli_Bunting_0105_15017.jpg,346,432,015.Lazuli_Bunting,52,72,270,394,161,233,218,322
../../CUB_200_2011/images\015.Lazuli_Bunting/Lazuli_Bunting_0031_15018.jpg,500,400,015.Lazuli_Bunting,173,90,368,371,270,230,195,281
../../CUB_200_2011/images\015.Lazuli_Bunting/Lazuli_Bunting_0037_15021.jpg,444,500,015.Lazuli_Bunting,175,176,334,312,254,244,159,136
../../CUB_200_2011/images\015.Lazuli_Bunting/Lazuli_Bunting_0093_15030.jpg,500,333,015.Lazuli_Bunting,249,138,394,253,321,195,145,115
../../CUB_200_2011/images\015.Lazuli_Bunting/Lazuli_Bunting_0057_14775.jpg,500,270,015.Lazuli_Bunting,26,69,414,240,220,154,388,171
../../CUB_200_2011/images\015.Lazuli_Bunting/Lazuli_Bunting_0056_15032.jpg,500,357,015.Lazuli_Bunting,113,105,454,338,283,221,341,233
../../CUB_200_2011/images\015.Lazuli_Bunting/Lazuli_Bunting_0055_15043.jpg,500,433,015.Lazuli_Bunting,116,153,334,315,225,234,218,162
../../CUB_200_2011/images\015.Lazuli_Bunting/Lazuli_Bunting_0082_15047.jpg,500,317,015.Lazuli_Bunting,211,125,438,271,324,198,227,146
../../CUB_200_2011/images\015.Lazuli_Bunting/Lazuli_Bunting_0084_14815.jpg,500,333,015.Lazuli_Bunting,78,140,292,257,185,198,214,117
../../CUB_200_2011/images\015.Lazuli_Bunting/Lazuli_Bunting_0042_14820.jpg,500,460,015.Lazuli_Bunting,59,57,493,453,276,255,434,396
../../CUB_200_2011/images\015.Lazuli_Bunting/Lazuli_Bunting_0025_15079.jpg,500,418,015.Lazuli_Bunting,1,38,440,373,220,205,439,335
../../CUB_200_2011/images\015.Lazuli_Bunting/Lazuli_Bunting_0014_14824.jpg,393,500,015.Lazuli_Bunting,156,116,314,324,235,220,158,208
../../CUB_200_2011/images\015.Lazuli_Bunting/Lazuli_Bunting_0039_15081.jpg,500,342,015.Lazuli_Bunting,125,98,334,254,229,176,209,156
../../CUB_200_2011/images\015.Lazuli_Bunting/Lazuli_Bunting_0020_14837.jpg,500,313,015.Lazuli_Bunting,172,52,356,265,264,158,184,213
../../CUB_200_2011/images\015.Lazuli_Bunting/Lazuli_Bunting_0087_15096.jpg,500,326,015.Lazuli_Bunting,111,16,360,318,235,167,249,302
../../CUB_200_2011/images\015.Lazuli_Bunting/Lazuli_Bunting_0048_14844.jpg,493,500,015.Lazuli_Bunting,130,122,437,449,283,285,307,327
../../CUB_200_2011/images\016.Painted_Bunting/Painted_Bunting_0102_16642.jpg,500,333,016.Painted_Bunting,28,72,367,280,197,176,339,208
../../CUB_200_2011/images\016.Painted_Bunting/Painted_Bunting_0004_16641.jpg,500,389,016.Painted_Bunting,87,47,465,293,276,170,378,246
../../CUB_200_2011/images\016.Painted_Bunting/Painted_Bunting_0077_16819.jpg,400,500,016.Painted_Bunting,124,163,335,366,229,264,211,203
../../CUB_200_2011/images\016.Painted_Bunting/Painted_Bunting_0039_15235.jpg,500,486,016.Painted_Bunting,14,179,207,333,110,256,193,154
../../CUB_200_2011/images\016.Painted_Bunting/Painted_Bunting_0053_16404.jpg,500,333,016.Painted_Bunting,83,91,393,284,238,187,310,193
../../CUB_200_2011/images\016.Painted_Bunting/Painted_Bunting_0050_16670.jpg,333,500,016.Painted_Bunting,32,97,239,440,135,268,207,343
../../CUB_200_2011/images\016.Painted_Bunting/Painted_Bunting_0008_16416.jpg,500,380,016.Painted_Bunting,119,101,374,267,246,184,255,166
../../CUB_200_2011/images\016.Painted_Bunting/Painted_Bunting_0061_16930.jpg,500,375,016.Painted_Bunting,95,100,346,313,220,206,251,213
../../CUB_200_2011/images\016.Painted_Bunting/Painted_Bunting_0011_16690.jpg,500,375,016.Painted_Bunting,57,197,171,337,114,267,114,140
../../CUB_200_2011/images\016.Painted_Bunting/Painted_Bunting_0040_16691.jpg,500,362,016.Painted_Bunting,113,86,491,303,302,194,378,217
../../CUB_200_2011/images\016.Painted_Bunting/Painted_Bunting_0010_16948.jpg,500,404,016.Painted_Bunting,29,60,432,313,230,186,403,253
../../CUB_200_2011/images\016.Painted_Bunting/Painted_Bunting_0072_16697.jpg,500,449,016.Painted_Bunting,208,169,316,293,262,231,108,124
../../CUB_200_2011/images\016.Painted_Bunting/Painted_Bunting_0054_16711.jpg,500,406,016.Painted_Bunting,142,105,365,304,253,204,223,199
../../CUB_200_2011/images\016.Painted_Bunting/Painted_Bunting_0069_16462.jpg,500,304,016.Painted_Bunting,207,90,313,228,260,159,106,138
../../CUB_200_2011/images\016.Painted_Bunting/Painted_Bunting_0058_16719.jpg,500,358,016.Painted_Bunting,88,120,315,259,201,189,227,139
../../CUB_200_2011/images\016.Painted_Bunting/Painted_Bunting_0025_16722.jpg,500,338,016.Painted_Bunting,178,79,440,281,309,180,262,202
../../CUB_200_2011/images\016.Painted_Bunting/Painted_Bunting_0094_16467.jpg,500,393,016.Painted_Bunting,101,34,488,388,294,211,387,354
../../CUB_200_2011/images\016.Painted_Bunting/Painted_Bunting_0079_15197.jpg,391,500,016.Painted_Bunting,123,190,388,440,255,315,265,250
../../CUB_200_2011/images\016.Painted_Bunting/Painted_Bunting_0091_15198.jpg,500,475,016.Painted_Bunting,47,64,446,448,246,256,399,384
../../CUB_200_2011/images\016.Painted_Bunting/Painted_Bunting_0100_16735.jpg,500,333,016.Painted_Bunting,180,93,442,236,311,164,262,143
../../CUB_200_2011/images\016.Painted_Bunting/Painted_Bunting_0016_15200.jpg,500,339,016.Painted_Bunting,205,84,494,237,349,160,289,153
../../CUB_200_2011/images\016.Painted_Bunting/Painted_Bunting_0073_16737.jpg,500,420,016.Painted_Bunting,104,40,393,386,248,213,289,346
../../CUB_200_2011/images\016.Painted_Bunting/Painted_Bunting_0005_15202.jpg,500,332,016.Painted_Bunting,28,67,400,292,214,179,372,225
../../CUB_200_2011/images\016.Painted_Bunting/Painted_Bunting_0028_15205.jpg,500,333,016.Painted_Bunting,136,66,485,227,310,146,349,161
../../CUB_200_2011/images\016.Painted_Bunting/Painted_Bunting_0034_15207.jpg,500,359,016.Painted_Bunting,30,87,308,230,169,158,278,143
../../CUB_200_2011/images\016.Painted_Bunting/Painted_Bunting_0055_15208.jpg,500,394,016.Painted_Bunting,43,52,301,392,172,222,258,340
../../CUB_200_2011/images\016.Painted_Bunting/Painted_Bunting_0071_15209.jpg,400,500,016.Painted_Bunting,55,70,389,493,222,281,334,423
../../CUB_200_2011/images\016.Painted_Bunting/Painted_Bunting_0093_15212.jpg,500,397,016.Painted_Bunting,183,124,345,230,264,177,162,106
../../CUB_200_2011/images\016.Painted_Bunting/Painted_Bunting_0098_15226.jpg,500,333,016.Painted_Bunting,58,98,372,276,215,187,314,178
../../CUB_200_2011/images\016.Painted_Bunting/Painted_Bunting_0076_16765.jpg,500,349,016.Painted_Bunting,228,116,371,293,299,204,143,177
../../CUB_200_2011/images\016.Painted_Bunting/Painted_Bunting_0081_15230.jpg,500,404,016.Painted_Bunting,68,55,456,363,262,209,388,308
../../CUB_200_2011/images\016.Painted_Bunting/Painted_Bunting_0019_15231.jpg,500,375,016.Painted_Bunting,25,64,391,286,208,175,366,222
../../CUB_200_2011/images\016.Painted_Bunting/Painted_Bunting_0087_15232.jpg,500,358,016.Painted_Bunting,197,71,316,213,256,142,119,142
../../CUB_200_2011/images\016.Painted_Bunting/Painted_Bunting_0096_15233.jpg,500,426,016.Painted_Bunting,215,119,373,368,294,243,158,249
../../CUB_200_2011/images\016.Painted_Bunting/Painted_Bunting_0070_16515.jpg,500,365,016.Painted_Bunting,291,92,399,331,345,211,108,239
../../CUB_200_2011/images\016.Painted_Bunting/Painted_Bunting_0066_15241.jpg,358,500,016.Painted_Bunting,94,242,261,433,177,337,167,191
../../CUB_200_2011/images\016.Painted_Bunting/Painted_Bunting_0099_16525.jpg,500,375,016.Painted_Bunting,137,67,312,341,224,204,175,274
../../CUB_200_2011/images\016.Painted_Bunting/Painted_Bunting_0006_15249.jpg,467,500,016.Painted_Bunting,27,42,403,448,215,245,376,406
../../CUB_200_2011/images\016.Painted_Bunting/Painted_Bunting_0029_16530.jpg,375,500,016.Painted_Bunting,111,75,304,466,207,270,193,391
../../CUB_200_2011/images\016.Painted_Bunting/Painted_Bunting_0084_16531.jpg,500,411,016.Painted_Bunting,195,46,459,367,327,206,264,321
../../CUB_200_2011/images\016.Painted_Bunting/Painted_Bunting_0080_16534.jpg,401,500,016.Painted_Bunting,98,178,250,342,174,260,152,164
../../CUB_200_2011/images\016.Painted_Bunting/Painted_Bunting_0046_16535.jpg,335,500,016.Painted_Bunting,50,58,274,268,162,163,224,210
../../CUB_200_2011/images\016.Painted_Bunting/Painted_Bunting_0027_16536.jpg,500,478,016.Painted_Bunting,158,72,332,396,245,234,174,324
../../CUB_200_2011/images\016.Painted_Bunting/Painted_Bunting_0086_16540.jpg,500,495,016.Painted_Bunting,134,134,355,464,244,299,221,330
../../CUB_200_2011/images\016.Painted_Bunting/Painted_Bunting_0044_16557.jpg,500,333,016.Painted_Bunting,119,39,414,286,266,162,295,247
../../CUB_200_2011/images\016.Painted_Bunting/Painted_Bunting_0085_15282.jpg,500,324,016.Painted_Bunting,75,38,461,315,268,176,386,277
../../CUB_200_2011/images\016.Painted_Bunting/Painted_Bunting_0036_16563.jpg,500,333,016.Painted_Bunting,105,78,312,296,208,187,207,218
../../CUB_200_2011/images\016.Painted_Bunting/Painted_Bunting_0078_16565.jpg,400,500,016.Painted_Bunting,83,93,215,386,149,239,132,293
../../CUB_200_2011/images\016.Painted_Bunting/Painted_Bunting_0013_15294.jpg,500,340,016.Painted_Bunting,89,96,375,279,232,187,286,183
../../CUB_200_2011/images\016.Painted_Bunting/Painted_Bunting_0021_15295.jpg,500,400,016.Painted_Bunting,209,79,348,323,278,201,139,244
../../CUB_200_2011/images\016.Painted_Bunting/Painted_Bunting_0001_16585.jpg,500,375,016.Painted_Bunting,168,156,270,279,219,217,102,123
../../CUB_200_2011/images\016.Painted_Bunting/Painted_Bunting_0083_16587.jpg,500,332,016.Painted_Bunting,224,114,345,272,284,193,121,158
../../CUB_200_2011/images\016.Painted_Bunting/Painted_Bunting_0009_16674.jpg,500,334,016.Painted_Bunting,179,69,339,280,259,174,160,211
../../CUB_200_2011/images\016.Painted_Bunting/Painted_Bunting_0056_16599.jpg,500,324,016.Painted_Bunting,114,25,306,276,210,150,192,251
../../CUB_200_2011/images\016.Painted_Bunting/Painted_Bunting_0032_16605.jpg,500,375,016.Painted_Bunting,73,81,314,284,193,182,241,203
../../CUB_200_2011/images\016.Painted_Bunting/Painted_Bunting_0049_16869.jpg,500,333,016.Painted_Bunting,159,78,349,288,254,183,190,210
../../CUB_200_2011/images\016.Painted_Bunting/Painted_Bunting_0060_15224.jpg,500,333,016.Painted_Bunting,94,107,248,228,171,167,154,121
../../CUB_200_2011/images\016.Painted_Bunting/Painted_Bunting_0002_16887.jpg,398,500,016.Painted_Bunting,127,198,254,323,190,260,127,125
../../CUB_200_2011/images\017.Cardinal/Cardinal_0038_19203.jpg,500,336,017.Cardinal,198,69,432,324,315,196,234,255
../../CUB_200_2011/images\017.Cardinal/Cardinal_0072_17159.jpg,500,397,017.Cardinal,85,17,419,362,252,189,334,345
../../CUB_200_2011/images\017.Cardinal/Cardinal_0085_19162.jpg,500,334,017.Cardinal,118,19,472,310,295,164,354,291
../../CUB_200_2011/images\017.Cardinal/Cardinal_0047_17673.jpg,500,398,017.Cardinal,142,49,308,356,225,202,166,307
../../CUB_200_2011/images\017.Cardinal/Cardinal_0094_17165.jpg,500,348,017.Cardinal,113,36,424,221,268,128,311,185
../../CUB_200_2011/images\017.Cardinal/Cardinal_0035_17678.jpg,455,500,017.Cardinal,116,169,272,342,194,255,156,173
../../CUB_200_2011/images\017.Cardinal/Cardinal_0045_18021.jpg,400,500,017.Cardinal,167,73,361,477,264,275,194,404
../../CUB_200_2011/images\017.Cardinal/Cardinal_0103_17425.jpg,500,424,017.Cardinal,2,28,469,417,235,222,467,389
../../CUB_200_2011/images\017.Cardinal/Cardinal_0102_17808.jpg,500,375,017.Cardinal,219,22,489,374,354,198,270,352
../../CUB_200_2011/images\017.Cardinal/Cardinal_0006_17684.jpg,500,427,017.Cardinal,164,99,487,396,325,247,323,297
../../CUB_200_2011/images\017.Cardinal/Cardinal_0054_19334.jpg,435,500,017.Cardinal,65,77,381,442,223,259,316,365
../../CUB_200_2011/images\017.Cardinal/Cardinal_0075_17946.jpg,399,500,017.Cardinal,91,118,276,394,183,256,185,276
../../CUB_200_2011/images\017.Cardinal/Cardinal_0078_17181.jpg,500,477,017.Cardinal,131,32,440,427,285,229,309,395
../../CUB_200_2011/images\017.Cardinal/Cardinal_0041_17189.jpg,500,390,017.Cardinal,81,151,338,266,209,208,257,115
../../CUB_200_2011/images\017.Cardinal/Cardinal_0066_17803.jpg,500,384,017.Cardinal,56,112,349,250,202,181,293,138
../../CUB_200_2011/images\017.Cardinal/Cardinal_0040_17477.jpg,500,338,017.Cardinal,111,90,387,247,249,168,276,157
../../CUB_200_2011/images\017.Cardinal/Cardinal_0051_17223.jpg,500,421,017.Cardinal,4,167,190,419,97,293,186,252
../../CUB_200_2011/images\017.Cardinal/Cardinal_0093_17676.jpg,407,500,017.Cardinal,146,22,347,499,246,260,201,477
../../CUB_200_2011/images\017.Cardinal/Cardinal_0022_17233.jpg,388,500,017.Cardinal,67,76,228,470,147,273,161,394
../../CUB_200_2011/images\017.Cardinal/Cardinal_0023_19026.jpg,500,407,017.Cardinal,44,109,251,366,147,237,207,257
../../CUB_200_2011/images\017.Cardinal/Cardinal_0019_17368.jpg,500,333,017.Cardinal,125,89,499,325,312,207,374,236
../../CUB_200_2011/images\017.Cardinal/Cardinal_0089_18005.jpg,500,353,017.Cardinal,163,74,285,300,224,187,122,226
../../CUB_200_2011/images\017.Cardinal/Cardinal_0025_17239.jpg,500,362,017.Cardinal,120,45,490,317,305,181,370,272
../../CUB_200_2011/images\017.Cardinal/Cardinal_0033_19215.jpg,401,500,017.Cardinal,102,58,319,472,210,265,217,414
../../CUB_200_2011/images\017.Cardinal/Cardinal_0079_19044.jpg,500,346,017.Cardinal,226,53,422,223,324,138,196,170
../../CUB_200_2011/images\017.Cardinal/Cardinal_0105_19045.jpg,500,390,017.Cardinal,138,115,418,309,278,212,280,194
../../CUB_200_2011/images\017.Cardinal/Cardinal_0029_17297.jpg,500,333,017.Cardinal,112,37,343,314,227,175,231,277
../../CUB_200_2011/images\017.Cardinal/Cardinal_0081_17291.jpg,500,341,017.Cardinal,90,67,376,311,233,189,286,244
../../CUB_200_2011/images\017.Cardinal/Cardinal_0050_18035.jpg,419,500,017.Cardinal,111,70,315,338,213,204,204,268
../../CUB_200_2011/images\017.Cardinal/Cardinal_0007_18537.jpg,500,375,017.Cardinal,74,41,315,369,194,205,241,328
../../CUB_200_2011/images\017.Cardinal/Cardinal_0083_18042.jpg,500,375,017.Cardinal,89,78,472,320,280,199,383,242
../../CUB_200_2011/images\017.Cardinal/Cardinal_0020_18664.jpg,500,386,017.Cardinal,87,68,471,345,279,206,384,277
../../CUB_200_2011/images\017.Cardinal/Cardinal_0053_17541.jpg,377,500,017.Cardinal,67,81,282,442,174,261,215,361
../../CUB_200_2011/images\017.Cardinal/Cardinal_0028_18054.jpg,500,250,017.Cardinal,44,84,210,223,127,153,166,139
../../CUB_200_2011/images\017.Cardinal/Cardinal_0014_17389.jpg,500,375,017.Cardinal,111,48,460,344,285,196,349,296
../../CUB_200_2011/images\017.Cardinal/Cardinal_0052_18334.jpg,500,330,017.Cardinal,37,90,394,267,215,178,357,177
../../CUB_200_2011/images\017.Cardinal/Cardinal_0001_17057.jpg,500,464,017.Cardinal,91,38,487,463,289,250,396,425
../../CUB_200_2011/images\017.Cardinal/Cardinal_0074_18339.jpg,500,333,017.Cardinal,192,31,397,314,294,172,205,283
../../CUB_200_2011/images\017.Cardinal/Cardinal_0084_17576.jpg,500,409,017.Cardinal,69,150,294,336,181,243,225,186
../../CUB_200_2011/images\017.Cardinal/Cardinal_0037_18092.jpg,445,500,017.Cardinal,53,97,291,361,172,229,238,264
../../CUB_200_2011/images\017.Cardinal/Cardinal_0018_17071.jpg,431,500,017.Cardinal,98,48,358,499,228,273,260,451
../../CUB_200_2011/images\017.Cardinal/Cardinal_0056_18352.jpg,500,375,017.Cardinal,98,1,447,358,272,179,349,357
../../CUB_200_2011/images\017.Cardinal/Cardinal_0062_17334.jpg,500,375,017.Cardinal,98,75,499,363,298,219,401,288
../../CUB_200_2011/images\017.Cardinal/Cardinal_0092_17591.jpg,500,500,017.Cardinal,89,52,424,453,256,252,335,401
../../CUB_200_2011/images\017.Cardinal/Cardinal_0095_18108.jpg,382,500,017.Cardinal,81,55,368,398,224,226,287,343
../../CUB_200_2011/images\017.Cardinal/Cardinal_0039_17597.jpg,500,429,017.Cardinal,0,73,341,428,170,250,341,355
../../CUB_200_2011/images\017.Cardinal/Cardinal_0016_17862.jpg,494,500,017.Cardinal,159,126,316,464,237,295,157,338
../../CUB_200_2011/images\017.Cardinal/Cardinal_0012_18638.jpg,500,434,017.Cardinal,137,54,323,411,230,232,186,357
../../CUB_200_2011/images\017.Cardinal/Cardinal_0055_18898.jpg,500,333,017.Cardinal,293,75,434,330,363,202,141,255
../../CUB_200_2011/images\017.Cardinal/Cardinal_0010_18894.jpg,500,332,017.Cardinal,33,50,204,255,118,152,171,205
../../CUB_200_2011/images\017.Cardinal/Cardinal_0104_17122.jpg,352,500,017.Cardinal,33,47,315,474,174,260,282,427
../../CUB_200_2011/images\017.Cardinal/Cardinal_0057_17128.jpg,500,393,017.Cardinal,26,32,441,283,233,157,415,251
../../CUB_200_2011/images\017.Cardinal/Cardinal_0049_18258.jpg,333,500,017.Cardinal,75,38,278,413,176,225,203,375
../../CUB_200_2011/images\017.Cardinal/Cardinal_0082_17875.jpg,444,500,017.Cardinal,101,80,363,499,232,289,262,419
../../CUB_200_2011/images\017.Cardinal/Cardinal_0060_17139.jpg,420,500,017.Cardinal,93,114,409,449,251,281,316,335
../../CUB_200_2011/images\017.Cardinal/Cardinal_0097_17396.jpg,500,375,017.Cardinal,193,114,417,312,305,213,224,198
../../CUB_200_2011/images\017.Cardinal/Cardinal_0002_18424.jpg,333,500,017.Cardinal,106,65,263,457,184,261,157,392
../../CUB_200_2011/images\018.Spotted_Catbird/Spotted_Catbird_0018_796800.jpg,239,320,018.Spotted_Catbird,63,35,197,306,130,170,134,271
../../CUB_200_2011/images\018.Spotted_Catbird/Spotted_Catbird_0030_796801.jpg,500,333,018.Spotted_Catbird,67,109,289,269,178,189,222,160
../../CUB_200_2011/images\018.Spotted_Catbird/Spotted_Catbird_0012_796802.jpg,500,381,018.Spotted_Catbird,183,32,394,349,288,190,211,317
../../CUB_200_2011/images\018.Spotted_Catbird/Spotted_Catbird_0016_796803.jpg,200,133,018.Spotted_Catbird,25,29,160,132,92,80,135,103
../../CUB_200_2011/images\018.Spotted_Catbird/Spotted_Catbird_0004_796804.jpg,500,400,018.Spotted_Catbird,76,113,453,355,264,234,377,242
../../CUB_200_2011/images\018.Spotted_Catbird/Spotted_Catbird_0033_796805.jpg,500,375,018.Spotted_Catbird,121,23,362,363,241,193,241,340
../../CUB_200_2011/images\018.Spotted_Catbird/Spotted_Catbird_0031_796806.jpg,300,226,018.Spotted_Catbird,57,40,251,187,154,113,194,147
../../CUB_200_2011/images\018.Spotted_Catbird/Spotted_Catbird_0041_796807.jpg,177,131,018.Spotted_Catbird,27,6,175,133,101,69,148,127
../../CUB_200_2011/images\018.Spotted_Catbird/Spotted_Catbird_0015_796808.jpg,500,407,018.Spotted_Catbird,51,69,367,396,209,232,316,327
../../CUB_200_2011/images\018.Spotted_Catbird/Spotted_Catbird_0044_796809.jpg,500,333,018.Spotted_Catbird,122,48,340,303,231,175,218,255
../../CUB_200_2011/images\018.Spotted_Catbird/Spotted_Catbird_0037_796810.jpg,500,333,018.Spotted_Catbird,70,42,272,288,171,165,202,246
../../CUB_200_2011/images\018.Spotted_Catbird/Spotted_Catbird_0039_796811.jpg,500,333,018.Spotted_Catbird,87,40,409,331,248,185,322,291
../../CUB_200_2011/images\018.Spotted_Catbird/Spotted_Catbird_0028_796813.jpg,500,327,018.Spotted_Catbird,83,55,371,277,227,166,288,222
../../CUB_200_2011/images\018.Spotted_Catbird/Spotted_Catbird_0045_796814.jpg,500,326,018.Spotted_Catbird,206,105,325,284,265,194,119,179
../../CUB_200_2011/images\018.Spotted_Catbird/Spotted_Catbird_0011_796815.jpg,500,333,018.Spotted_Catbird,129,87,415,243,272,165,286,156
../../CUB_200_2011/images\018.Spotted_Catbird/Spotted_Catbird_0048_796817.jpg,500,333,018.Spotted_Catbird,140,48,399,332,269,190,259,284
../../CUB_200_2011/images\018.Spotted_Catbird/Spotted_Catbird_0026_796818.jpg,500,335,018.Spotted_Catbird,105,55,391,289,248,172,286,234
../../CUB_200_2011/images\018.Spotted_Catbird/Spotted_Catbird_0025_796819.jpg,307,500,018.Spotted_Catbird,13,29,289,487,151,258,276,458
../../CUB_200_2011/images\018.Spotted_Catbird/Spotted_Catbird_0040_796820.jpg,333,500,018.Spotted_Catbird,9,54,310,478,159,266,301,424
../../CUB_200_2011/images\018.Spotted_Catbird/Spotted_Catbird_0022_796821.jpg,333,500,018.Spotted_Catbird,27,110,269,456,148,283,242,346
../../CUB_200_2011/images\018.Spotted_Catbird/Spotted_Catbird_0003_796822.jpg,500,353,018.Spotted_Catbird,153,71,470,313,311,192,317,242
../../CUB_200_2011/images\018.Spotted_Catbird/Spotted_Catbird_0006_796823.jpg,360,284,018.Spotted_Catbird,56,39,273,244,164,141,217,205
../../CUB_200_2011/images\018.Spotted_Catbird/Spotted_Catbird_0029_796825.jpg,255,263,018.Spotted_Catbird,38,18,246,254,142,136,208,236
../../CUB_200_2011/images\018.Spotted_Catbird/Spotted_Catbird_0002_796827.jpg,152,238,018.Spotted_Catbird,4,4,146,239,75,121,142,235
../../CUB_200_2011/images\018.Spotted_Catbird/Spotted_Catbird_0032_796828.jpg,350,234,018.Spotted_Catbird,104,22,312,212,208,117,208,190
../../CUB_200_2011/images\018.Spotted_Catbird/Spotted_Catbird_0046_19399.jpg,345,500,018.Spotted_Catbird,100,164,203,381,151,272,103,217
../../CUB_200_2011/images\018.Spotted_Catbird/Spotted_Catbird_0047_19400.jpg,500,333,018.Spotted_Catbird,4,60,401,328,202,194,397,268
../../CUB_200_2011/images\018.Spotted_Catbird/Spotted_Catbird_0036_19406.jpg,333,500,018.Spotted_Catbird,44,100,297,423,170,261,253,323
../../CUB_200_2011/images\018.Spotted_Catbird/Spotted_Catbird_0005_19411.jpg,500,337,018.Spotted_Catbird,104,8,342,328,223,168,238,320
../../CUB_200_2011/images\018.Spotted_Catbird/Spotted_Catbird_0007_19424.jpg,332,500,018.Spotted_Catbird,1,23,308,499,154,261,307,476
../../CUB_200_2011/images\018.Spotted_Catbird/Spotted_Catbird_0014_19425.jpg,500,397,018.Spotted_Catbird,174,61,283,338,228,199,109,277
../../CUB_200_2011/images\018.Spotted_Catbird/Spotted_Catbird_0013_19428.jpg,500,375,018.Spotted_Catbird,55,114,375,342,215,228,320,228
../../CUB_200_2011/images\018.Spotted_Catbird/Spotted_Catbird_0042_19430.jpg,500,333,018.Spotted_Catbird,102,72,277,242,189,157,175,170
../../CUB_200_2011/images\018.Spotted_Catbird/Spotted_Catbird_0010_19436.jpg,500,375,018.Spotted_Catbird,198,140,298,347,248,243,100,207
../../CUB_200_2011/images\018.Spotted_Catbird/Spotted_Catbird_0034_19437.jpg,500,333,018.Spotted_Catbird,191,40,346,331,268,185,155,291
../../CUB_200_2011/images\018.Spotted_Catbird/Spotted_Catbird_0019_796788.jpg,404,271,018.Spotted_Catbird,53,40,296,223,174,131,243,183
../../CUB_200_2011/images\018.Spotted_Catbird/Spotted_Catbird_0008_796789.jpg,400,266,018.Spotted_Catbird,58,51,305,208,181,129,247,157
../../CUB_200_2011/images\018.Spotted_Catbird/Spotted_Catbird_0024_796791.jpg,320,221,018.Spotted_Catbird,43,24,265,212,154,118,222,188
../../CUB_200_2011/images\018.Spotted_Catbird/Spotted_Catbird_0023_796793.jpg,361,383,018.Spotted_Catbird,6,10,343,315,174,162,337,305
../../CUB_200_2011/images\018.Spotted_Catbird/Spotted_Catbird_0020_796794.jpg,414,300,018.Spotted_Catbird,15,20,398,295,206,157,383,275
../../CUB_200_2011/images\018.Spotted_Catbird/Spotted_Catbird_0009_796795.jpg,500,333,018.Spotted_Catbird,135,79,309,265,222,172,174,186
../../CUB_200_2011/images\018.Spotted_Catbird/Spotted_Catbird_0027_796796.jpg,500,347,018.Spotted_Catbird,43,69,373,346,208,207,330,277
../../CUB_200_2011/images\018.Spotted_Catbird/Spotted_Catbird_0001_796797.jpg,246,314,018.Spotted_Catbird,46,41,209,311,127,176,163,270
../../CUB_200_2011/images\018.Spotted_Catbird/Spotted_Catbird_0021_796798.jpg,454,500,018.Spotted_Catbird,66,67,334,497,200,282,268,430
../../CUB_200_2011/images\018.Spotted_Catbird/Spotted_Catbird_0035_796799.jpg,250,253,018.Spotted_Catbird,35,29,214,247,124,138,179,218
../../CUB_200_2011/images\019.Gray_Catbird/Gray_Catbird_0043_21008.jpg,500,333,019.Gray_Catbird,86,87,287,248,186,167,201,161
../../CUB_200_2011/images\019.Gray_Catbird/Gray_Catbird_0032_21551.jpg,500,375,019.Gray_Catbird,2,69,459,380,230,224,457,311
../../CUB_200_2011/images\019.Gray_Catbird/Gray_Catbird_0067_21043.jpg,500,449,019.Gray_Catbird,202,69,399,322,300,195,197,253
../../CUB_200_2011/images\019.Gray_Catbird/Gray_Catbird_0039_21040.jpg,500,473,019.Gray_Catbird,75,81,385,392,230,236,310,311
../../CUB_200_2011/images\019.Gray_Catbird/Gray_Catbird_0127_20034.jpg,500,333,019.Gray_Catbird,96,90,244,281,170,185,148,191
../../CUB_200_2011/images\019.Gray_Catbird/Gray_Catbird_0069_21065.jpg,375,500,019.Gray_Catbird,106,62,275,471,190,266,169,409
../../CUB_200_2011/images\019.Gray_Catbird/Gray_Catbird_0048_20558.jpg,500,425,019.Gray_Catbird,112,82,450,403,281,242,338,321
../../CUB_200_2011/images\019.Gray_Catbird/Gray_Catbird_0013_20562.jpg,500,488,019.Gray_Catbird,63,66,260,446,161,256,197,380
../../CUB_200_2011/images\019.Gray_Catbird/Gray_Catbird_0019_20567.jpg,500,400,019.Gray_Catbird,164,124,394,295,279,209,230,171
../../CUB_200_2011/images\019.Gray_Catbird/Gray_Catbird_0111_19550.jpg,500,333,019.Gray_Catbird,146,107,399,259,272,183,253,152
../../CUB_200_2011/images\019.Gray_Catbird/Gray_Catbird_0023_20668.jpg,500,333,019.Gray_Catbird,205,115,345,305,275,210,140,190
../../CUB_200_2011/images\019.Gray_Catbird/Gray_Catbird_0130_20328.jpg,500,377,019.Gray_Catbird,184,94,442,330,313,212,258,236
../../CUB_200_2011/images\019.Gray_Catbird/Gray_Catbird_0134_20596.jpg,500,353,019.Gray_Catbird,151,100,466,302,308,201,315,202
../../CUB_200_2011/images\019.Gray_Catbird/Gray_Catbird_0028_20598.jpg,500,350,019.Gray_Catbird,10,26,375,343,192,184,365,317
../../CUB_200_2011/images\019.Gray_Catbird/Gray_Catbird_0022_19585.jpg,500,451,019.Gray_Catbird,259,67,411,345,335,206,152,278
../../CUB_200_2011/images\019.Gray_Catbird/Gray_Catbird_0031_21635.jpg,500,388,019.Gray_Catbird,213,135,463,319,338,227,250,184
../../CUB_200_2011/images\019.Gray_Catbird/Gray_Catbird_0075_21125.jpg,500,383,019.Gray_Catbird,49,48,404,366,226,207,355,318
../../CUB_200_2011/images\019.Gray_Catbird/Gray_Catbird_0074_19601.jpg,500,338,019.Gray_Catbird,112,76,483,330,297,203,371,254
../../CUB_200_2011/images\019.Gray_Catbird/Gray_Catbird_0102_20644.jpg,500,345,019.Gray_Catbird,183,92,300,200,241,146,117,108
../../CUB_200_2011/images\019.Gray_Catbird/Gray_Catbird_0080_20139.jpg,500,333,019.Gray_Catbird,15,44,480,331,247,187,465,287
../../CUB_200_2011/images\019.Gray_Catbird/Gray_Catbird_0060_20656.jpg,500,360,019.Gray_Catbird,59,124,334,284,196,204,275,160
../../CUB_200_2011/images\019.Gray_Catbird/Gray_Catbird_0131_19633.jpg,500,400,019.Gray_Catbird,133,60,420,317,276,188,287,257
../../CUB_200_2011/images\019.Gray_Catbird/Gray_Catbird_0141_21174.jpg,500,350,019.Gray_Catbird,29,89,361,303,195,196,332,214
../../CUB_200_2011/images\019.Gray_Catbird/Gray_Catbird_0101_21178.jpg,500,333,019.Gray_Catbird,63,100,471,292,267,196,408,192
../../CUB_200_2011/images\019.Gray_Catbird/Gray_Catbird_0055_20671.jpg,481,393,019.Gray_Catbird,153,33,452,369,302,201,299,336
../../CUB_200_2011/images\019.Gray_Catbird/Gray_Catbird_0100_20674.jpg,500,400,019.Gray_Catbird,48,54,499,305,273,179,451,251
../../CUB_200_2011/images\019.Gray_Catbird/Gray_Catbird_0107_20513.jpg,475,383,019.Gray_Catbird,48,20,224,363,136,191,176,343
../../CUB_200_2011/images\019.Gray_Catbird/Gray_Catbird_0053_20694.jpg,500,375,019.Gray_Catbird,65,43,431,311,248,177,366,268
../../CUB_200_2011/images\019.Gray_Catbird/Gray_Catbird_0001_20695.jpg,500,392,019.Gray_Catbird,141,19,357,383,249,201,216,364
../../CUB_200_2011/images\019.Gray_Catbird/Gray_Catbird_0063_20707.jpg,500,454,019.Gray_Catbird,102,87,421,413,261,250,319,326
../../CUB_200_2011/images\019.Gray_Catbird/Gray_Catbird_0104_20716.jpg,363,500,019.Gray_Catbird,49,48,287,458,168,253,238,410
../../CUB_200_2011/images\019.Gray_Catbird/Gray_Catbird_0015_21230.jpg,500,400,019.Gray_Catbird,10,72,440,273,225,172,430,201
../../CUB_200_2011/images\019.Gray_Catbird/Gray_Catbird_0092_20735.jpg,500,403,019.Gray_Catbird,144,127,373,306,258,216,229,179
../../CUB_200_2011/images\019.Gray_Catbird/Gray_Catbird_0024_20739.jpg,500,333,019.Gray_Catbird,173,72,405,275,289,173,232,203
../../CUB_200_2011/images\019.Gray_Catbird/Gray_Catbird_0091_20416.jpg,500,375,019.Gray_Catbird,178,175,425,280,301,227,247,105
../../CUB_200_2011/images\019.Gray_Catbird/Gray_Catbird_0113_21270.jpg,500,333,019.Gray_Catbird,91,63,379,317,235,190,288,254
../../CUB_200_2011/images\019.Gray_Catbird/Gray_Catbird_0050_20763.jpg,500,402,019.Gray_Catbird,135,101,404,321,269,211,269,220
../../CUB_200_2011/images\019.Gray_Catbird/Gray_Catbird_0007_20186.jpg,500,333,019.Gray_Catbird,131,68,377,273,254,170,246,205
../../CUB_200_2011/images\019.Gray_Catbird/Gray_Catbird_0139_21281.jpg,500,333,019.Gray_Catbird,103,65,364,231,233,148,261,166
../../CUB_200_2011/images\019.Gray_Catbird/Gray_Catbird_0094_21303.jpg,500,333,019.Gray_Catbird,179,76,308,292,243,184,129,216
../../CUB_200_2011/images\019.Gray_Catbird/Gray_Catbird_0049_21311.jpg,500,333,019.Gray_Catbird,60,48,316,280,188,164,256,232
../../CUB_200_2011/images\019.Gray_Catbird/Gray_Catbird_0117_21333.jpg,500,443,019.Gray_Catbird,146,130,341,438,243,284,195,308
../../CUB_200_2011/images\019.Gray_Catbird/Gray_Catbird_0125_19833.jpg,500,375,019.Gray_Catbird,232,109,348,365,290,237,116,256
../../CUB_200_2011/images\019.Gray_Catbird/Gray_Catbird_0105_20864.jpg,500,315,019.Gray_Catbird,62,41,238,250,150,145,176,209
../../CUB_200_2011/images\019.Gray_Catbird/Gray_Catbird_0042_20546.jpg,333,500,019.Gray_Catbird,88,64,283,473,185,268,195,409
../../CUB_200_2011/images\019.Gray_Catbird/Gray_Catbird_0002_21395.jpg,500,411,019.Gray_Catbird,146,98,456,410,301,254,310,312
../../CUB_200_2011/images\019.Gray_Catbird/Gray_Catbird_0057_20979.jpg,500,331,019.Gray_Catbird,123,86,314,267,218,176,191,181
../../CUB_200_2011/images\019.Gray_Catbird/Gray_Catbird_0103_20930.jpg,500,338,019.Gray_Catbird,66,64,434,300,250,182,368,236
../../CUB_200_2011/images\019.Gray_Catbird/Gray_Catbird_0008_20430.jpg,500,307,019.Gray_Catbird,148,121,409,254,278,187,261,133
../../CUB_200_2011/images\019.Gray_Catbird/Gray_Catbird_0138_20945.jpg,446,500,019.Gray_Catbird,31,6,445,432,238,219,414,426
../../CUB_200_2011/images\019.Gray_Catbird/Gray_Catbird_0045_20950.jpg,500,375,019.Gray_Catbird,190,13,402,304,296,158,212,291
../../CUB_200_2011/images\019.Gray_Catbird/Gray_Catbird_0090_21464.jpg,333,500,019.Gray_Catbird,86,89,281,430,183,259,195,341
../../CUB_200_2011/images\019.Gray_Catbird/Gray_Catbird_0044_20955.jpg,416,304,019.Gray_Catbird,45,53,394,247,219,150,349,194
../../CUB_200_2011/images\019.Gray_Catbird/Gray_Catbird_0027_20968.jpg,500,346,019.Gray_Catbird,94,86,268,276,181,181,174,190
../../CUB_200_2011/images\019.Gray_Catbird/Gray_Catbird_0118_20476.jpg,500,331,019.Gray_Catbird,46,36,471,307,258,171,425,271
../../CUB_200_2011/images\019.Gray_Catbird/Gray_Catbird_0006_20867.jpg,500,333,019.Gray_Catbird,85,93,462,296,273,194,377,203
../../CUB_200_2011/images\019.Gray_Catbird/Gray_Catbird_0071_20974.jpg,500,375,019.Gray_Catbird,48,93,474,311,261,202,426,218
../../CUB_200_2011/images\019.Gray_Catbird/Gray_Catbird_0126_19446.jpg,500,357,019.Gray_Catbird,92,70,446,264,269,167,354,194
../../CUB_200_2011/images\019.Gray_Catbird/Gray_Catbird_0129_20987.jpg,460,366,019.Gray_Catbird,26,104,370,322,198,213,344,218
../../CUB_200_2011/images\020.Yellow_breasted_Chat/Yellow_Breasted_Chat_0029_22017.jpg,500,375,020.Yellow_breasted_Chat,169,121,439,295,304,208,270,174
../../CUB_200_2011/images\020.Yellow_breasted_Chat/Yellow_Breasted_Chat_0090_21931.jpg,500,375,020.Yellow_breasted_Chat,80,79,344,292,212,185,264,213
../../CUB_200_2011/images\020.Yellow_breasted_Chat/Yellow_Breasted_Chat_0073_21932.jpg,500,375,020.Yellow_breasted_Chat,193,142,354,286,273,214,161,144
../../CUB_200_2011/images\020.Yellow_breasted_Chat/Yellow_Breasted_Chat_0106_22032.jpg,422,500,020.Yellow_breasted_Chat,151,130,253,282,202,206,102,152
../../CUB_200_2011/images\020.Yellow_breasted_Chat/Yellow_Breasted_Chat_0010_21777.jpg,500,415,020.Yellow_breasted_Chat,142,106,308,335,225,220,166,229
../../CUB_200_2011/images\020.Yellow_breasted_Chat/Yellow_Breasted_Chat_0063_21783.jpg,500,398,020.Yellow_breasted_Chat,82,123,359,328,220,225,277,205
../../CUB_200_2011/images\020.Yellow_breasted_Chat/Yellow_Breasted_Chat_0109_21796.jpg,500,333,020.Yellow_breasted_Chat,101,121,326,227,213,174,225,106
../../CUB_200_2011/images\020.Yellow_breasted_Chat/Yellow_Breasted_Chat_0048_21797.jpg,500,378,020.Yellow_breasted_Chat,99,60,377,353,238,206,278,293
../../CUB_200_2011/images\020.Yellow_breasted_Chat/Yellow_Breasted_Chat_0089_21804.jpg,500,343,020.Yellow_breasted_Chat,158,73,394,264,276,168,236,191
../../CUB_200_2011/images\020.Yellow_breasted_Chat/Yellow_Breasted_Chat_0011_21820.jpg,500,399,020.Yellow_breasted_Chat,41,76,444,283,242,179,403,207
../../CUB_200_2011/images\020.Yellow_breasted_Chat/Yellow_Breasted_Chat_0032_21823.jpg,333,500,020.Yellow_breasted_Chat,91,106,230,409,160,257,139,303
../../CUB_200_2011/images\020.Yellow_breasted_Chat/Yellow_Breasted_Chat_0084_22082.jpg,375,500,020.Yellow_breasted_Chat,102,198,286,441,194,319,184,243
../../CUB_200_2011/images\020.Yellow_breasted_Chat/Yellow_Breasted_Chat_0005_21828.jpg,500,357,020.Yellow_breasted_Chat,214,83,405,282,309,182,191,199
../../CUB_200_2011/images\020.Yellow_breasted_Chat/Yellow_Breasted_Chat_0072_21830.jpg,333,500,020.Yellow_breasted_Chat,28,170,194,470,111,320,166,300
../../CUB_200_2011/images\020.Yellow_breasted_Chat/Yellow_Breasted_Chat_0095_21832.jpg,357,500,020.Yellow_breasted_Chat,58,65,233,447,145,256,175,382
../../CUB_200_2011/images\020.Yellow_breasted_Chat/Yellow_Breasted_Chat_0066_21839.jpg,500,401,020.Yellow_breasted_Chat,120,88,496,377,308,232,376,289
../../CUB_200_2011/images\020.Yellow_breasted_Chat/Yellow_Breasted_Chat_0026_21845.jpg,500,375,020.Yellow_breasted_Chat,40,119,425,351,232,235,385,232
../../CUB_200_2011/images\020.Yellow_breasted_Chat/Yellow_Breasted_Chat_0044_22106.jpg,500,374,020.Yellow_breasted_Chat,48,120,238,327,143,223,190,207
../../CUB_200_2011/images\020.Yellow_breasted_Chat/Yellow_Breasted_Chat_0091_22111.jpg,500,333,020.Yellow_breasted_Chat,128,36,485,332,306,184,357,296
../../CUB_200_2011/images\020.Yellow_breasted_Chat/Yellow_Breasted_Chat_0008_21856.jpg,500,422,020.Yellow_breasted_Chat,131,157,297,315,214,236,166,158
../../CUB_200_2011/images\020.Yellow_breasted_Chat/Yellow_Breasted_Chat_0002_21819.jpg,500,333,020.Yellow_breasted_Chat,179,77,364,273,271,175,185,196
../../CUB_200_2011/images\020.Yellow_breasted_Chat/Yellow_Breasted_Chat_0068_21860.jpg,500,375,020.Yellow_breasted_Chat,225,48,340,331,282,189,115,283
../../CUB_200_2011/images\020.Yellow_breasted_Chat/Yellow_Breasted_Chat_0058_21864.jpg,500,333,020.Yellow_breasted_Chat,62,100,456,332,259,216,394,232
../../CUB_200_2011/images\020.Yellow_breasted_Chat/Yellow_Breasted_Chat_0052_21866.jpg,500,340,020.Yellow_breasted_Chat,87,125,318,245,202,185,231,120
../../CUB_200_2011/images\020.Yellow_breasted_Chat/Yellow_Breasted_Chat_0035_21870.jpg,500,468,020.Yellow_breasted_Chat,131,123,304,311,217,217,173,188
../../CUB_200_2011/images\020.Yellow_breasted_Chat/Yellow_Breasted_Chat_0110_21871.jpg,500,327,020.Yellow_breasted_Chat,73,88,444,252,258,170,371,164
../../CUB_200_2011/images\020.Yellow_breasted_Chat/Yellow_Breasted_Chat_0071_22129.jpg,500,336,020.Yellow_breasted_Chat,100,160,294,289,197,224,194,129
../../CUB_200_2011/images\020.Yellow_breasted_Chat/Yellow_Breasted_Chat_0086_21877.jpg,500,334,020.Yellow_breasted_Chat,184,140,385,261,284,200,201,121
../../CUB_200_2011/images\020.Yellow_breasted_Chat/Yellow_Breasted_Chat_0065_22137.jpg,432,289,020.Yellow_breasted_Chat,127,90,350,222,238,156,223,132
../../CUB_200_2011/images\020.Yellow_breasted_Chat/Yellow_Breasted_Chat_0085_21899.jpg,500,469,020.Yellow_breasted_Chat,61,66,364,439,212,252,303,373
../../CUB_200_2011/images\020.Yellow_breasted_Chat/Yellow_Breasted_Chat_0039_21654.jpg,500,333,020.Yellow_breasted_Chat,296,93,448,231,372,162,152,138
../../CUB_200_2011/images\020.Yellow_breasted_Chat/Yellow_Breasted_Chat_0100_21913.jpg,500,375,020.Yellow_breasted_Chat,142,134,355,370,248,252,213,236
../../CUB_200_2011/images\020.Yellow_breasted_Chat/Yellow_Breasted_Chat_0081_21829.jpg,280,227,020.Yellow_breasted_Chat,44,47,239,182,141,114,195,135
../../CUB_200_2011/images\020.Yellow_breasted_Chat/Yellow_Breasted_Chat_0023_21664.jpg,369,500,020.Yellow_breasted_Chat,129,149,288,355,208,252,159,206
../../CUB_200_2011/images\020.Yellow_breasted_Chat/Yellow_Breasted_Chat_0103_21670.jpg,500,335,020.Yellow_breasted_Chat,128,92,397,272,262,182,269,180
../../CUB_200_2011/images\020.Yellow_breasted_Chat/Yellow_Breasted_Chat_0001_21928.jpg,500,443,020.Yellow_breasted_Chat,188,105,346,353,267,229,158,248
../../CUB_200_2011/images\020.Yellow_breasted_Chat/Yellow_Breasted_Chat_0062_21673.jpg,500,318,020.Yellow_breasted_Chat,73,62,382,253,227,157,309,191
../../CUB_200_2011/images\020.Yellow_breasted_Chat/Yellow_Breasted_Chat_0101_21677.jpg,500,333,020.Yellow_breasted_Chat,91,47,257,321,174,184,166,274
../../CUB_200_2011/images\020.Yellow_breasted_Chat/Yellow_Breasted_Chat_0041_21683.jpg,410,500,020.Yellow_breasted_Chat,96,66,296,458,196,262,200,392
../../CUB_200_2011/images\020.Yellow_breasted_Chat/Yellow_Breasted_Chat_0088_21686.jpg,273,382,020.Yellow_breasted_Chat,79,61,255,368,167,214,176,307
../../CUB_200_2011/images\020.Yellow_breasted_Chat/Yellow_Breasted_Chat_0022_21944.jpg,500,333,020.Yellow_breasted_Chat,129,107,475,262,302,184,346,155
../../CUB_200_2011/images\020.Yellow_breasted_Chat/Yellow_Breasted_Chat_0094_21693.jpg,418,500,020.Yellow_breasted_Chat,94,83,324,381,209,232,230,298
../../CUB_200_2011/images\020.Yellow_breasted_Chat/Yellow_Breasted_Chat_0087_21695.jpg,359,500,020.Yellow_breasted_Chat,40,191,274,453,157,322,234,262
../../CUB_200_2011/images\020.Yellow_breasted_Chat/Yellow_Breasted_Chat_0102_21696.jpg,500,329,020.Yellow_breasted_Chat,105,64,454,265,279,164,349,201
../../CUB_200_2011/images\020.Yellow_breasted_Chat/Yellow_Breasted_Chat_0107_21698.jpg,500,375,020.Yellow_breasted_Chat,23,133,305,293,164,213,282,160
../../CUB_200_2011/images\020.Yellow_breasted_Chat/Yellow_Breasted_Chat_0034_21955.jpg,333,500,020.Yellow_breasted_Chat,55,161,295,355,175,258,240,194
../../CUB_200_2011/images\020.Yellow_breasted_Chat/Yellow_Breasted_Chat_0012_21961.jpg,500,335,020.Yellow_breasted_Chat,98,94,371,292,234,193,273,198
../../CUB_200_2011/images\020.Yellow_breasted_Chat/Yellow_Breasted_Chat_0030_21964.jpg,333,500,020.Yellow_breasted_Chat,109,195,258,381,183,288,149,186
../../CUB_200_2011/images\020.Yellow_breasted_Chat/Yellow_Breasted_Chat_0061_21967.jpg,500,334,020.Yellow_breasted_Chat,132,46,303,243,217,144,171,197
../../CUB_200_2011/images\020.Yellow_breasted_Chat/Yellow_Breasted_Chat_0105_21714.jpg,500,326,020.Yellow_breasted_Chat,223,67,400,233,311,150,177,166
../../CUB_200_2011/images\020.Yellow_breasted_Chat/Yellow_Breasted_Chat_0075_21715.jpg,375,500,020.Yellow_breasted_Chat,59,107,354,499,206,303,295,392
../../CUB_200_2011/images\020.Yellow_breasted_Chat/Yellow_Breasted_Chat_0017_21719.jpg,500,324,020.Yellow_breasted_Chat,123,18,306,323,214,170,183,305
../../CUB_200_2011/images\020.Yellow_breasted_Chat/Yellow_Breasted_Chat_0079_21978.jpg,300,286,020.Yellow_breasted_Chat,25,31,242,272,133,151,217,241
../../CUB_200_2011/images\020.Yellow_breasted_Chat/Yellow_Breasted_Chat_0077_21986.jpg,500,333,020.Yellow_breasted_Chat,245,121,411,249,328,185,166,128
../../CUB_200_2011/images\020.Yellow_breasted_Chat/Yellow_Breasted_Chat_0098_21987.jpg,500,345,020.Yellow_breasted_Chat,188,74,347,311,267,192,159,237
../../CUB_200_2011/images\020.Yellow_breasted_Chat/Yellow_Breasted_Chat_0014_21970.jpg,500,347,020.Yellow_breasted_Chat,205,126,325,265,265,195,120,139
../../CUB_200_2011/images\020.Yellow_breasted_Chat/Yellow_Breasted_Chat_0033_21873.jpg,500,333,020.Yellow_breasted_Chat,243,131,378,243,310,187,135,112
../../CUB_200_2011/images\020.Yellow_breasted_Chat/Yellow_Breasted_Chat_0097_21748.jpg,333,500,020.Yellow_breasted_Chat,53,98,203,229,128,163,150,131
../../CUB_200_2011/images\020.Yellow_breasted_Chat/Yellow_Breasted_Chat_0013_22008.jpg,500,400,020.Yellow_breasted_Chat,199,95,434,316,316,205,235,221
../../CUB_200_2011/images\021.Eastern_Towhee/Eastern_Towhee_0122_22538.jpg,500,333,021.Eastern_Towhee,122,99,284,220,203,159,162,121
../../CUB_200_2011/images\021.Eastern_Towhee/Eastern_Towhee_0018_22546.jpg,500,425,021.Eastern_Towhee,155,176,435,357,295,266,280,181
../../CUB_200_2011/images\021.Eastern_Towhee/Eastern_Towhee_0110_22549.jpg,500,403,021.Eastern_Towhee,145,122,326,263,235,192,181,141
../../CUB_200_2011/images\021.Eastern_Towhee/Eastern_Towhee_0048_22557.jpg,427,500,021.Eastern_Towhee,119,121,413,458,266,289,294,337
../../CUB_200_2011/images\021.Eastern_Towhee/Eastern_Towhee_0052_22558.jpg,481,500,021.Eastern_Towhee,89,38,398,468,243,253,309,430
../../CUB_200_2011/images\021.Eastern_Towhee/Eastern_Towhee_0101_22559.jpg,334,500,021.Eastern_Towhee,26,64,246,475,136,269,220,411
../../CUB_200_2011/images\021.Eastern_Towhee/Eastern_Towhee_0099_22566.jpg,500,354,021.Eastern_Towhee,0,81,404,267,202,174,404,186
../../CUB_200_2011/images\021.Eastern_Towhee/Eastern_Towhee_0068_22194.jpg,500,374,021.Eastern_Towhee,127,92,435,334,281,213,308,242
../../CUB_200_2011/images\021.Eastern_Towhee/Eastern_Towhee_0097_22580.jpg,500,375,021.Eastern_Towhee,231,181,385,296,308,238,154,115
../../CUB_200_2011/images\021.Eastern_Towhee/Eastern_Towhee_0124_22585.jpg,356,500,021.Eastern_Towhee,127,107,259,353,193,230,132,246
../../CUB_200_2011/images\021.Eastern_Towhee/Eastern_Towhee_0075_22588.jpg,500,313,021.Eastern_Towhee,142,61,405,271,273,166,263,210
../../CUB_200_2011/images\021.Eastern_Towhee/Eastern_Towhee_0095_22594.jpg,500,350,021.Eastern_Towhee,309,113,484,275,396,194,175,162
../../CUB_200_2011/images\021.Eastern_Towhee/Eastern_Towhee_0086_22611.jpg,500,382,021.Eastern_Towhee,155,77,313,328,234,202,158,251
../../CUB_200_2011/images\021.Eastern_Towhee/Eastern_Towhee_0074_22620.jpg,500,358,021.Eastern_Towhee,74,156,234,268,154,212,160,112
../../CUB_200_2011/images\021.Eastern_Towhee/Eastern_Towhee_0093_22621.jpg,500,297,021.Eastern_Towhee,14,18,494,288,254,153,480,270
../../CUB_200_2011/images\021.Eastern_Towhee/Eastern_Towhee_0053_22623.jpg,500,375,021.Eastern_Towhee,139,104,367,374,253,239,228,270
../../CUB_200_2011/images\021.Eastern_Towhee/Eastern_Towhee_0134_22624.jpg,500,321,021.Eastern_Towhee,27,83,344,287,185,185,317,204
../../CUB_200_2011/images\021.Eastern_Towhee/Eastern_Towhee_0091_22629.jpg,450,349,021.Eastern_Towhee,78,34,400,335,239,184,322,301
../../CUB_200_2011/images\021.Eastern_Towhee/Eastern_Towhee_0126_22639.jpg,500,355,021.Eastern_Towhee,26,81,298,263,162,172,272,182
../../CUB_200_2011/images\021.Eastern_Towhee/Eastern_Towhee_0064_22649.jpg,500,374,021.Eastern_Towhee,118,121,428,270,273,195,310,149
../../CUB_200_2011/images\021.Eastern_Towhee/Eastern_Towhee_0017_22138.jpg,500,400,021.Eastern_Towhee,153,95,383,337,268,216,230,242
../../CUB_200_2011/images\021.Eastern_Towhee/Eastern_Towhee_0020_22141.jpg,500,326,021.Eastern_Towhee,100,32,437,260,268,146,337,228
../../CUB_200_2011/images\021.Eastern_Towhee/Eastern_Towhee_0067_22142.jpg,400,500,021.Eastern_Towhee,103,82,387,453,245,267,284,371
../../CUB_200_2011/images\021.Eastern_Towhee/Eastern_Towhee_0054_22147.jpg,500,377,021.Eastern_Towhee,90,90,275,327,182,208,185,237
../../CUB_200_2011/images\021.Eastern_Towhee/Eastern_Towhee_0021_22152.jpg,500,332,021.Eastern_Towhee,61,22,488,317,274,169,427,295
../../CUB_200_2011/images\021.Eastern_Towhee/Eastern_Towhee_0042_22155.jpg,500,401,021.Eastern_Towhee,161,106,474,400,317,253,313,294
../../CUB_200_2011/images\021.Eastern_Towhee/Eastern_Towhee_0085_22674.jpg,500,354,021.Eastern_Towhee,7,55,454,333,230,194,447,278
../../CUB_200_2011/images\021.Eastern_Towhee/Eastern_Towhee_0105_22675.jpg,333,500,021.Eastern_Towhee,82,230,224,342,153,286,142,112
../../CUB_200_2011/images\021.Eastern_Towhee/Eastern_Towhee_0098_22676.jpg,500,333,021.Eastern_Towhee,188,99,348,264,268,181,160,165
../../CUB_200_2011/images\021.Eastern_Towhee/Eastern_Towhee_0111_22168.jpg,500,375,021.Eastern_Towhee,128,57,432,340,280,198,304,283
../../CUB_200_2011/images\021.Eastern_Towhee/Eastern_Towhee_0007_22172.jpg,500,413,021.Eastern_Towhee,20,60,410,327,215,193,390,267
../../CUB_200_2011/images\021.Eastern_Towhee/Eastern_Towhee_0030_22693.jpg,500,363,021.Eastern_Towhee,50,28,350,350,200,189,300,322
../../CUB_200_2011/images\021.Eastern_Towhee/Eastern_Towhee_0108_22182.jpg,500,357,021.Eastern_Towhee,21,97,297,299,159,198,276,202
../../CUB_200_2011/images\021.Eastern_Towhee/Eastern_Towhee_0120_22189.jpg,500,422,021.Eastern_Towhee,55,83,388,325,221,204,333,242
../../CUB_200_2011/images\021.Eastern_Towhee/Eastern_Towhee_0125_22220.jpg,500,333,021.Eastern_Towhee,77,97,262,312,169,204,185,215
../../CUB_200_2011/images\021.Eastern_Towhee/Eastern_Towhee_0035_22223.jpg,500,310,021.Eastern_Towhee,65,87,391,275,228,181,326,188
../../CUB_200_2011/images\021.Eastern_Towhee/Eastern_Towhee_0117_22741.jpg,500,356,021.Eastern_Towhee,265,152,445,315,355,233,180,163
../../CUB_200_2011/images\021.Eastern_Towhee/Eastern_Towhee_0112_22231.jpg,500,353,021.Eastern_Towhee,31,39,278,305,154,172,247,266
../../CUB_200_2011/images\021.Eastern_Towhee/Eastern_Towhee_0031_22233.jpg,500,333,021.Eastern_Towhee,28,95,202,309,115,202,174,214
../../CUB_200_2011/images\021.Eastern_Towhee/Eastern_Towhee_0073_22247.jpg,500,318,021.Eastern_Towhee,75,69,472,281,273,175,397,212
../../CUB_200_2011/images\021.Eastern_Towhee/Eastern_Towhee_0050_22257.jpg,500,500,021.Eastern_Towhee,132,88,287,471,209,279,155,383
../../CUB_200_2011/images\021.Eastern_Towhee/Eastern_Towhee_0090_22273.jpg,500,345,021.Eastern_Towhee,91,83,223,280,157,181,132,197
../../CUB_200_2011/images\021.Eastern_Towhee/Eastern_Towhee_0015_22275.jpg,500,439,021.Eastern_Towhee,33,54,455,399,244,226,422,345
../../CUB_200_2011/images\021.Eastern_Towhee/Eastern_Towhee_0022_22279.jpg,500,436,021.Eastern_Towhee,130,132,458,352,294,242,328,220
../../CUB_200_2011/images\021.Eastern_Towhee/Eastern_Towhee_0080_22303.jpg,500,369,021.Eastern_Towhee,165,67,330,346,247,206,165,279
../../CUB_200_2011/images\021.Eastern_Towhee/Eastern_Towhee_0115_22304.jpg,500,424,021.Eastern_Towhee,90,61,351,378,220,219,261,317
../../CUB_200_2011/images\021.Eastern_Towhee/Eastern_Towhee_0001_22314.jpg,500,333,021.Eastern_Towhee,176,98,321,243,248,170,145,145
../../CUB_200_2011/images\021.Eastern_Towhee/Eastern_Towhee_0002_22318.jpg,500,334,021.Eastern_Towhee,218,95,424,277,321,186,206,182
../../CUB_200_2011/images\021.Eastern_Towhee/Eastern_Towhee_0121_22319.jpg,500,375,021.Eastern_Towhee,114,54,467,331,290,192,353,277
../../CUB_200_2011/images\021.Eastern_Towhee/Eastern_Towhee_0082_22330.jpg,500,333,021.Eastern_Towhee,88,110,300,258,194,184,212,148
../../CUB_200_2011/images\021.Eastern_Towhee/Eastern_Towhee_0013_22336.jpg,500,351,021.Eastern_Towhee,25,110,317,296,171,203,292,186
../../CUB_200_2011/images\021.Eastern_Towhee/Eastern_Towhee_0040_22341.jpg,500,375,021.Eastern_Towhee,0,15,401,374,200,194,401,359
../../CUB_200_2011/images\021.Eastern_Towhee/Eastern_Towhee_0049_22357.jpg,500,357,021.Eastern_Towhee,180,88,424,306,302,197,244,218
../../CUB_200_2011/images\021.Eastern_Towhee/Eastern_Towhee_0129_22358.jpg,500,366,021.Eastern_Towhee,154,115,346,272,250,193,192,157
../../CUB_200_2011/images\021.Eastern_Towhee/Eastern_Towhee_0014_22367.jpg,500,375,021.Eastern_Towhee,87,33,431,340,259,186,344,307
../../CUB_200_2011/images\021.Eastern_Towhee/Eastern_Towhee_0027_22372.jpg,436,500,021.Eastern_Towhee,55,21,386,491,220,256,331,470
../../CUB_200_2011/images\021.Eastern_Towhee/Eastern_Towhee_0024_22382.jpg,500,333,021.Eastern_Towhee,60,111,309,251,184,181,249,140
../../CUB_200_2011/images\021.Eastern_Towhee/Eastern_Towhee_0038_22399.jpg,500,371,021.Eastern_Towhee,82,82,368,361,225,221,286,279
../../CUB_200_2011/images\021.Eastern_Towhee/Eastern_Towhee_0062_22418.jpg,500,375,021.Eastern_Towhee,220,179,475,346,347,262,255,167
../../CUB_200_2011/images\021.Eastern_Towhee/Eastern_Towhee_0079_22690.jpg,500,426,021.Eastern_Towhee,49,73,434,395,241,234,385,322
../../CUB_200_2011/images\022.Chuck_will_Widow/Chuck_Will_Widow_0033_22792.jpg,500,291,022.Chuck_will_Widow,24,22,489,270,256,146,465,248
../../CUB_200_2011/images\022.Chuck_will_Widow/Chuck_Will_Widow_0045_22798.jpg,500,375,022.Chuck_will_Widow,29,43,387,374,208,208,358,331
../../CUB_200_2011/images\022.Chuck_will_Widow/Chuck_Will_Widow_0032_22802.jpg,500,408,022.Chuck_will_Widow,140,58,348,287,244,172,208,229
../../CUB_200_2011/images\022.Chuck_will_Widow/Chuck_Will_Widow_0019_22806.jpg,500,354,022.Chuck_will_Widow,55,111,292,244,173,177,237,133
../../CUB_200_2011/images\022.Chuck_will_Widow/Chuck_Will_Widow_0021_796952.jpg,500,328,022.Chuck_will_Widow,143,130,383,264,263,197,240,134
../../CUB_200_2011/images\022.Chuck_will_Widow/Chuck_Will_Widow_0053_796953.jpg,500,400,022.Chuck_will_Widow,44,84,429,351,236,217,385,267
../../CUB_200_2011/images\022.Chuck_will_Widow/Chuck_Will_Widow_0011_796954.jpg,500,261,022.Chuck_will_Widow,10,46,478,207,244,126,468,161
../../CUB_200_2011/images\022.Chuck_will_Widow/Chuck_Will_Widow_0009_796955.jpg,453,340,022.Chuck_will_Widow,22,49,421,315,221,182,399,266
../../CUB_200_2011/images\022.Chuck_will_Widow/Chuck_Will_Widow_0012_796956.jpg,500,393,022.Chuck_will_Widow,50,98,375,336,212,217,325,238
../../CUB_200_2011/images\022.Chuck_will_Widow/Chuck_Will_Widow_0004_796957.jpg,358,400,022.Chuck_will_Widow,23,15,356,391,189,203,333,376
../../CUB_200_2011/images\022.Chuck_will_Widow/Chuck_Will_Widow_0007_796958.jpg,372,270,022.Chuck_will_Widow,14,13,350,206,182,109,336,193
../../CUB_200_2011/images\022.Chuck_will_Widow/Chuck_Will_Widow_0002_796959.jpg,328,298,022.Chuck_will_Widow,62,46,240,218,151,132,178,172
../../CUB_200_2011/images\022.Chuck_will_Widow/Chuck_Will_Widow_0017_796960.jpg,360,326,022.Chuck_will_Widow,4,109,280,240,142,174,276,131
../../CUB_200_2011/images\022.Chuck_will_Widow/Chuck_Will_Widow_0037_796961.jpg,333,500,022.Chuck_will_Widow,60,105,316,415,188,260,256,310
../../CUB_200_2011/images\022.Chuck_will_Widow/Chuck_Will_Widow_0015_796962.jpg,350,295,022.Chuck_will_Widow,39,22,342,284,190,153,303,262
../../CUB_200_2011/images\022.Chuck_will_Widow/Chuck_Will_Widow_0026_796963.jpg,350,247,022.Chuck_will_Widow,8,12,349,245,178,128,341,233
../../CUB_200_2011/images\022.Chuck_will_Widow/Chuck_Will_Widow_0010_796964.jpg,500,360,022.Chuck_will_Widow,40,74,427,338,233,206,387,264
../../CUB_200_2011/images\022.Chuck_will_Widow/Chuck_Will_Widow_0020_796965.jpg,500,343,022.Chuck_will_Widow,2,102,457,313,229,207,455,211
../../CUB_200_2011/images\022.Chuck_will_Widow/Chuck_Will_Widow_0046_796966.jpg,418,500,022.Chuck_will_Widow,129,131,341,407,235,269,212,276
../../CUB_200_2011/images\022.Chuck_will_Widow/Chuck_Will_Widow_0022_796967.jpg,230,155,022.Chuck_will_Widow,5,9,220,146,112,77,215,137
../../CUB_200_2011/images\022.Chuck_will_Widow/Chuck_Will_Widow_0008_796968.jpg,404,271,022.Chuck_will_Widow,44,72,267,173,155,122,223,101
../../CUB_200_2011/images\022.Chuck_will_Widow/Chuck_Will_Widow_0034_796969.jpg,380,253,022.Chuck_will_Widow,11,51,356,224,183,137,345,173
../../CUB_200_2011/images\022.Chuck_will_Widow/Chuck_Will_Widow_0057_796970.jpg,500,333,022.Chuck_will_Widow,1,50,445,312,223,181,444,262
../../CUB_200_2011/images\022.Chuck_will_Widow/Chuck_Will_Widow_0047_796971.jpg,377,250,022.Chuck_will_Widow,50,10,270,242,160,126,220,232
../../CUB_200_2011/images\022.Chuck_will_Widow/Chuck_Will_Widow_0025_796972.jpg,500,403,022.Chuck_will_Widow,41,92,351,374,196,233,310,282
../../CUB_200_2011/images\022.Chuck_will_Widow/Chuck_Will_Widow_0055_796973.jpg,500,333,022.Chuck_will_Widow,118,64,499,236,308,150,381,172
../../CUB_200_2011/images\022.Chuck_will_Widow/Chuck_Will_Widow_0016_796974.jpg,500,332,022.Chuck_will_Widow,29,51,467,332,248,191,438,281
../../CUB_200_2011/images\022.Chuck_will_Widow/Chuck_Will_Widow_0001_796975.jpg,500,332,022.Chuck_will_Widow,155,101,371,323,263,212,216,222
../../CUB_200_2011/images\022.Chuck_will_Widow/Chuck_Will_Widow_0040_796976.jpg,500,276,022.Chuck_will_Widow,3,40,427,242,215,141,424,202
../../CUB_200_2011/images\022.Chuck_will_Widow/Chuck_Will_Widow_0003_796977.jpg,500,370,022.Chuck_will_Widow,163,69,464,320,313,194,301,251
../../CUB_200_2011/images\022.Chuck_will_Widow/Chuck_Will_Widow_0027_796978.jpg,500,330,022.Chuck_will_Widow,1,0,421,263,211,131,420,263
../../CUB_200_2011/images\022.Chuck_will_Widow/Chuck_Will_Widow_0023_796979.jpg,429,290,022.Chuck_will_Widow,120,72,394,253,257,162,274,181
../../CUB_200_2011/images\022.Chuck_will_Widow/Chuck_Will_Widow_0018_796980.jpg,350,340,022.Chuck_will_Widow,25,52,320,268,172,160,295,216
../../CUB_200_2011/images\022.Chuck_will_Widow/Chuck_Will_Widow_0031_796981.jpg,500,406,022.Chuck_will_Widow,37,95,478,256,257,175,441,161
../../CUB_200_2011/images\022.Chuck_will_Widow/Chuck_Will_Widow_0059_796982.jpg,500,382,022.Chuck_will_Widow,23,76,444,333,233,204,421,257
../../CUB_200_2011/images\022.Chuck_will_Widow/Chuck_Will_Widow_0042_796983.jpg,500,320,022.Chuck_will_Widow,9,14,352,288,180,151,343,274
../../CUB_200_2011/images\022.Chuck_will_Widow/Chuck_Will_Widow_0052_796984.jpg,350,444,022.Chuck_will_Widow,7,47,331,412,169,229,324,365
../../CUB_200_2011/images\022.Chuck_will_Widow/Chuck_Will_Widow_0035_796985.jpg,500,334,022.Chuck_will_Widow,54,60,499,333,276,196,445,273
../../CUB_200_2011/images\022.Chuck_will_Widow/Chuck_Will_Widow_0006_796986.jpg,450,319,022.Chuck_will_Widow,16,80,436,279,226,179,420,199
../../CUB_200_2011/images\022.Chuck_will_Widow/Chuck_Will_Widow_0014_796987.jpg,500,334,022.Chuck_will_Widow,159,51,423,290,291,170,264,239
../../CUB_200_2011/images\022.Chuck_will_Widow/Chuck_Will_Widow_0028_796988.jpg,500,333,022.Chuck_will_Widow,107,61,499,291,303,176,392,230
../../CUB_200_2011/images\022.Chuck_will_Widow/Chuck_Will_Widow_0038_796989.jpg,359,296,022.Chuck_will_Widow,1,5,341,239,171,122,340,234
../../CUB_200_2011/images\022.Chuck_will_Widow/Chuck_Will_Widow_0051_796991.jpg,500,410,022.Chuck_will_Widow,92,51,532,354,312,202,440,303
../../CUB_200_2011/images\022.Chuck_will_Widow/Chuck_Will_Widow_0024_796993.jpg,376,325,022.Chuck_will_Widow,8,12,336,309,172,160,328,297
../../CUB_200_2011/images\022.Chuck_will_Widow/Chuck_Will_Widow_0030_796994.jpg,500,402,022.Chuck_will_Widow,82,53,499,357,290,205,417,304
../../CUB_200_2011/images\022.Chuck_will_Widow/Chuck_Will_Widow_0048_796995.jpg,500,435,022.Chuck_will_Widow,31,23,478,405,254,214,447,382
../../CUB_200_2011/images\022.Chuck_will_Widow/Chuck_Will_Widow_0056_796996.jpg,500,382,022.Chuck_will_Widow,21,74,425,237,223,155,404,163
../../CUB_200_2011/images\022.Chuck_will_Widow/Chuck_Will_Widow_0041_796997.jpg,500,375,022.Chuck_will_Widow,8,25,418,332,213,178,410,307
../../CUB_200_2011/images\022.Chuck_will_Widow/Chuck_Will_Widow_0005_796998.jpg,500,333,022.Chuck_will_Widow,172,22,374,263,273,142,202,241
../../CUB_200_2011/images\022.Chuck_will_Widow/Chuck_Will_Widow_0058_796999.jpg,480,348,022.Chuck_will_Widow,67,43,425,333,246,188,358,290
../../CUB_200_2011/images\022.Chuck_will_Widow/Chuck_Will_Widow_0039_797000.jpg,357,500,022.Chuck_will_Widow,2,66,325,454,163,260,323,388
../../CUB_200_2011/images\022.Chuck_will_Widow/Chuck_Will_Widow_0043_797001.jpg,500,375,022.Chuck_will_Widow,64,81,408,322,236,201,344,241
../../CUB_200_2011/images\022.Chuck_will_Widow/Chuck_Will_Widow_0049_22747.jpg,500,347,022.Chuck_will_Widow,94,72,463,348,278,210,369,276
../../CUB_200_2011/images\022.Chuck_will_Widow/Chuck_Will_Widow_0050_22750.jpg,500,375,022.Chuck_will_Widow,1,33,480,373,240,203,479,340
../../CUB_200_2011/images\022.Chuck_will_Widow/Chuck_Will_Widow_0029_22751.jpg,500,308,022.Chuck_will_Widow,99,69,399,252,249,160,300,183
../../CUB_200_2011/images\022.Chuck_will_Widow/Chuck_Will_Widow_0054_22782.jpg,500,323,022.Chuck_will_Widow,80,55,396,307,238,181,316,252
../../CUB_200_2011/images\023.Brandt_Cormorant/Brandt_Cormorant_0029_23043.jpg,500,333,023.Brandt_Cormorant,25,47,430,194,227,120,405,147
../../CUB_200_2011/images\023.Brandt_Cormorant/Brandt_Cormorant_0014_23050.jpg,500,333,023.Brandt_Cormorant,123,22,333,334,228,178,210,312
../../CUB_200_2011/images\023.Brandt_Cormorant/Brandt_Cormorant_0019_23058.jpg,500,375,023.Brandt_Cormorant,163,40,495,374,329,207,332,334
../../CUB_200_2011/images\023.Brandt_Cormorant/Brandt_Cormorant_0092_23061.jpg,500,441,023.Brandt_Cormorant,41,80,353,378,197,229,312,298
../../CUB_200_2011/images\023.Brandt_Cormorant/Brandt_Cormorant_0072_23069.jpg,331,500,023.Brandt_Cormorant,125,45,324,313,224,179,199,268
../../CUB_200_2011/images\023.Brandt_Cormorant/Brandt_Cormorant_0002_23072.jpg,500,310,023.Brandt_Cormorant,240,131,442,243,341,187,202,112
../../CUB_200_2011/images\023.Brandt_Cormorant/Brandt_Cormorant_0025_22820.jpg,500,333,023.Brandt_Cormorant,153,27,390,292,271,159,237,265
../../CUB_200_2011/images\023.Brandt_Cormorant/Brandt_Cormorant_0016_23077.jpg,500,337,023.Brandt_Cormorant,37,84,379,232,208,158,342,148
../../CUB_200_2011/images\023.Brandt_Cormorant/Brandt_Cormorant_0018_23090.jpg,500,334,023.Brandt_Cormorant,266,27,430,317,348,172,164,290
../../CUB_200_2011/images\023.Brandt_Cormorant/Brandt_Cormorant_0067_23352.jpg,500,379,023.Brandt_Cormorant,68,20,499,376,283,198,431,356
../../CUB_200_2011/images\023.Brandt_Cormorant/Brandt_Cormorant_0021_23097.jpg,500,333,023.Brandt_Cormorant,62,76,449,308,255,192,387,232
../../CUB_200_2011/images\023.Brandt_Cormorant/Brandt_Cormorant_0052_23356.jpg,500,309,023.Brandt_Cormorant,36,28,494,300,265,164,458,272
../../CUB_200_2011/images\023.Brandt_Cormorant/Brandt_Cormorant_0064_22849.jpg,500,333,023.Brandt_Cormorant,145,49,388,228,266,138,243,179
../../CUB_200_2011/images\023.Brandt_Cormorant/Brandt_Cormorant_0038_23110.jpg,500,375,023.Brandt_Cormorant,90,58,265,326,177,192,175,268
../../CUB_200_2011/images\023.Brandt_Cormorant/Brandt_Cormorant_0074_22881.jpg,333,500,023.Brandt_Cormorant,43,38,303,498,173,268,260,460
../../CUB_200_2011/images\023.Brandt_Cormorant/Brandt_Cormorant_0065_23118.jpg,500,241,023.Brandt_Cormorant,14,20,498,240,256,130,484,220
../../CUB_200_2011/images\023.Brandt_Cormorant/Brandt_Cormorant_0087_23126.jpg,500,313,023.Brandt_Cormorant,56,38,425,311,240,174,369,273
../../CUB_200_2011/images\023.Brandt_Cormorant/Brandt_Cormorant_0079_22874.jpg,452,500,023.Brandt_Cormorant,184,170,451,499,317,334,267,329
../../CUB_200_2011/images\023.Brandt_Cormorant/Brandt_Cormorant_0013_23391.jpg,375,500,023.Brandt_Cormorant,113,142,216,312,164,227,103,170
../../CUB_200_2011/images\023.Brandt_Cormorant/Brandt_Cormorant_0070_23137.jpg,500,350,023.Brandt_Cormorant,15,95,440,349,227,222,425,254
../../CUB_200_2011/images\023.Brandt_Cormorant/Brandt_Cormorant_0044_22884.jpg,358,500,023.Brandt_Cormorant,111,123,263,426,187,274,152,303
../../CUB_200_2011/images\023.Brandt_Cormorant/Brandt_Cormorant_0017_23141.jpg,500,333,023.Brandt_Cormorant,160,85,471,332,315,208,311,247
../../CUB_200_2011/images\023.Brandt_Cormorant/Brandt_Cormorant_0001_23398.jpg,500,381,023.Brandt_Cormorant,75,94,370,304,222,199,295,210
../../CUB_200_2011/images\023.Brandt_Cormorant/Brandt_Cormorant_0040_23144.jpg,500,335,023.Brandt_Cormorant,159,63,473,334,316,198,314,271
../../CUB_200_2011/images\023.Brandt_Cormorant/Brandt_Cormorant_0009_22890.jpg,392,500,023.Brandt_Cormorant,94,18,373,499,233,258,279,481
../../CUB_200_2011/images\023.Brandt_Cormorant/Brandt_Cormorant_0028_22892.jpg,500,333,023.Brandt_Cormorant,165,46,343,298,254,172,178,252
../../CUB_200_2011/images\023.Brandt_Cormorant/Brandt_Cormorant_0042_23151.jpg,500,333,023.Brandt_Cormorant,105,83,323,230,214,156,218,147
../../CUB_200_2011/images\023.Brandt_Cormorant/Brandt_Cormorant_0083_23156.jpg,500,322,023.Brandt_Cormorant,62,43,354,218,208,130,292,175
../../CUB_200_2011/images\023.Brandt_Cormorant/Brandt_Cormorant_0022_23157.jpg,500,425,023.Brandt_Cormorant,139,145,304,251,221,198,165,106
../../CUB_200_2011/images\023.Brandt_Cormorant/Brandt_Cormorant_0061_22902.jpg,500,333,023.Brandt_Cormorant,128,19,280,300,204,159,152,281
../../CUB_200_2011/images\023.Brandt_Cormorant/Brandt_Cormorant_0026_22913.jpg,356,500,023.Brandt_Cormorant,92,69,258,457,175,263,166,388
../../CUB_200_2011/images\023.Brandt_Cormorant/Brandt_Cormorant_0045_22916.jpg,375,500,023.Brandt_Cormorant,137,43,312,459,224,251,175,416
../../CUB_200_2011/images\023.Brandt_Cormorant/Brandt_Cormorant_0003_22922.jpg,500,356,023.Brandt_Cormorant,126,31,496,355,311,193,370,324
../../CUB_200_2011/images\023.Brandt_Cormorant/Brandt_Cormorant_0049_22924.jpg,395,500,023.Brandt_Cormorant,59,88,205,449,132,268,146,361
../../CUB_200_2011/images\023.Brandt_Cormorant/Brandt_Cormorant_0030_22926.jpg,500,333,023.Brandt_Cormorant,96,90,437,332,266,211,341,242
../../CUB_200_2011/images\023.Brandt_Cormorant/Brandt_Cormorant_0007_22934.jpg,500,333,023.Brandt_Cormorant,39,42,495,262,267,152,456,220
../../CUB_200_2011/images\023.Brandt_Cormorant/Brandt_Cormorant_0036_22937.jpg,500,409,023.Brandt_Cormorant,222,32,400,363,311,197,178,331
../../CUB_200_2011/images\023.Brandt_Cormorant/Brandt_Cormorant_0091_22825.jpg,500,375,023.Brandt_Cormorant,91,54,498,374,294,214,407,320
../../CUB_200_2011/images\023.Brandt_Cormorant/Brandt_Cormorant_0015_23198.jpg,497,500,023.Brandt_Cormorant,202,41,368,425,285,233,166,384
../../CUB_200_2011/images\023.Brandt_Cormorant/Brandt_Cormorant_0039_22945.jpg,500,375,023.Brandt_Cormorant,33,110,421,374,227,242,388,264
../../CUB_200_2011/images\023.Brandt_Cormorant/Brandt_Cormorant_0078_23203.jpg,500,375,023.Brandt_Cormorant,89,163,296,272,192,217,207,109
../../CUB_200_2011/images\023.Brandt_Cormorant/Brandt_Cormorant_0053_22957.jpg,500,333,023.Brandt_Cormorant,4,71,445,332,224,201,441,261
../../CUB_200_2011/images\023.Brandt_Cormorant/Brandt_Cormorant_0075_22970.jpg,500,350,023.Brandt_Cormorant,72,110,363,294,217,202,291,184
../../CUB_200_2011/images\023.Brandt_Cormorant/Brandt_Cormorant_0033_22975.jpg,306,500,023.Brandt_Cormorant,25,68,242,441,133,254,217,373
../../CUB_200_2011/images\023.Brandt_Cormorant/Brandt_Cormorant_0082_22978.jpg,333,500,023.Brandt_Cormorant,57,114,273,390,165,252,216,276
../../CUB_200_2011/images\023.Brandt_Cormorant/Brandt_Cormorant_0032_22886.jpg,500,333,023.Brandt_Cormorant,165,102,436,308,300,205,271,206
../../CUB_200_2011/images\023.Brandt_Cormorant/Brandt_Cormorant_0006_22925.jpg,407,500,023.Brandt_Cormorant,73,47,393,485,233,266,320,438
../../CUB_200_2011/images\023.Brandt_Cormorant/Brandt_Cormorant_0023_23254.jpg,500,333,023.Brandt_Cormorant,86,86,351,301,218,193,265,215
../../CUB_200_2011/images\023.Brandt_Cormorant/Brandt_Cormorant_0035_23000.jpg,500,318,023.Brandt_Cormorant,246,76,472,260,359,168,226,184
../../CUB_200_2011/images\023.Brandt_Cormorant/Brandt_Cormorant_0088_22948.jpg,500,400,023.Brandt_Cormorant,0,20,356,399,178,209,356,379
../../CUB_200_2011/images\023.Brandt_Cormorant/Brandt_Cormorant_0080_23002.jpg,500,333,023.Brandt_Cormorant,20,27,221,298,120,162,201,271
../../CUB_200_2011/images\023.Brandt_Cormorant/Brandt_Cormorant_0073_23259.jpg,500,389,023.Brandt_Cormorant,39,2,396,351,217,176,357,349
../../CUB_200_2011/images\023.Brandt_Cormorant/Brandt_Cormorant_0071_23007.jpg,500,363,023.Brandt_Cormorant,2,20,415,362,208,191,413,342
../../CUB_200_2011/images\023.Brandt_Cormorant/Brandt_Cormorant_0084_23265.jpg,333,500,023.Brandt_Cormorant,68,104,208,287,138,195,140,183
../../CUB_200_2011/images\023.Brandt_Cormorant/Brandt_Cormorant_0063_22865.jpg,500,500,023.Brandt_Cormorant,96,107,497,499,296,303,401,392
../../CUB_200_2011/images\023.Brandt_Cormorant/Brandt_Cormorant_0068_23019.jpg,500,333,023.Brandt_Cormorant,19,50,341,221,180,135,322,171
../../CUB_200_2011/images\023.Brandt_Cormorant/Brandt_Cormorant_0076_23021.jpg,333,500,023.Brandt_Cormorant,43,110,246,499,144,304,203,389
../../CUB_200_2011/images\023.Brandt_Cormorant/Brandt_Cormorant_0047_23337.jpg,500,375,023.Brandt_Cormorant,141,40,272,308,206,174,131,268
../../CUB_200_2011/images\023.Brandt_Cormorant/Brandt_Cormorant_0062_23038.jpg,500,344,023.Brandt_Cormorant,122,94,445,267,283,180,323,173
../../CUB_200_2011/images\024.Red_faced_Cormorant/Red_Faced_Cormorant_0053_796331.jpg,298,400,024.Red_faced_Cormorant,55,29,222,383,138,206,167,354
../../CUB_200_2011/images\024.Red_faced_Cormorant/Red_Faced_Cormorant_0026_796289.jpg,500,374,024.Red_faced_Cormorant,45,96,342,288,193,192,297,192
../../CUB_200_2011/images\024.Red_faced_Cormorant/Red_Faced_Cormorant_0021_796265.jpg,500,299,024.Red_faced_Cormorant,91,86,284,294,187,190,193,208
../../CUB_200_2011/images\024.Red_faced_Cormorant/Red_Faced_Cormorant_0072_796269.jpg,500,500,024.Red_faced_Cormorant,115,91,369,429,242,260,254,338
../../CUB_200_2011/images\024.Red_faced_Cormorant/Red_Faced_Cormorant_0003_796270.jpg,500,375,024.Red_faced_Cormorant,188,132,319,371,253,251,131,239
../../CUB_200_2011/images\024.Red_faced_Cormorant/Red_Faced_Cormorant_0040_796272.jpg,295,500,024.Red_faced_Cormorant,84,11,251,496,167,253,167,485
../../CUB_200_2011/images\024.Red_faced_Cormorant/Red_Faced_Cormorant_0069_796274.jpg,500,333,024.Red_faced_Cormorant,179,104,347,298,263,201,168,194
../../CUB_200_2011/images\024.Red_faced_Cormorant/Red_Faced_Cormorant_0002_796275.jpg,330,500,024.Red_faced_Cormorant,94,161,243,407,168,284,149,246
../../CUB_200_2011/images\024.Red_faced_Cormorant/Red_Faced_Cormorant_0050_796276.jpg,431,500,024.Red_faced_Cormorant,132,70,375,481,253,275,243,411
../../CUB_200_2011/images\024.Red_faced_Cormorant/Red_Faced_Cormorant_0042_796277.jpg,333,500,024.Red_faced_Cormorant,67,94,212,482,139,288,145,388
../../CUB_200_2011/images\024.Red_faced_Cormorant/Red_Faced_Cormorant_0013_796278.jpg,500,333,024.Red_faced_Cormorant,135,50,339,171,237,110,204,121
../../CUB_200_2011/images\024.Red_faced_Cormorant/Red_Faced_Cormorant_0049_796279.jpg,333,500,024.Red_faced_Cormorant,67,94,212,403,139,248,145,309
../../CUB_200_2011/images\024.Red_faced_Cormorant/Red_Faced_Cormorant_0007_796280.jpg,350,233,024.Red_faced_Cormorant,33,32,297,232,165,132,264,200
../../CUB_200_2011/images\024.Red_faced_Cormorant/Red_Faced_Cormorant_0063_796284.jpg,457,500,024.Red_faced_Cormorant,206,118,346,304,276,211,140,186
../../CUB_200_2011/images\024.Red_faced_Cormorant/Red_Faced_Cormorant_0024_796285.jpg,500,319,024.Red_faced_Cormorant,157,53,283,253,220,153,126,200
../../CUB_200_2011/images\024.Red_faced_Cormorant/Red_Faced_Cormorant_0057_796286.jpg,334,500,024.Red_faced_Cormorant,96,62,269,454,182,258,173,392
../../CUB_200_2011/images\024.Red_faced_Cormorant/Red_Faced_Cormorant_0034_23425.jpg,500,375,024.Red_faced_Cormorant,19,79,436,310,227,194,417,231
../../CUB_200_2011/images\024.Red_faced_Cormorant/Red_Faced_Cormorant_0065_796293.jpg,500,250,024.Red_faced_Cormorant,119,70,401,214,260,142,282,144
../../CUB_200_2011/images\024.Red_faced_Cormorant/Red_Faced_Cormorant_0035_796294.jpg,334,500,024.Red_faced_Cormorant,71,79,333,496,202,287,262,417
../../CUB_200_2011/images\024.Red_faced_Cormorant/Red_Faced_Cormorant_0048_796296.jpg,391,500,024.Red_faced_Cormorant,39,48,362,419,200,233,323,371
../../CUB_200_2011/images\024.Red_faced_Cormorant/Red_Faced_Cormorant_0056_796297.jpg,350,350,024.Red_faced_Cormorant,76,18,248,331,162,174,172,313
../../CUB_200_2011/images\024.Red_faced_Cormorant/Red_Faced_Cormorant_0061_796300.jpg,500,369,024.Red_faced_Cormorant,44,47,416,351,230,199,372,304
../../CUB_200_2011/images\024.Red_faced_Cormorant/Red_Faced_Cormorant_0054_796301.jpg,341,500,024.Red_faced_Cormorant,68,41,271,469,169,255,203,428
../../CUB_200_2011/images\024.Red_faced_Cormorant/Red_Faced_Cormorant_0037_796305.jpg,278,500,024.Red_faced_Cormorant,21,24,233,472,127,248,212,448
../../CUB_200_2011/images\024.Red_faced_Cormorant/Red_Faced_Cormorant_0025_796306.jpg,423,500,024.Red_faced_Cormorant,141,53,308,451,224,252,167,398
../../CUB_200_2011/images\024.Red_faced_Cormorant/Red_Faced_Cormorant_0015_796307.jpg,334,500,024.Red_faced_Cormorant,125,98,238,256,181,177,113,158
../../CUB_200_2011/images\024.Red_faced_Cormorant/Red_Faced_Cormorant_0039_796308.jpg,500,319,024.Red_faced_Cormorant,190,12,306,302,248,157,116,290
../../CUB_200_2011/images\024.Red_faced_Cormorant/Red_Faced_Cormorant_0046_23446.jpg,500,333,024.Red_faced_Cormorant,162,20,403,311,282,165,241,291
../../CUB_200_2011/images\024.Red_faced_Cormorant/Red_Faced_Cormorant_0038_796313.jpg,231,350,024.Red_faced_Cormorant,24,124,230,349,127,236,206,225
../../CUB_200_2011/images\024.Red_faced_Cormorant/Red_Faced_Cormorant_0009_796314.jpg,500,347,024.Red_faced_Cormorant,273,64,393,309,333,186,120,245
../../CUB_200_2011/images\024.Red_faced_Cormorant/Red_Faced_Cormorant_0058_796315.jpg,362,500,024.Red_faced_Cormorant,64,119,234,343,149,231,170,224
../../CUB_200_2011/images\024.Red_faced_Cormorant/Red_Faced_Cormorant_0052_796316.jpg,433,290,024.Red_faced_Cormorant,30,64,318,289,174,176,288,225
../../CUB_200_2011/images\024.Red_faced_Cormorant/Red_Faced_Cormorant_0020_796318.jpg,263,350,024.Red_faced_Cormorant,55,8,211,346,133,177,156,338
../../CUB_200_2011/images\024.Red_faced_Cormorant/Red_Faced_Cormorant_0070_796319.jpg,500,369,024.Red_faced_Cormorant,99,63,203,194,151,128,104,131
../../CUB_200_2011/images\024.Red_faced_Cormorant/Red_Faced_Cormorant_0068_796321.jpg,404,271,024.Red_faced_Cormorant,46,35,338,270,192,152,292,235
../../CUB_200_2011/images\024.Red_faced_Cormorant/Red_Faced_Cormorant_0028_796322.jpg,311,500,024.Red_faced_Cormorant,58,58,238,440,148,249,180,382
../../CUB_200_2011/images\024.Red_faced_Cormorant/Red_Faced_Cormorant_0017_796323.jpg,271,404,024.Red_faced_Cormorant,108,74,234,323,171,198,126,249
../../CUB_200_2011/images\024.Red_faced_Cormorant/Red_Faced_Cormorant_0045_796324.jpg,500,446,024.Red_faced_Cormorant,78,78,382,243,230,160,304,165
../../CUB_200_2011/images\024.Red_faced_Cormorant/Red_Faced_Cormorant_0030_796325.jpg,334,500,024.Red_faced_Cormorant,44,71,243,499,143,285,199,428
../../CUB_200_2011/images\024.Red_faced_Cormorant/Red_Faced_Cormorant_0001_796327.jpg,500,471,024.Red_faced_Cormorant,190,122,365,386,277,254,175,264
../../CUB_200_2011/images\024.Red_faced_Cormorant/Red_Faced_Cormorant_0064_23464.jpg,500,333,024.Red_faced_Cormorant,177,114,302,332,239,223,125,218
../../CUB_200_2011/images\024.Red_faced_Cormorant/Red_Faced_Cormorant_0036_796329.jpg,180,270,024.Red_faced_Cormorant,1,55,166,269,83,162,165,214
../../CUB_200_2011/images\024.Red_faced_Cormorant/Red_Faced_Cormorant_0047_796330.jpg,334,500,024.Red_faced_Cormorant,40,110,324,500,182,305,284,390
../../CUB_200_2011/images\024.Red_faced_Cormorant/Red_Faced_Cormorant_0073_796332.jpg,271,404,024.Red_faced_Cormorant,82,70,219,378,150,224,137,308
../../CUB_200_2011/images\024.Red_faced_Cormorant/Red_Faced_Cormorant_0066_796333.jpg,258,381,024.Red_faced_Cormorant,90,69,210,356,150,212,120,287
../../CUB_200_2011/images\024.Red_faced_Cormorant/Red_Faced_Cormorant_0032_796334.jpg,500,383,024.Red_faced_Cormorant,205,5,316,379,260,192,111,374
../../CUB_200_2011/images\024.Red_faced_Cormorant/Red_Faced_Cormorant_0062_796336.jpg,333,500,024.Red_faced_Cormorant,75,121,231,445,153,283,156,324
../../CUB_200_2011/images\024.Red_faced_Cormorant/Red_Faced_Cormorant_0033_796337.jpg,360,430,024.Red_faced_Cormorant,59,101,221,324,140,212,162,223
../../CUB_200_2011/images\024.Red_faced_Cormorant/Red_Faced_Cormorant_0027_23482.jpg,500,313,024.Red_faced_Cormorant,128,136,415,249,271,192,287,113
../../CUB_200_2011/images\024.Red_faced_Cormorant/Red_Faced_Cormorant_0060_23416.jpg,500,333,024.Red_faced_Cormorant,224,8,378,332,301,170,154,324
../../CUB_200_2011/images\024.Red_faced_Cormorant/Red_Faced_Cormorant_0010_23421.jpg,343,500,024.Red_faced_Cormorant,86,90,274,494,180,292,188,404
../../CUB_200_2011/images\024.Red_faced_Cormorant/Red_Faced_Cormorant_0023_796328.jpg,500,419,024.Red_faced_Cormorant,89,56,389,364,239,210,300,308
../../CUB_200_2011/images\025.Pelagic_Cormorant/Pelagic_Cormorant_0054_23812.jpg,500,350,025.Pelagic_Cormorant,69,88,420,258,244,173,351,170
../../CUB_200_2011/images\025.Pelagic_Cormorant/Pelagic_Cormorant_0083_23557.jpg,500,333,025.Pelagic_Cormorant,94,110,311,260,202,185,217,150
../../CUB_200_2011/images\025.Pelagic_Cormorant/Pelagic_Cormorant_0009_23561.jpg,500,333,025.Pelagic_Cormorant,161,24,310,301,235,162,149,277
../../CUB_200_2011/images\025.Pelagic_Cormorant/Pelagic_Cormorant_0012_23565.jpg,375,500,025.Pelagic_Cormorant,54,13,366,495,210,254,312,482
../../CUB_200_2011/images\025.Pelagic_Cormorant/Pelagic_Cormorant_0032_23570.jpg,500,389,025.Pelagic_Cormorant,103,91,390,304,246,197,287,213
../../CUB_200_2011/images\025.Pelagic_Cormorant/Pelagic_Cormorant_0070_23513.jpg,500,375,025.Pelagic_Cormorant,229,35,376,345,302,190,147,310
../../CUB_200_2011/images\025.Pelagic_Cormorant/Pelagic_Cormorant_0084_23836.jpg,500,386,025.Pelagic_Cormorant,47,89,266,290,156,189,219,201
../../CUB_200_2011/images\025.Pelagic_Cormorant/Pelagic_Cormorant_0063_23515.jpg,387,500,025.Pelagic_Cormorant,152,64,339,491,245,277,187,427
../../CUB_200_2011/images\025.Pelagic_Cormorant/Pelagic_Cormorant_0046_23588.jpg,382,500,025.Pelagic_Cormorant,62,64,231,470,146,267,169,406
../../CUB_200_2011/images\025.Pelagic_Cormorant/Pelagic_Cormorant_0036_23503.jpg,500,317,025.Pelagic_Cormorant,131,5,286,311,208,158,155,306
../../CUB_200_2011/images\025.Pelagic_Cormorant/Pelagic_Cormorant_0035_23849.jpg,470,500,025.Pelagic_Cormorant,127,20,303,490,215,255,176,470
../../CUB_200_2011/images\025.Pelagic_Cormorant/Pelagic_Cormorant_0088_23855.jpg,500,400,025.Pelagic_Cormorant,194,98,331,349,262,223,137,251
../../CUB_200_2011/images\025.Pelagic_Cormorant/Pelagic_Cormorant_0008_23602.jpg,500,375,025.Pelagic_Cormorant,89,122,445,249,267,185,356,127
../../CUB_200_2011/images\025.Pelagic_Cormorant/Pelagic_Cormorant_0071_23964.jpg,500,346,025.Pelagic_Cormorant,33,39,364,262,198,150,331,223
../../CUB_200_2011/images\025.Pelagic_Cormorant/Pelagic_Cormorant_0017_23875.jpg,500,393,025.Pelagic_Cormorant,73,106,420,325,246,215,347,219
../../CUB_200_2011/images\025.Pelagic_Cormorant/Pelagic_Cormorant_0062_23623.jpg,398,500,025.Pelagic_Cormorant,71,45,301,388,186,216,230,343
../../CUB_200_2011/images\025.Pelagic_Cormorant/Pelagic_Cormorant_0042_23522.jpg,357,500,025.Pelagic_Cormorant,146,123,289,437,217,280,143,314
../../CUB_200_2011/images\025.Pelagic_Cormorant/Pelagic_Cormorant_0085_23821.jpg,375,500,025.Pelagic_Cormorant,89,38,318,494,203,266,229,456
../../CUB_200_2011/images\025.Pelagic_Cormorant/Pelagic_Cormorant_0037_23889.jpg,332,500,025.Pelagic_Cormorant,16,133,277,480,146,306,261,347
../../CUB_200_2011/images\025.Pelagic_Cormorant/Pelagic_Cormorant_0080_23890.jpg,367,500,025.Pelagic_Cormorant,42,118,289,416,165,267,247,298
../../CUB_200_2011/images\025.Pelagic_Cormorant/Pelagic_Cormorant_0100_23894.jpg,342,500,025.Pelagic_Cormorant,103,91,235,378,169,234,132,287
../../CUB_200_2011/images\025.Pelagic_Cormorant/Pelagic_Cormorant_0092_23639.jpg,500,437,025.Pelagic_Cormorant,158,42,333,432,245,237,175,390
../../CUB_200_2011/images\025.Pelagic_Cormorant/Pelagic_Cormorant_0064_23641.jpg,500,319,025.Pelagic_Cormorant,82,18,315,286,198,152,233,268
../../CUB_200_2011/images\025.Pelagic_Cormorant/Pelagic_Cormorant_0038_23643.jpg,500,340,025.Pelagic_Cormorant,31,54,455,230,243,142,424,176
../../CUB_200_2011/images\025.Pelagic_Cormorant/Pelagic_Cormorant_0075_23645.jpg,500,366,025.Pelagic_Cormorant,17,111,447,285,232,198,430,174
../../CUB_200_2011/images\025.Pelagic_Cormorant/Pelagic_Cormorant_0011_23667.jpg,500,281,025.Pelagic_Cormorant,196,21,387,181,291,101,191,160
../../CUB_200_2011/images\025.Pelagic_Cormorant/Pelagic_Cormorant_0029_23545.jpg,356,500,025.Pelagic_Cormorant,94,21,326,416,210,218,232,395
../../CUB_200_2011/images\025.Pelagic_Cormorant/Pelagic_Cormorant_0055_23415.jpg,309,500,025.Pelagic_Cormorant,58,245,170,424,114,334,112,179
../../CUB_200_2011/images\025.Pelagic_Cormorant/Pelagic_Cormorant_0002_23680.jpg,500,375,025.Pelagic_Cormorant,162,47,418,359,290,203,256,312
../../CUB_200_2011/images\025.Pelagic_Cormorant/Pelagic_Cormorant_0003_23695.jpg,500,340,025.Pelagic_Cormorant,175,37,354,328,264,182,179,291
../../CUB_200_2011/images\025.Pelagic_Cormorant/Pelagic_Cormorant_0010_23711.jpg,382,500,025.Pelagic_Cormorant,125,80,311,418,218,249,186,338
../../CUB_200_2011/images\025.Pelagic_Cormorant/Pelagic_Cormorant_0024_23712.jpg,500,333,025.Pelagic_Cormorant,39,66,431,239,235,152,392,173
../../CUB_200_2011/images\025.Pelagic_Cormorant/Pelagic_Cormorant_0044_23536.jpg,345,500,025.Pelagic_Cormorant,6,82,311,446,158,264,305,364
../../CUB_200_2011/images\025.Pelagic_Cormorant/Pelagic_Cormorant_0049_23714.jpg,500,357,025.Pelagic_Cormorant,107,59,428,206,267,132,321,147
../../CUB_200_2011/images\025.Pelagic_Cormorant/Pelagic_Cormorant_0047_23718.jpg,500,386,025.Pelagic_Cormorant,161,157,349,280,255,218,188,123
../../CUB_200_2011/images\025.Pelagic_Cormorant/Pelagic_Cormorant_0086_23719.jpg,500,333,025.Pelagic_Cormorant,56,86,258,230,157,158,202,144
../../CUB_200_2011/images\025.Pelagic_Cormorant/Pelagic_Cormorant_0005_23720.jpg,500,333,025.Pelagic_Cormorant,172,41,290,304,231,172,118,263
../../CUB_200_2011/images\025.Pelagic_Cormorant/Pelagic_Cormorant_0093_23722.jpg,500,333,025.Pelagic_Cormorant,138,91,423,291,280,191,285,200
../../CUB_200_2011/images\025.Pelagic_Cormorant/Pelagic_Cormorant_0018_23880.jpg,466,500,025.Pelagic_Cormorant,88,137,214,378,151,257,126,241
../../CUB_200_2011/images\025.Pelagic_Cormorant/Pelagic_Cormorant_0030_23732.jpg,327,500,025.Pelagic_Cormorant,45,180,314,429,179,304,269,249
../../CUB_200_2011/images\025.Pelagic_Cormorant/Pelagic_Cormorant_0057_24002.jpg,350,500,025.Pelagic_Cormorant,86,55,349,464,217,259,263,409
../../CUB_200_2011/images\025.Pelagic_Cormorant/Pelagic_Cormorant_0053_23760.jpg,500,319,025.Pelagic_Cormorant,10,35,317,207,163,121,307,172
../../CUB_200_2011/images\025.Pelagic_Cormorant/Pelagic_Cormorant_0041_23763.jpg,375,500,025.Pelagic_Cormorant,176,90,286,211,231,150,110,121
../../CUB_200_2011/images\025.Pelagic_Cormorant/Pelagic_Cormorant_0016_23509.jpg,500,400,025.Pelagic_Cormorant,185,71,351,329,268,200,166,258
../../CUB_200_2011/images\025.Pelagic_Cormorant/Pelagic_Cormorant_0074_23511.jpg,500,460,025.Pelagic_Cormorant,118,122,400,374,259,248,282,252
../../CUB_200_2011/images\025.Pelagic_Cormorant/Pelagic_Cormorant_0082_23844.jpg,434,500,025.Pelagic_Cormorant,61,51,290,394,175,222,229,343
../../CUB_200_2011/images\025.Pelagic_Cormorant/Pelagic_Cormorant_0019_23546.jpg,500,357,025.Pelagic_Cormorant,109,149,439,321,274,235,330,172
../../CUB_200_2011/images\025.Pelagic_Cormorant/Pelagic_Cormorant_0096_23775.jpg,500,333,025.Pelagic_Cormorant,63,81,194,314,128,197,131,233
../../CUB_200_2011/images\025.Pelagic_Cormorant/Pelagic_Cormorant_0025_23776.jpg,500,333,025.Pelagic_Cormorant,10,57,317,330,163,193,307,273
../../CUB_200_2011/images\025.Pelagic_Cormorant/Pelagic_Cormorant_0102_23778.jpg,359,500,025.Pelagic_Cormorant,86,64,265,423,175,243,179,359
../../CUB_200_2011/images\025.Pelagic_Cormorant/Pelagic_Cormorant_0076_23523.jpg,335,500,025.Pelagic_Cormorant,98,58,300,369,199,213,202,311
../../CUB_200_2011/images\025.Pelagic_Cormorant/Pelagic_Cormorant_0098_23783.jpg,500,333,025.Pelagic_Cormorant,156,34,333,324,244,179,177,290
../../CUB_200_2011/images\025.Pelagic_Cormorant/Pelagic_Cormorant_0099_23784.jpg,500,333,025.Pelagic_Cormorant,47,132,325,254,186,193,278,122
../../CUB_200_2011/images\025.Pelagic_Cormorant/Pelagic_Cormorant_0073_23785.jpg,280,420,025.Pelagic_Cormorant,13,24,273,388,143,206,260,364
../../CUB_200_2011/images\025.Pelagic_Cormorant/Pelagic_Cormorant_0033_23530.jpg,500,393,025.Pelagic_Cormorant,192,51,329,369,260,210,137,318
../../CUB_200_2011/images\025.Pelagic_Cormorant/Pelagic_Cormorant_0026_23792.jpg,500,375,025.Pelagic_Cormorant,166,55,339,373,252,214,173,318
../../CUB_200_2011/images\025.Pelagic_Cormorant/Pelagic_Cormorant_0001_23538.jpg,458,500,025.Pelagic_Cormorant,57,34,332,471,194,252,275,437
../../CUB_200_2011/images\025.Pelagic_Cormorant/Pelagic_Cormorant_0014_23801.jpg,500,375,025.Pelagic_Cormorant,144,87,310,351,227,219,166,264
../../CUB_200_2011/images\025.Pelagic_Cormorant/Pelagic_Cormorant_0022_23802.jpg,500,375,025.Pelagic_Cormorant,63,71,450,334,256,202,387,263
../../CUB_200_2011/images\025.Pelagic_Cormorant/Pelagic_Cormorant_0061_23548.jpg,500,333,025.Pelagic_Cormorant,100,69,426,244,263,156,326,175
../../CUB_200_2011/images\026.Bronzed_Cowbird/Bronzed_Cowbird_0027_24022.jpg,500,338,026.Bronzed_Cowbird,0,38,468,328,234,183,468,290
../../CUB_200_2011/images\026.Bronzed_Cowbird/Bronzed_Cowbird_0057_24074.jpg,500,400,026.Bronzed_Cowbird,79,124,304,386,191,255,225,262
../../CUB_200_2011/images\026.Bronzed_Cowbird/Bronzed_Cowbird_0012_796247.jpg,500,391,026.Bronzed_Cowbird,20,105,390,332,205,218,370,227
../../CUB_200_2011/images\026.Bronzed_Cowbird/Bronzed_Cowbird_0055_24076.jpg,500,339,026.Bronzed_Cowbird,160,42,497,337,328,189,337,295
../../CUB_200_2011/images\026.Bronzed_Cowbird/Bronzed_Cowbird_0085_24152.jpg,500,362,026.Bronzed_Cowbird,90,87,439,285,264,186,349,198
../../CUB_200_2011/images\026.Bronzed_Cowbird/Bronzed_Cowbird_0060_24082.jpg,403,500,026.Bronzed_Cowbird,74,111,371,366,222,238,297,255
../../CUB_200_2011/images\026.Bronzed_Cowbird/Bronzed_Cowbird_0051_24083.jpg,500,500,026.Bronzed_Cowbird,38,49,434,497,236,273,396,448
../../CUB_200_2011/images\026.Bronzed_Cowbird/Bronzed_Cowbird_0030_24103.jpg,417,500,026.Bronzed_Cowbird,52,103,277,422,164,262,225,319
../../CUB_200_2011/images\026.Bronzed_Cowbird/Bronzed_Cowbird_0034_796209.jpg,500,333,026.Bronzed_Cowbird,101,63,266,298,183,180,165,235
../../CUB_200_2011/images\026.Bronzed_Cowbird/Bronzed_Cowbird_0091_796212.jpg,500,433,026.Bronzed_Cowbird,36,71,393,355,214,213,357,284
../../CUB_200_2011/images\026.Bronzed_Cowbird/Bronzed_Cowbird_0025_796213.jpg,375,500,026.Bronzed_Cowbird,126,68,277,473,201,270,151,405
../../CUB_200_2011/images\026.Bronzed_Cowbird/Bronzed_Cowbird_0092_796215.jpg,500,375,026.Bronzed_Cowbird,95,72,375,242,235,157,280,170
../../CUB_200_2011/images\026.Bronzed_Cowbird/Bronzed_Cowbird_0052_796216.jpg,500,398,026.Bronzed_Cowbird,172,113,360,280,266,196,188,167
../../CUB_200_2011/images\026.Bronzed_Cowbird/Bronzed_Cowbird_0046_796218.jpg,272,182,026.Bronzed_Cowbird,25,16,208,167,116,91,183,151
../../CUB_200_2011/images\026.Bronzed_Cowbird/Bronzed_Cowbird_0001_796219.jpg,500,400,026.Bronzed_Cowbird,148,62,471,373,309,217,323,311
../../CUB_200_2011/images\026.Bronzed_Cowbird/Bronzed_Cowbird_0089_796220.jpg,500,339,026.Bronzed_Cowbird,78,89,312,256,195,172,234,167
../../CUB_200_2011/images\026.Bronzed_Cowbird/Bronzed_Cowbird_0022_796221.jpg,500,333,026.Bronzed_Cowbird,29,77,420,333,224,205,391,256
../../CUB_200_2011/images\026.Bronzed_Cowbird/Bronzed_Cowbird_0056_796222.jpg,500,414,026.Bronzed_Cowbird,108,117,331,346,219,231,223,229
../../CUB_200_2011/images\026.Bronzed_Cowbird/Bronzed_Cowbird_0087_796223.jpg,500,398,026.Bronzed_Cowbird,140,70,462,354,301,212,322,284
../../CUB_200_2011/images\026.Bronzed_Cowbird/Bronzed_Cowbird_0043_796224.jpg,500,374,026.Bronzed_Cowbird,50,97,375,321,212,209,325,224
../../CUB_200_2011/images\026.Bronzed_Cowbird/Bronzed_Cowbird_0073_796226.jpg,500,333,026.Bronzed_Cowbird,155,123,367,291,261,207,212,168
../../CUB_200_2011/images\026.Bronzed_Cowbird/Bronzed_Cowbird_0013_24131.jpg,500,333,026.Bronzed_Cowbird,12,73,378,248,195,160,366,175
../../CUB_200_2011/images\026.Bronzed_Cowbird/Bronzed_Cowbird_0026_796229.jpg,379,329,026.Bronzed_Cowbird,41,32,345,265,193,148,304,233
../../CUB_200_2011/images\026.Bronzed_Cowbird/Bronzed_Cowbird_0040_24134.jpg,500,333,026.Bronzed_Cowbird,204,123,332,224,268,173,128,101
../../CUB_200_2011/images\026.Bronzed_Cowbird/Bronzed_Cowbird_0061_796232.jpg,500,416,026.Bronzed_Cowbird,85,77,393,395,239,236,308,318
../../CUB_200_2011/images\026.Bronzed_Cowbird/Bronzed_Cowbird_0032_796233.jpg,500,247,026.Bronzed_Cowbird,70,82,276,182,173,132,206,100
../../CUB_200_2011/images\026.Bronzed_Cowbird/Bronzed_Cowbird_0011_24138.jpg,500,407,026.Bronzed_Cowbird,74,97,412,304,243,200,338,207
../../CUB_200_2011/images\026.Bronzed_Cowbird/Bronzed_Cowbird_0076_796235.jpg,350,234,026.Bronzed_Cowbird,69,73,324,198,196,135,255,125
../../CUB_200_2011/images\026.Bronzed_Cowbird/Bronzed_Cowbird_0020_796237.jpg,500,490,026.Bronzed_Cowbird,175,71,417,477,296,274,242,406
../../CUB_200_2011/images\026.Bronzed_Cowbird/Bronzed_Cowbird_0062_796238.jpg,500,373,026.Bronzed_Cowbird,72,73,321,324,196,198,249,251
../../CUB_200_2011/images\026.Bronzed_Cowbird/Bronzed_Cowbird_0058_796239.jpg,500,364,026.Bronzed_Cowbird,156,45,437,313,296,179,281,268
../../CUB_200_2011/images\026.Bronzed_Cowbird/Bronzed_Cowbird_0010_24146.jpg,500,400,026.Bronzed_Cowbird,202,124,332,286,267,205,130,162
../../CUB_200_2011/images\026.Bronzed_Cowbird/Bronzed_Cowbird_0049_24147.jpg,500,319,026.Bronzed_Cowbird,110,126,393,254,251,190,283,128
../../CUB_200_2011/images\026.Bronzed_Cowbird/Bronzed_Cowbird_0002_796244.jpg,167,250,026.Bronzed_Cowbird,5,25,139,211,72,118,134,186
../../CUB_200_2011/images\026.Bronzed_Cowbird/Bronzed_Cowbird_0003_796246.jpg,395,500,026.Bronzed_Cowbird,132,143,315,416,223,279,183,273
../../CUB_200_2011/images\026.Bronzed_Cowbird/Bronzed_Cowbird_0008_796250.jpg,208,137,026.Bronzed_Cowbird,62,10,162,123,112,66,100,113
../../CUB_200_2011/images\026.Bronzed_Cowbird/Bronzed_Cowbird_0054_24159.jpg,500,375,026.Bronzed_Cowbird,216,62,321,262,268,162,105,200
../../CUB_200_2011/images\026.Bronzed_Cowbird/Bronzed_Cowbird_0029_796256.jpg,272,182,026.Bronzed_Cowbird,49,34,218,155,133,94,169,121
../../CUB_200_2011/images\026.Bronzed_Cowbird/Bronzed_Cowbird_0086_796259.jpg,500,327,026.Bronzed_Cowbird,116,77,336,300,226,188,220,223
../../CUB_200_2011/images\026.Bronzed_Cowbird/Bronzed_Cowbird_0078_796262.jpg,500,426,026.Bronzed_Cowbird,99,113,487,345,293,229,388,232
../../CUB_200_2011/images\026.Bronzed_Cowbird/Bronzed_Cowbird_0024_24167.jpg,500,333,026.Bronzed_Cowbird,93,97,326,262,209,179,233,165
../../CUB_200_2011/images\026.Bronzed_Cowbird/Bronzed_Cowbird_0053_24170.jpg,500,343,026.Bronzed_Cowbird,237,64,481,317,359,190,244,253
../../CUB_200_2011/images\026.Bronzed_Cowbird/Bronzed_Cowbird_0005_24173.jpg,500,375,026.Bronzed_Cowbird,105,72,484,372,294,222,379,300
../../CUB_200_2011/images\026.Bronzed_Cowbird/Bronzed_Cowbird_0082_24175.jpg,500,375,026.Bronzed_Cowbird,87,120,335,251,211,185,248,131
../../CUB_200_2011/images\026.Bronzed_Cowbird/Bronzed_Cowbird_0090_24179.jpg,500,306,026.Bronzed_Cowbird,141,31,378,298,259,164,237,267
../../CUB_200_2011/images\026.Bronzed_Cowbird/Bronzed_Cowbird_0021_24189.jpg,500,333,026.Bronzed_Cowbird,167,122,301,237,234,179,134,115
../../CUB_200_2011/images\026.Bronzed_Cowbird/Bronzed_Cowbird_0081_24198.jpg,500,375,026.Bronzed_Cowbird,114,84,282,286,198,185,168,202
../../CUB_200_2011/images\026.Bronzed_Cowbird/Bronzed_Cowbird_0064_24199.jpg,500,333,026.Bronzed_Cowbird,102,90,252,247,177,168,150,157
../../CUB_200_2011/images\026.Bronzed_Cowbird/Bronzed_Cowbird_0031_24139.jpg,500,357,026.Bronzed_Cowbird,164,165,450,353,307,259,286,188
../../CUB_200_2011/images\026.Bronzed_Cowbird/Bronzed_Cowbird_0018_24140.jpg,500,315,026.Bronzed_Cowbird,213,70,439,265,326,167,226,195
../../CUB_200_2011/images\026.Bronzed_Cowbird/Bronzed_Cowbird_0017_24019.jpg,500,360,026.Bronzed_Cowbird,101,87,295,340,198,213,194,253
../../CUB_200_2011/images\026.Bronzed_Cowbird/Bronzed_Cowbird_0019_796242.jpg,500,333,026.Bronzed_Cowbird,57,81,317,248,187,164,260,167
../../CUB_200_2011/images\026.Bronzed_Cowbird/Bronzed_Cowbird_0039_24026.jpg,339,500,026.Bronzed_Cowbird,33,86,299,418,166,252,266,332
../../CUB_200_2011/images\026.Bronzed_Cowbird/Bronzed_Cowbird_0014_24030.jpg,500,490,026.Bronzed_Cowbird,29,79,468,330,248,204,439,251
../../CUB_200_2011/images\026.Bronzed_Cowbird/Bronzed_Cowbird_0037_24032.jpg,500,333,026.Bronzed_Cowbird,169,52,273,174,221,113,104,122
../../CUB_200_2011/images\026.Bronzed_Cowbird/Bronzed_Cowbird_0009_24033.jpg,409,500,026.Bronzed_Cowbird,79,81,317,405,198,243,238,324
../../CUB_200_2011/images\026.Bronzed_Cowbird/Bronzed_Cowbird_0044_24145.jpg,500,333,026.Bronzed_Cowbird,96,123,396,311,246,217,300,188
../../CUB_200_2011/images\026.Bronzed_Cowbird/Bronzed_Cowbird_0074_24045.jpg,375,500,026.Bronzed_Cowbird,131,73,274,472,202,272,143,399
../../CUB_200_2011/images\026.Bronzed_Cowbird/Bronzed_Cowbird_0023_24058.jpg,341,500,026.Bronzed_Cowbird,101,111,271,367,186,239,170,256
../../CUB_200_2011/images\026.Bronzed_Cowbird/Bronzed_Cowbird_0016_796245.jpg,500,350,026.Bronzed_Cowbird,163,72,350,323,256,197,187,251
../../CUB_200_2011/images\027.Shiny_Cowbird/Shiny_Cowbird_0056_24321.jpg,500,363,027.Shiny_Cowbird,109,160,308,282,208,221,199,122
../../CUB_200_2011/images\027.Shiny_Cowbird/Shiny_Cowbird_0019_24323.jpg,358,500,027.Shiny_Cowbird,48,77,240,491,144,284,192,414
../../CUB_200_2011/images\027.Shiny_Cowbird/Shiny_Cowbird_0055_24331.jpg,500,390,027.Shiny_Cowbird,263,127,379,274,321,200,116,147
../../CUB_200_2011/images\027.Shiny_Cowbird/Shiny_Cowbird_0075_24335.jpg,500,333,027.Shiny_Cowbird,123,67,449,320,286,193,326,253
../../CUB_200_2011/images\027.Shiny_Cowbird/Shiny_Cowbird_0057_24345.jpg,500,338,027.Shiny_Cowbird,101,108,289,268,195,188,188,160
../../CUB_200_2011/images\027.Shiny_Cowbird/Shiny_Cowbird_0026_796847.jpg,500,391,027.Shiny_Cowbird,32,126,465,324,248,225,433,198
../../CUB_200_2011/images\027.Shiny_Cowbird/Shiny_Cowbird_0069_24351.jpg,500,375,027.Shiny_Cowbird,170,131,349,244,259,187,179,113
../../CUB_200_2011/images\027.Shiny_Cowbird/Shiny_Cowbird_0066_24358.jpg,500,333,027.Shiny_Cowbird,174,92,388,281,281,186,214,189
../../CUB_200_2011/images\027.Shiny_Cowbird/Shiny_Cowbird_0039_24359.jpg,500,333,027.Shiny_Cowbird,261,127,435,242,348,184,174,115
../../CUB_200_2011/images\027.Shiny_Cowbird/Shiny_Cowbird_0076_24363.jpg,500,377,027.Shiny_Cowbird,75,126,345,308,210,217,270,182
../../CUB_200_2011/images\027.Shiny_Cowbird/Shiny_Cowbird_0029_24372.jpg,500,411,027.Shiny_Cowbird,46,53,366,328,206,190,320,275
../../CUB_200_2011/images\027.Shiny_Cowbird/Shiny_Cowbird_0040_24379.jpg,500,492,027.Shiny_Cowbird,155,99,345,429,250,264,190,330
../../CUB_200_2011/images\027.Shiny_Cowbird/Shiny_Cowbird_0002_24380.jpg,500,375,027.Shiny_Cowbird,140,42,416,346,278,194,276,304
../../CUB_200_2011/images\027.Shiny_Cowbird/Shiny_Cowbird_0086_24386.jpg,415,296,027.Shiny_Cowbird,119,82,275,221,197,151,156,139
../../CUB_200_2011/images\027.Shiny_Cowbird/Shiny_Cowbird_0067_24392.jpg,334,500,027.Shiny_Cowbird,70,92,304,358,187,225,234,266
../../CUB_200_2011/images\027.Shiny_Cowbird/Shiny_Cowbird_0079_24399.jpg,500,356,027.Shiny_Cowbird,121,18,407,353,264,185,286,335
../../CUB_200_2011/images\027.Shiny_Cowbird/Shiny_Cowbird_0012_24249.jpg,500,334,027.Shiny_Cowbird,174,109,306,303,240,206,132,194
../../CUB_200_2011/images\027.Shiny_Cowbird/Shiny_Cowbird_0068_24413.jpg,500,351,027.Shiny_Cowbird,216,56,433,348,324,202,217,292
../../CUB_200_2011/images\027.Shiny_Cowbird/Shiny_Cowbird_0059_24421.jpg,500,375,027.Shiny_Cowbird,99,91,336,293,217,192,237,202
../../CUB_200_2011/images\027.Shiny_Cowbird/Shiny_Cowbird_0007_24434.jpg,500,325,027.Shiny_Cowbird,254,85,452,247,353,166,198,162
../../CUB_200_2011/images\027.Shiny_Cowbird/Shiny_Cowbird_0051_24438.jpg,500,495,027.Shiny_Cowbird,61,106,395,425,228,265,334,319
../../CUB_200_2011/images\027.Shiny_Cowbird/Shiny_Cowbird_0010_24439.jpg,333,500,027.Shiny_Cowbird,113,176,242,340,177,258,129,164
../../CUB_200_2011/images\027.Shiny_Cowbird/Shiny_Cowbird_0037_24440.jpg,500,375,027.Shiny_Cowbird,2,81,373,308,187,194,371,227
../../CUB_200_2011/images\027.Shiny_Cowbird/Shiny_Cowbird_0025_24444.jpg,500,375,027.Shiny_Cowbird,69,103,465,322,267,212,396,219
../../CUB_200_2011/images\027.Shiny_Cowbird/Shiny_Cowbird_0030_24206.jpg,500,375,027.Shiny_Cowbird,179,128,427,364,303,246,248,236
../../CUB_200_2011/images\027.Shiny_Cowbird/Shiny_Cowbird_0047_24210.jpg,500,362,027.Shiny_Cowbird,128,89,464,297,296,193,336,208
../../CUB_200_2011/images\027.Shiny_Cowbird/Shiny_Cowbird_0014_24214.jpg,500,413,027.Shiny_Cowbird,169,107,383,349,276,228,214,242
../../CUB_200_2011/images\027.Shiny_Cowbird/Shiny_Cowbird_0018_796830.jpg,500,372,027.Shiny_Cowbird,31,88,483,327,257,207,452,239
../../CUB_200_2011/images\027.Shiny_Cowbird/Shiny_Cowbird_0070_796832.jpg,440,418,027.Shiny_Cowbird,38,66,361,382,199,224,323,316
../../CUB_200_2011/images\027.Shiny_Cowbird/Shiny_Cowbird_0081_796833.jpg,500,334,027.Shiny_Cowbird,48,32,364,320,206,176,316,288
../../CUB_200_2011/images\027.Shiny_Cowbird/Shiny_Cowbird_0083_796834.jpg,340,420,027.Shiny_Cowbird,30,36,316,342,173,189,286,306
../../CUB_200_2011/images\027.Shiny_Cowbird/Shiny_Cowbird_0009_796835.jpg,500,375,027.Shiny_Cowbird,11,82,462,344,236,213,451,262
../../CUB_200_2011/images\027.Shiny_Cowbird/Shiny_Cowbird_0035_796837.jpg,350,305,027.Shiny_Cowbird,57,44,290,261,173,152,233,217
../../CUB_200_2011/images\027.Shiny_Cowbird/Shiny_Cowbird_0085_796839.jpg,395,500,027.Shiny_Cowbird,59,32,348,441,203,236,289,409
../../CUB_200_2011/images\027.Shiny_Cowbird/Shiny_Cowbird_0004_796841.jpg,479,500,027.Shiny_Cowbird,94,85,359,400,226,242,265,315
../../CUB_200_2011/images\027.Shiny_Cowbird/Shiny_Cowbird_0078_796846.jpg,212,250,027.Shiny_Cowbird,16,55,155,203,85,129,139,148
../../CUB_200_2011/images\027.Shiny_Cowbird/Shiny_Cowbird_0044_24239.jpg,500,346,027.Shiny_Cowbird,23,66,427,317,225,191,404,251
../../CUB_200_2011/images\027.Shiny_Cowbird/Shiny_Cowbird_0064_796848.jpg,500,333,027.Shiny_Cowbird,60,118,334,305,197,211,274,187
../../CUB_200_2011/images\027.Shiny_Cowbird/Shiny_Cowbird_0034_796849.jpg,420,315,027.Shiny_Cowbird,145,86,389,258,267,172,244,172
../../CUB_200_2011/images\027.Shiny_Cowbird/Shiny_Cowbird_0027_796850.jpg,400,288,027.Shiny_Cowbird,140,84,301,215,220,149,161,131
../../CUB_200_2011/images\027.Shiny_Cowbird/Shiny_Cowbird_0031_796851.jpg,359,288,027.Shiny_Cowbird,49,33,325,249,187,141,276,216
../../CUB_200_2011/images\027.Shiny_Cowbird/Shiny_Cowbird_0017_796853.jpg,350,242,027.Shiny_Cowbird,152,74,304,216,228,145,152,142
../../CUB_200_2011/images\027.Shiny_Cowbird/Shiny_Cowbird_0045_796856.jpg,500,333,027.Shiny_Cowbird,65,56,359,190,212,123,294,134
../../CUB_200_2011/images\027.Shiny_Cowbird/Shiny_Cowbird_0043_796857.jpg,280,191,027.Shiny_Cowbird,24,26,249,175,136,100,225,149
../../CUB_200_2011/images\027.Shiny_Cowbird/Shiny_Cowbird_0015_796858.jpg,392,500,027.Shiny_Cowbird,116,122,308,438,212,280,192,316
../../CUB_200_2011/images\027.Shiny_Cowbird/Shiny_Cowbird_0001_796860.jpg,500,285,027.Shiny_Cowbird,93,64,318,243,205,153,225,179
../../CUB_200_2011/images\027.Shiny_Cowbird/Shiny_Cowbird_0006_796864.jpg,500,349,027.Shiny_Cowbird,96,49,464,336,280,192,368,287
../../CUB_200_2011/images\027.Shiny_Cowbird/Shiny_Cowbird_0063_24259.jpg,500,333,027.Shiny_Cowbird,221,120,339,254,280,187,118,134
../../CUB_200_2011/images\027.Shiny_Cowbird/Shiny_Cowbird_0021_796870.jpg,500,333,027.Shiny_Cowbird,27,88,264,261,145,174,237,173
../../CUB_200_2011/images\027.Shiny_Cowbird/Shiny_Cowbird_0061_796874.jpg,500,333,027.Shiny_Cowbird,50,58,293,319,171,188,243,261
../../CUB_200_2011/images\027.Shiny_Cowbird/Shiny_Cowbird_0080_796875.jpg,450,308,027.Shiny_Cowbird,8,57,351,263,179,160,343,206
../../CUB_200_2011/images\027.Shiny_Cowbird/Shiny_Cowbird_0062_24271.jpg,500,333,027.Shiny_Cowbird,47,63,314,310,180,186,267,247
../../CUB_200_2011/images\027.Shiny_Cowbird/Shiny_Cowbird_0077_24273.jpg,333,500,027.Shiny_Cowbird,139,211,297,413,218,312,158,202
../../CUB_200_2011/images\027.Shiny_Cowbird/Shiny_Cowbird_0036_24274.jpg,500,375,027.Shiny_Cowbird,166,70,371,280,268,175,205,210
../../CUB_200_2011/images\027.Shiny_Cowbird/Shiny_Cowbird_0020_24276.jpg,500,332,027.Shiny_Cowbird,174,102,317,236,245,169,143,134
../../CUB_200_2011/images\027.Shiny_Cowbird/Shiny_Cowbird_0082_24279.jpg,500,333,027.Shiny_Cowbird,120,69,388,258,254,163,268,189
../../CUB_200_2011/images\027.Shiny_Cowbird/Shiny_Cowbird_0024_24281.jpg,500,375,027.Shiny_Cowbird,200,152,376,282,288,217,176,130
../../CUB_200_2011/images\027.Shiny_Cowbird/Shiny_Cowbird_0005_796873.jpg,500,334,027.Shiny_Cowbird,49,45,333,293,191,169,284,248
../../CUB_200_2011/images\027.Shiny_Cowbird/Shiny_Cowbird_0032_24284.jpg,500,354,027.Shiny_Cowbird,106,58,396,233,251,145,290,175
../../CUB_200_2011/images\027.Shiny_Cowbird/Shiny_Cowbird_0074_24297.jpg,500,361,027.Shiny_Cowbird,156,56,381,308,268,182,225,252
../../CUB_200_2011/images\028.Brown_Creeper/Brown_Creeper_0042_24578.jpg,410,500,028.Brown_Creeper,153,134,282,419,217,276,129,285
../../CUB_200_2011/images\028.Brown_Creeper/Brown_Creeper_0093_24581.jpg,500,334,028.Brown_Creeper,156,35,343,334,249,184,187,299
../../CUB_200_2011/images\028.Brown_Creeper/Brown_Creeper_0123_24589.jpg,393,500,028.Brown_Creeper,137,79,261,499,199,289,124,420
../../CUB_200_2011/images\028.Brown_Creeper/Brown_Creeper_0111_24590.jpg,500,451,028.Brown_Creeper,282,54,431,409,356,231,149,355
../../CUB_200_2011/images\028.Brown_Creeper/Brown_Creeper_0061_24601.jpg,313,480,028.Brown_Creeper,95,89,244,431,169,260,149,342
../../CUB_200_2011/images\028.Brown_Creeper/Brown_Creeper_0106_24617.jpg,500,500,028.Brown_Creeper,113,17,243,322,178,169,130,305
../../CUB_200_2011/images\028.Brown_Creeper/Brown_Creeper_0069_24618.jpg,500,319,028.Brown_Creeper,120,82,321,293,220,187,201,211
../../CUB_200_2011/images\028.Brown_Creeper/Brown_Creeper_0103_24632.jpg,500,387,028.Brown_Creeper,243,90,351,301,297,195,108,211
../../CUB_200_2011/images\028.Brown_Creeper/Brown_Creeper_0079_24647.jpg,400,500,028.Brown_Creeper,68,124,208,462,138,293,140,338
../../CUB_200_2011/images\028.Brown_Creeper/Brown_Creeper_0114_24649.jpg,500,357,028.Brown_Creeper,256,135,394,356,325,245,138,221
../../CUB_200_2011/images\028.Brown_Creeper/Brown_Creeper_0127_24656.jpg,341,500,028.Brown_Creeper,82,148,271,404,176,276,189,256
../../CUB_200_2011/images\028.Brown_Creeper/Brown_Creeper_0005_24659.jpg,500,313,028.Brown_Creeper,162,128,364,269,263,198,202,141
../../CUB_200_2011/images\028.Brown_Creeper/Brown_Creeper_0053_24451.jpg,364,500,028.Brown_Creeper,154,85,293,456,223,270,139,371
../../CUB_200_2011/images\028.Brown_Creeper/Brown_Creeper_0104_24698.jpg,359,500,028.Brown_Creeper,81,101,239,452,160,276,158,351
../../CUB_200_2011/images\028.Brown_Creeper/Brown_Creeper_0063_24724.jpg,500,388,028.Brown_Creeper,164,117,331,350,247,233,167,233
../../CUB_200_2011/images\028.Brown_Creeper/Brown_Creeper_0027_24729.jpg,500,333,028.Brown_Creeper,182,30,324,303,253,166,142,273
../../CUB_200_2011/images\028.Brown_Creeper/Brown_Creeper_0088_24731.jpg,333,500,028.Brown_Creeper,41,56,301,397,171,226,260,341
../../CUB_200_2011/images\028.Brown_Creeper/Brown_Creeper_0074_24789.jpg,456,387,028.Brown_Creeper,177,90,317,348,247,219,140,258
../../CUB_200_2011/images\028.Brown_Creeper/Brown_Creeper_0032_24800.jpg,500,378,028.Brown_Creeper,189,73,344,340,266,206,155,267
../../CUB_200_2011/images\028.Brown_Creeper/Brown_Creeper_0107_24827.jpg,333,500,028.Brown_Creeper,102,87,279,262,190,174,177,175
../../CUB_200_2011/images\028.Brown_Creeper/Brown_Creeper_0002_24838.jpg,357,500,028.Brown_Creeper,111,58,263,408,187,233,152,350
../../CUB_200_2011/images\028.Brown_Creeper/Brown_Creeper_0064_24840.jpg,333,500,028.Brown_Creeper,80,59,298,380,189,219,218,321
../../CUB_200_2011/images\028.Brown_Creeper/Brown_Creeper_0089_24841.jpg,355,500,028.Brown_Creeper,93,40,282,450,187,245,189,410
../../CUB_200_2011/images\028.Brown_Creeper/Brown_Creeper_0004_24851.jpg,417,500,028.Brown_Creeper,141,156,280,413,210,284,139,257
../../CUB_200_2011/images\028.Brown_Creeper/Brown_Creeper_0110_24866.jpg,352,500,028.Brown_Creeper,107,135,271,425,189,280,164,290
../../CUB_200_2011/images\028.Brown_Creeper/Brown_Creeper_0007_24902.jpg,441,500,028.Brown_Creeper,108,60,350,438,229,249,242,378
../../CUB_200_2011/images\028.Brown_Creeper/Brown_Creeper_0049_24911.jpg,333,500,028.Brown_Creeper,144,86,283,463,213,274,139,377
../../CUB_200_2011/images\028.Brown_Creeper/Brown_Creeper_0029_24912.jpg,361,500,028.Brown_Creeper,130,135,271,499,200,317,141,364
../../CUB_200_2011/images\028.Brown_Creeper/Brown_Creeper_0065_24464.jpg,343,500,028.Brown_Creeper,66,48,294,484,180,266,228,436
../../CUB_200_2011/images\028.Brown_Creeper/Brown_Creeper_0058_24933.jpg,335,500,028.Brown_Creeper,125,104,241,374,183,239,116,270
../../CUB_200_2011/images\028.Brown_Creeper/Brown_Creeper_0085_24938.jpg,500,415,028.Brown_Creeper,194,60,325,372,259,216,131,312
../../CUB_200_2011/images\028.Brown_Creeper/Brown_Creeper_0023_24940.jpg,486,500,028.Brown_Creeper,185,61,335,454,260,257,150,393
../../CUB_200_2011/images\028.Brown_Creeper/Brown_Creeper_0035_24941.jpg,417,500,028.Brown_Creeper,89,149,278,464,183,306,189,315
../../CUB_200_2011/images\028.Brown_Creeper/Brown_Creeper_0075_24947.jpg,500,500,028.Brown_Creeper,183,52,390,460,286,256,207,408
../../CUB_200_2011/images\028.Brown_Creeper/Brown_Creeper_0120_24955.jpg,490,500,028.Brown_Creeper,145,26,359,494,252,260,214,468
../../CUB_200_2011/images\028.Brown_Creeper/Brown_Creeper_0012_24956.jpg,333,500,028.Brown_Creeper,61,49,293,494,177,271,232,445
../../CUB_200_2011/images\028.Brown_Creeper/Brown_Creeper_0001_24449.jpg,402,500,028.Brown_Creeper,116,65,271,450,193,257,155,385
../../CUB_200_2011/images\028.Brown_Creeper/Brown_Creeper_0124_24963.jpg,500,387,028.Brown_Creeper,42,101,373,286,207,193,331,185
../../CUB_200_2011/images\028.Brown_Creeper/Brown_Creeper_0056_24452.jpg,402,500,028.Brown_Creeper,200,155,319,428,259,291,119,273
../../CUB_200_2011/images\028.Brown_Creeper/Brown_Creeper_0083_24967.jpg,500,335,028.Brown_Creeper,17,40,412,278,214,159,395,238
../../CUB_200_2011/images\028.Brown_Creeper/Brown_Creeper_0046_24463.jpg,500,375,028.Brown_Creeper,142,65,363,321,252,193,221,256
../../CUB_200_2011/images\028.Brown_Creeper/Brown_Creeper_0048_24976.jpg,337,500,028.Brown_Creeper,127,55,239,453,183,254,112,398
../../CUB_200_2011/images\028.Brown_Creeper/Brown_Creeper_0072_24977.jpg,333,500,028.Brown_Creeper,88,26,259,480,173,253,171,454
../../CUB_200_2011/images\028.Brown_Creeper/Brown_Creeper_0051_24468.jpg,360,500,028.Brown_Creeper,147,55,311,488,229,271,164,433
../../CUB_200_2011/images\028.Brown_Creeper/Brown_Creeper_0047_24984.jpg,500,437,028.Brown_Creeper,185,146,442,387,313,266,257,241
../../CUB_200_2011/images\028.Brown_Creeper/Brown_Creeper_0101_24987.jpg,500,400,028.Brown_Creeper,175,72,295,325,235,198,120,253
../../CUB_200_2011/images\028.Brown_Creeper/Brown_Creeper_0125_24995.jpg,322,500,028.Brown_Creeper,131,166,272,408,201,287,141,242
../../CUB_200_2011/images\028.Brown_Creeper/Brown_Creeper_0031_24999.jpg,342,500,028.Brown_Creeper,57,84,222,476,139,280,165,392
../../CUB_200_2011/images\028.Brown_Creeper/Brown_Creeper_0115_24488.jpg,357,500,028.Brown_Creeper,74,97,267,499,170,298,193,402
../../CUB_200_2011/images\028.Brown_Creeper/Brown_Creeper_0059_25010.jpg,500,327,028.Brown_Creeper,142,40,282,244,212,142,140,204
../../CUB_200_2011/images\028.Brown_Creeper/Brown_Creeper_0118_24500.jpg,346,500,028.Brown_Creeper,60,28,250,458,155,243,190,430
../../CUB_200_2011/images\028.Brown_Creeper/Brown_Creeper_0100_24502.jpg,500,333,028.Brown_Creeper,164,93,357,214,260,153,193,121
../../CUB_200_2011/images\028.Brown_Creeper/Brown_Creeper_0006_25034.jpg,324,500,028.Brown_Creeper,96,132,205,393,150,262,109,261
../../CUB_200_2011/images\028.Brown_Creeper/Brown_Creeper_0057_24529.jpg,500,334,028.Brown_Creeper,110,14,232,317,171,165,122,303
../../CUB_200_2011/images\028.Brown_Creeper/Brown_Creeper_0073_24546.jpg,337,500,028.Brown_Creeper,151,84,276,454,213,269,125,370
../../CUB_200_2011/images\028.Brown_Creeper/Brown_Creeper_0043_24549.jpg,500,485,028.Brown_Creeper,153,84,363,485,258,284,210,401
../../CUB_200_2011/images\028.Brown_Creeper/Brown_Creeper_0113_24560.jpg,315,500,028.Brown_Creeper,55,86,243,483,149,284,188,397
../../CUB_200_2011/images\028.Brown_Creeper/Brown_Creeper_0102_25000.jpg,407,500,028.Brown_Creeper,83,60,254,500,168,280,171,440
../../CUB_200_2011/images\028.Brown_Creeper/Brown_Creeper_0121_24574.jpg,389,500,028.Brown_Creeper,161,71,342,443,251,257,181,372
../../CUB_200_2011/images\029.American_Crow/American_Crow_0117_25090.jpg,500,333,029.American_Crow,88,55,363,273,225,164,275,218
../../CUB_200_2011/images\029.American_Crow/American_Crow_0030_25092.jpg,500,334,029.American_Crow,173,124,335,256,254,190,162,132
../../CUB_200_2011/images\029.American_Crow/American_Crow_0119_25610.jpg,500,493,029.American_Crow,33,71,448,484,240,277,415,413
../../CUB_200_2011/images\029.American_Crow/American_Crow_0020_25618.jpg,500,375,029.American_Crow,132,130,474,328,303,229,342,198
../../CUB_200_2011/images\029.American_Crow/American_Crow_0016_25112.jpg,500,354,029.American_Crow,73,40,419,323,246,181,346,283
../../CUB_200_2011/images\029.American_Crow/American_Crow_0136_25117.jpg,500,336,029.American_Crow,180,78,497,246,338,162,317,168
../../CUB_200_2011/images\029.American_Crow/American_Crow_0101_25118.jpg,500,399,029.American_Crow,116,75,435,344,275,209,319,269
../../CUB_200_2011/images\029.American_Crow/American_Crow_0002_25122.jpg,500,449,029.American_Crow,82,26,389,441,235,233,307,415
../../CUB_200_2011/images\029.American_Crow/American_Crow_0109_25123.jpg,500,399,029.American_Crow,2,50,375,363,188,206,373,313
../../CUB_200_2011/images\029.American_Crow/American_Crow_0111_25127.jpg,500,477,029.American_Crow,45,112,417,414,231,263,372,302
../../CUB_200_2011/images\029.American_Crow/American_Crow_0003_25130.jpg,357,500,029.American_Crow,29,136,358,304,193,220,329,168
../../CUB_200_2011/images\029.American_Crow/American_Crow_0021_25137.jpg,334,500,029.American_Crow,44,110,333,445,188,277,289,335
../../CUB_200_2011/images\029.American_Crow/American_Crow_0027_25146.jpg,500,333,029.American_Crow,35,29,395,292,215,160,360,263
../../CUB_200_2011/images\029.American_Crow/American_Crow_0113_25149.jpg,500,375,029.American_Crow,6,18,324,339,165,178,318,321
../../CUB_200_2011/images\029.American_Crow/American_Crow_0011_25151.jpg,500,333,029.American_Crow,37,58,309,291,173,174,272,233
../../CUB_200_2011/images\029.American_Crow/American_Crow_0043_25666.jpg,500,333,029.American_Crow,38,61,488,279,263,170,450,218
../../CUB_200_2011/images\029.American_Crow/American_Crow_0130_25163.jpg,416,500,029.American_Crow,0,99,373,458,186,278,373,359
../../CUB_200_2011/images\029.American_Crow/American_Crow_0093_25694.jpg,500,333,029.American_Crow,12,53,411,321,211,187,399,268
../../CUB_200_2011/images\029.American_Crow/American_Crow_0139_25186.jpg,500,375,029.American_Crow,222,117,378,275,300,196,156,158
../../CUB_200_2011/images\029.American_Crow/American_Crow_0132_25704.jpg,500,375,029.American_Crow,156,70,485,253,320,161,329,183
../../CUB_200_2011/images\029.American_Crow/American_Crow_0131_25706.jpg,363,500,029.American_Crow,2,9,357,494,179,251,355,485
../../CUB_200_2011/images\029.American_Crow/American_Crow_0068_25198.jpg,500,360,029.American_Crow,165,39,322,275,243,157,157,236
../../CUB_200_2011/images\029.American_Crow/American_Crow_0116_25199.jpg,500,333,029.American_Crow,60,118,327,248,193,183,267,130
../../CUB_200_2011/images\029.American_Crow/American_Crow_0122_25200.jpg,500,389,029.American_Crow,19,38,446,371,232,204,427,333
../../CUB_200_2011/images\029.American_Crow/American_Crow_0053_25203.jpg,500,500,029.American_Crow,82,65,433,498,257,281,351,433
../../CUB_200_2011/images\029.American_Crow/American_Crow_0099_25717.jpg,500,334,029.American_Crow,67,71,486,304,276,187,419,233
../../CUB_200_2011/images\029.American_Crow/American_Crow_0134_25206.jpg,500,417,029.American_Crow,75,32,493,386,284,209,418,354
../../CUB_200_2011/images\029.American_Crow/American_Crow_0121_25720.jpg,500,375,029.American_Crow,58,80,480,327,269,203,422,247
../../CUB_200_2011/images\029.American_Crow/American_Crow_0080_25220.jpg,375,500,029.American_Crow,71,106,308,399,189,252,237,293
../../CUB_200_2011/images\029.American_Crow/American_Crow_0137_25221.jpg,500,332,029.American_Crow,78,50,344,236,211,143,266,186
../../CUB_200_2011/images\029.American_Crow/American_Crow_0050_25255.jpg,500,360,029.American_Crow,55,57,394,323,224,190,339,266
../../CUB_200_2011/images\029.American_Crow/American_Crow_0085_25260.jpg,500,333,029.American_Crow,229,106,333,212,281,159,104,106
../../CUB_200_2011/images\029.American_Crow/American_Crow_0105_25283.jpg,500,466,029.American_Crow,186,90,430,404,308,247,244,314
../../CUB_200_2011/images\029.American_Crow/American_Crow_0014_25287.jpg,500,333,029.American_Crow,133,22,427,277,280,149,294,255
../../CUB_200_2011/images\029.American_Crow/American_Crow_0088_25303.jpg,500,375,029.American_Crow,118,101,339,268,228,184,221,167
../../CUB_200_2011/images\029.American_Crow/American_Crow_0012_25305.jpg,500,400,029.American_Crow,133,71,377,289,255,180,244,218
../../CUB_200_2011/images\029.American_Crow/American_Crow_0004_25819.jpg,500,400,029.American_Crow,14,51,476,385,245,218,462,334
../../CUB_200_2011/images\029.American_Crow/American_Crow_0036_25313.jpg,500,392,029.American_Crow,73,87,385,333,229,210,312,246
../../CUB_200_2011/images\029.American_Crow/American_Crow_0081_25837.jpg,500,333,029.American_Crow,51,39,431,303,241,171,380,264
../../CUB_200_2011/images\029.American_Crow/American_Crow_0074_25350.jpg,500,339,029.American_Crow,28,29,469,296,248,162,441,267
../../CUB_200_2011/images\029.American_Crow/American_Crow_0107_25353.jpg,500,332,029.American_Crow,76,101,401,263,238,182,325,162
../../CUB_200_2011/images\029.American_Crow/American_Crow_0124_25356.jpg,500,354,029.American_Crow,109,35,486,311,297,173,377,276
../../CUB_200_2011/images\029.American_Crow/American_Crow_0047_25397.jpg,500,367,029.American_Crow,15,60,452,318,233,189,437,258
../../CUB_200_2011/images\029.American_Crow/American_Crow_0127_25412.jpg,500,333,029.American_Crow,182,56,390,322,286,189,208,266
../../CUB_200_2011/images\029.American_Crow/American_Crow_0066_25827.jpg,500,333,029.American_Crow,70,78,348,317,209,197,278,239
../../CUB_200_2011/images\029.American_Crow/American_Crow_0031_25433.jpg,500,333,029.American_Crow,121,24,485,294,303,159,364,270
../../CUB_200_2011/images\029.American_Crow/American_Crow_0067_25443.jpg,500,374,029.American_Crow,11,45,304,365,157,205,293,320
../../CUB_200_2011/images\029.American_Crow/American_Crow_0079_25463.jpg,500,339,029.American_Crow,26,22,464,319,245,170,438,297
../../CUB_200_2011/images\029.American_Crow/American_Crow_0051_25505.jpg,500,333,029.American_Crow,213,58,404,202,308,130,191,144
../../CUB_200_2011/images\029.American_Crow/American_Crow_0069_25506.jpg,500,376,029.American_Crow,195,111,321,282,258,196,126,171
../../CUB_200_2011/images\029.American_Crow/American_Crow_0025_25522.jpg,500,356,029.American_Crow,62,98,313,290,187,194,251,192
../../CUB_200_2011/images\029.American_Crow/American_Crow_0110_25541.jpg,500,375,029.American_Crow,61,49,423,344,242,196,362,295
../../CUB_200_2011/images\029.American_Crow/American_Crow_0001_25053.jpg,500,354,029.American_Crow,88,32,448,318,268,175,360,286
../../CUB_200_2011/images\029.American_Crow/American_Crow_0039_25061.jpg,500,299,029.American_Crow,65,76,498,279,281,177,433,203
../../CUB_200_2011/images\029.American_Crow/American_Crow_0048_25062.jpg,500,333,029.American_Crow,165,58,455,276,310,167,290,218
../../CUB_200_2011/images\029.American_Crow/American_Crow_0094_25576.jpg,500,333,029.American_Crow,213,56,359,261,286,158,146,205
../../CUB_200_2011/images\029.American_Crow/American_Crow_0102_25066.jpg,500,401,029.American_Crow,101,52,448,328,274,190,347,276
../../CUB_200_2011/images\029.American_Crow/American_Crow_0062_25587.jpg,500,399,029.American_Crow,75,53,408,329,241,191,333,276
../../CUB_200_2011/images\029.American_Crow/American_Crow_0104_25086.jpg,500,375,029.American_Crow,32,23,497,374,264,198,465,351
../../CUB_200_2011/images\029.American_Crow/American_Crow_0059_25599.jpg,500,375,029.American_Crow,93,88,359,277,226,182,266,189
../../CUB_200_2011/images\030.Fish_Crow/Fish_Crow_0068_25859.jpg,449,500,030.Fish_Crow,108,11,413,450,260,230,305,439
../../CUB_200_2011/images\030.Fish_Crow/Fish_Crow_0080_25861.jpg,500,331,030.Fish_Crow,156,99,365,244,260,171,209,145
../../CUB_200_2011/images\030.Fish_Crow/Fish_Crow_0059_25864.jpg,500,332,030.Fish_Crow,179,75,304,274,241,174,125,199
../../CUB_200_2011/images\030.Fish_Crow/Fish_Crow_0011_25866.jpg,500,333,030.Fish_Crow,59,69,354,281,206,175,295,212
../../CUB_200_2011/images\030.Fish_Crow/Fish_Crow_0067_26124.jpg,500,428,030.Fish_Crow,50,113,379,332,214,222,329,219
../../CUB_200_2011/images\030.Fish_Crow/Fish_Crow_0017_26127.jpg,368,500,030.Fish_Crow,83,131,306,350,194,240,223,219
../../CUB_200_2011/images\030.Fish_Crow/Fish_Crow_0018_25879.jpg,500,331,030.Fish_Crow,122,92,294,293,208,192,172,201
../../CUB_200_2011/images\030.Fish_Crow/Fish_Crow_0041_25887.jpg,500,376,030.Fish_Crow,99,120,265,264,182,192,166,144
../../CUB_200_2011/images\030.Fish_Crow/Fish_Crow_0078_26144.jpg,500,333,030.Fish_Crow,165,58,391,263,278,160,226,205
../../CUB_200_2011/images\030.Fish_Crow/Fish_Crow_0034_25891.jpg,357,500,030.Fish_Crow,31,20,291,490,161,255,260,470
../../CUB_200_2011/images\030.Fish_Crow/Fish_Crow_0042_26148.jpg,500,375,030.Fish_Crow,61,77,330,275,195,176,269,198
../../CUB_200_2011/images\030.Fish_Crow/Fish_Crow_0025_25893.jpg,500,411,030.Fish_Crow,122,53,382,401,252,227,260,348
../../CUB_200_2011/images\030.Fish_Crow/Fish_Crow_0081_25908.jpg,375,500,030.Fish_Crow,69,19,247,483,158,251,178,464
../../CUB_200_2011/images\030.Fish_Crow/Fish_Crow_0031_25909.jpg,500,333,030.Fish_Crow,186,89,326,277,256,183,140,188
../../CUB_200_2011/images\030.Fish_Crow/Fish_Crow_0036_25911.jpg,500,330,030.Fish_Crow,105,86,407,288,256,187,302,202
../../CUB_200_2011/images\030.Fish_Crow/Fish_Crow_0005_25912.jpg,500,330,030.Fish_Crow,2,123,488,292,245,207,486,169
../../CUB_200_2011/images\030.Fish_Crow/Fish_Crow_0033_25915.jpg,411,500,030.Fish_Crow,23,37,408,498,215,267,385,461
../../CUB_200_2011/images\030.Fish_Crow/Fish_Crow_0085_25919.jpg,456,311,030.Fish_Crow,117,63,383,238,250,150,266,175
../../CUB_200_2011/images\030.Fish_Crow/Fish_Crow_0071_25155.jpg,433,500,030.Fish_Crow,53,51,395,459,224,255,342,408
../../CUB_200_2011/images\030.Fish_Crow/Fish_Crow_0040_25158.jpg,366,500,030.Fish_Crow,27,79,332,452,179,265,305,373
../../CUB_200_2011/images\030.Fish_Crow/Fish_Crow_0051_25934.jpg,500,474,030.Fish_Crow,118,68,381,423,249,245,263,355
../../CUB_200_2011/images\030.Fish_Crow/Fish_Crow_0004_25936.jpg,500,391,030.Fish_Crow,90,22,481,365,285,193,391,343
../../CUB_200_2011/images\030.Fish_Crow/Fish_Crow_0013_25939.jpg,500,331,030.Fish_Crow,186,121,350,252,268,186,164,131
../../CUB_200_2011/images\030.Fish_Crow/Fish_Crow_0065_25942.jpg,500,376,030.Fish_Crow,120,84,287,237,203,160,167,153
../../CUB_200_2011/images\030.Fish_Crow/Fish_Crow_0072_25945.jpg,500,379,030.Fish_Crow,166,73,341,331,253,202,175,258
../../CUB_200_2011/images\030.Fish_Crow/Fish_Crow_0012_25946.jpg,500,333,030.Fish_Crow,92,9,496,333,294,171,404,324
../../CUB_200_2011/images\030.Fish_Crow/Fish_Crow_0083_25949.jpg,500,333,030.Fish_Crow,79,11,391,333,235,172,312,322
../../CUB_200_2011/images\030.Fish_Crow/Fish_Crow_0044_25964.jpg,333,500,030.Fish_Crow,82,113,292,466,187,289,210,353
../../CUB_200_2011/images\030.Fish_Crow/Fish_Crow_0028_25968.jpg,500,375,030.Fish_Crow,183,112,343,257,263,184,160,145
../../CUB_200_2011/images\030.Fish_Crow/Fish_Crow_0003_25970.jpg,500,389,030.Fish_Crow,76,35,424,313,250,174,348,278
../../CUB_200_2011/images\030.Fish_Crow/Fish_Crow_0076_25971.jpg,500,255,030.Fish_Crow,24,18,480,249,252,133,456,231
../../CUB_200_2011/images\030.Fish_Crow/Fish_Crow_0073_25977.jpg,500,400,030.Fish_Crow,154,166,492,364,323,265,338,198
../../CUB_200_2011/images\030.Fish_Crow/Fish_Crow_0010_25836.jpg,500,332,030.Fish_Crow,41,39,425,229,233,134,384,190
../../CUB_200_2011/images\030.Fish_Crow/Fish_Crow_0058_25999.jpg,500,402,030.Fish_Crow,155,124,446,349,300,236,291,225
../../CUB_200_2011/images\030.Fish_Crow/Fish_Crow_0038_26000.jpg,500,400,030.Fish_Crow,27,81,499,399,263,240,472,318
../../CUB_200_2011/images\030.Fish_Crow/Fish_Crow_0069_26008.jpg,500,374,030.Fish_Crow,148,45,329,289,238,167,181,244
../../CUB_200_2011/images\030.Fish_Crow/Fish_Crow_0082_26012.jpg,500,375,030.Fish_Crow,34,85,410,269,222,177,376,184
../../CUB_200_2011/images\030.Fish_Crow/Fish_Crow_0032_26014.jpg,500,333,030.Fish_Crow,73,97,363,275,218,186,290,178
../../CUB_200_2011/images\030.Fish_Crow/Fish_Crow_0070_25504.jpg,500,388,030.Fish_Crow,54,113,399,365,226,239,345,252
../../CUB_200_2011/images\030.Fish_Crow/Fish_Crow_0007_26023.jpg,500,396,030.Fish_Crow,27,80,303,396,165,238,276,316
../../CUB_200_2011/images\030.Fish_Crow/Fish_Crow_0061_25884.jpg,333,500,030.Fish_Crow,32,113,233,430,132,271,201,317
../../CUB_200_2011/images\030.Fish_Crow/Fish_Crow_0020_26027.jpg,500,332,030.Fish_Crow,192,99,324,331,258,215,132,232
../../CUB_200_2011/images\030.Fish_Crow/Fish_Crow_0079_26030.jpg,500,368,030.Fish_Crow,94,77,402,249,248,163,308,172
../../CUB_200_2011/images\030.Fish_Crow/Fish_Crow_0001_26031.jpg,500,360,030.Fish_Crow,173,81,473,281,323,181,300,200
../../CUB_200_2011/images\030.Fish_Crow/Fish_Crow_0023_26037.jpg,500,376,030.Fish_Crow,146,71,364,290,255,180,218,219
../../CUB_200_2011/images\030.Fish_Crow/Fish_Crow_0049_26040.jpg,500,375,030.Fish_Crow,119,84,387,345,253,214,268,261
../../CUB_200_2011/images\030.Fish_Crow/Fish_Crow_0014_26041.jpg,500,374,030.Fish_Crow,176,57,424,309,300,183,248,252
../../CUB_200_2011/images\030.Fish_Crow/Fish_Crow_0060_26016.jpg,500,375,030.Fish_Crow,72,91,346,256,209,173,274,165
../../CUB_200_2011/images\030.Fish_Crow/Fish_Crow_0022_26062.jpg,500,396,030.Fish_Crow,152,80,442,354,297,217,290,274
../../CUB_200_2011/images\030.Fish_Crow/Fish_Crow_0024_26064.jpg,500,415,030.Fish_Crow,131,163,280,281,205,222,149,118
../../CUB_200_2011/images\030.Fish_Crow/Fish_Crow_0053_26067.jpg,500,375,030.Fish_Crow,135,36,401,374,268,205,266,338
../../CUB_200_2011/images\030.Fish_Crow/Fish_Crow_0047_26070.jpg,500,375,030.Fish_Crow,128,107,354,248,241,177,226,141
../../CUB_200_2011/images\030.Fish_Crow/Fish_Crow_0037_26071.jpg,500,300,030.Fish_Crow,197,109,313,273,255,191,116,164
../../CUB_200_2011/images\030.Fish_Crow/Fish_Crow_0002_26072.jpg,333,500,030.Fish_Crow,0,14,331,497,165,255,331,483
../../CUB_200_2011/images\030.Fish_Crow/Fish_Crow_0055_26077.jpg,500,333,030.Fish_Crow,98,46,347,291,222,168,249,245
../../CUB_200_2011/images\030.Fish_Crow/Fish_Crow_0035_26081.jpg,500,466,030.Fish_Crow,153,103,280,364,216,233,127,261
../../CUB_200_2011/images\030.Fish_Crow/Fish_Crow_0063_26094.jpg,326,500,030.Fish_Crow,26,246,281,394,153,320,255,148
../../CUB_200_2011/images\030.Fish_Crow/Fish_Crow_0043_25847.jpg,500,333,030.Fish_Crow,95,113,496,264,295,188,401,151
../../CUB_200_2011/images\030.Fish_Crow/Fish_Crow_0056_25851.jpg,500,335,030.Fish_Crow,70,95,302,249,186,172,232,154
../../CUB_200_2011/images\030.Fish_Crow/Fish_Crow_0016_25854.jpg,500,333,030.Fish_Crow,123,61,485,305,304,183,362,244
../../CUB_200_2011/images\031.Black_billed_Cuckoo/Black_Billed_Cuckoo_0071_26288.jpg,500,375,031.Black_billed_Cuckoo,195,80,344,324,269,202,149,244
../../CUB_200_2011/images\031.Black_billed_Cuckoo/Black_Billed_Cuckoo_0005_26161.jpg,500,400,031.Black_billed_Cuckoo,172,151,425,345,298,248,253,194
../../CUB_200_2011/images\031.Black_billed_Cuckoo/Black_Billed_Cuckoo_0028_26165.jpg,500,451,031.Black_billed_Cuckoo,184,36,491,339,337,187,307,303
../../CUB_200_2011/images\031.Black_billed_Cuckoo/Black_Billed_Cuckoo_0032_26292.jpg,500,342,031.Black_billed_Cuckoo,52,55,483,253,267,154,431,198
../../CUB_200_2011/images\031.Black_billed_Cuckoo/Black_Billed_Cuckoo_0084_26175.jpg,500,333,031.Black_billed_Cuckoo,14,49,332,195,173,122,318,146
../../CUB_200_2011/images\031.Black_billed_Cuckoo/Black_Billed_Cuckoo_0047_26176.jpg,500,336,031.Black_billed_Cuckoo,18,61,418,320,218,190,400,259
../../CUB_200_2011/images\031.Black_billed_Cuckoo/Black_Billed_Cuckoo_0076_26177.jpg,500,400,031.Black_billed_Cuckoo,11,79,445,372,228,225,434,293
../../CUB_200_2011/images\031.Black_billed_Cuckoo/Black_Billed_Cuckoo_0079_26180.jpg,306,500,031.Black_billed_Cuckoo,15,14,228,488,121,251,213,474
../../CUB_200_2011/images\031.Black_billed_Cuckoo/Black_Billed_Cuckoo_0051_795318.jpg,500,400,031.Black_billed_Cuckoo,37,72,397,360,217,216,360,288
../../CUB_200_2011/images\031.Black_billed_Cuckoo/Black_Billed_Cuckoo_0086_26188.jpg,500,333,031.Black_billed_Cuckoo,148,81,274,261,211,171,126,180
../../CUB_200_2011/images\031.Black_billed_Cuckoo/Black_Billed_Cuckoo_0045_26194.jpg,500,447,031.Black_billed_Cuckoo,139,90,364,358,251,224,225,268
../../CUB_200_2011/images\031.Black_billed_Cuckoo/Black_Billed_Cuckoo_0065_26203.jpg,500,335,031.Black_billed_Cuckoo,95,84,317,282,206,183,222,198
../../CUB_200_2011/images\031.Black_billed_Cuckoo/Black_Billed_Cuckoo_0096_26204.jpg,333,500,031.Black_billed_Cuckoo,34,183,204,457,119,320,170,274
../../CUB_200_2011/images\031.Black_billed_Cuckoo/Black_Billed_Cuckoo_0015_26208.jpg,365,500,031.Black_billed_Cuckoo,106,90,298,453,202,271,192,363
../../CUB_200_2011/images\031.Black_billed_Cuckoo/Black_Billed_Cuckoo_0081_26209.jpg,500,342,031.Black_billed_Cuckoo,181,107,291,236,236,171,110,129
../../CUB_200_2011/images\031.Black_billed_Cuckoo/Black_Billed_Cuckoo_0088_26217.jpg,333,500,031.Black_billed_Cuckoo,107,85,316,491,211,288,209,406
../../CUB_200_2011/images\031.Black_billed_Cuckoo/Black_Billed_Cuckoo_0018_26218.jpg,500,400,031.Black_billed_Cuckoo,6,94,390,300,198,197,384,206
../../CUB_200_2011/images\031.Black_billed_Cuckoo/Black_Billed_Cuckoo_0017_26221.jpg,400,500,031.Black_billed_Cuckoo,32,132,332,444,182,288,300,312
../../CUB_200_2011/images\031.Black_billed_Cuckoo/Black_Billed_Cuckoo_0077_26222.jpg,395,500,031.Black_billed_Cuckoo,14,101,268,477,141,289,254,376
../../CUB_200_2011/images\031.Black_billed_Cuckoo/Black_Billed_Cuckoo_0055_26223.jpg,400,500,031.Black_billed_Cuckoo,28,94,341,444,184,269,313,350
../../CUB_200_2011/images\031.Black_billed_Cuckoo/Black_Billed_Cuckoo_0052_26232.jpg,500,333,031.Black_billed_Cuckoo,202,93,353,290,277,191,151,197
../../CUB_200_2011/images\031.Black_billed_Cuckoo/Black_Billed_Cuckoo_0006_26233.jpg,500,363,031.Black_billed_Cuckoo,197,104,461,337,329,220,264,233
../../CUB_200_2011/images\031.Black_billed_Cuckoo/Black_Billed_Cuckoo_0066_26303.jpg,500,375,031.Black_billed_Cuckoo,107,29,318,374,212,201,211,345
../../CUB_200_2011/images\031.Black_billed_Cuckoo/Black_Billed_Cuckoo_0030_26240.jpg,334,500,031.Black_billed_Cuckoo,114,76,258,499,186,287,144,423
../../CUB_200_2011/images\031.Black_billed_Cuckoo/Black_Billed_Cuckoo_0082_26241.jpg,500,375,031.Black_billed_Cuckoo,172,61,332,250,252,155,160,189
../../CUB_200_2011/images\031.Black_billed_Cuckoo/Black_Billed_Cuckoo_0001_26242.jpg,325,374,031.Black_billed_Cuckoo,119,44,240,375,179,209,121,331
../../CUB_200_2011/images\031.Black_billed_Cuckoo/Black_Billed_Cuckoo_0044_26243.jpg,334,500,031.Black_billed_Cuckoo,72,70,183,400,127,235,111,330
../../CUB_200_2011/images\031.Black_billed_Cuckoo/Black_Billed_Cuckoo_0091_26246.jpg,343,500,031.Black_billed_Cuckoo,31,148,293,374,162,261,262,226
../../CUB_200_2011/images\031.Black_billed_Cuckoo/Black_Billed_Cuckoo_0023_26258.jpg,500,375,031.Black_billed_Cuckoo,73,96,315,375,194,235,242,279
../../CUB_200_2011/images\031.Black_billed_Cuckoo/Black_Billed_Cuckoo_0074_795286.jpg,400,500,031.Black_billed_Cuckoo,81,139,284,480,182,309,203,341
../../CUB_200_2011/images\031.Black_billed_Cuckoo/Black_Billed_Cuckoo_0058_795292.jpg,500,333,031.Black_billed_Cuckoo,109,76,363,263,236,169,254,187
../../CUB_200_2011/images\031.Black_billed_Cuckoo/Black_Billed_Cuckoo_0085_795294.jpg,500,375,031.Black_billed_Cuckoo,190,54,398,353,294,203,208,299
../../CUB_200_2011/images\031.Black_billed_Cuckoo/Black_Billed_Cuckoo_0075_795298.jpg,500,400,031.Black_billed_Cuckoo,14,65,395,368,204,216,381,303
../../CUB_200_2011/images\031.Black_billed_Cuckoo/Black_Billed_Cuckoo_0087_795300.jpg,400,313,031.Black_billed_Cuckoo,16,22,380,288,198,155,364,266
../../CUB_200_2011/images\031.Black_billed_Cuckoo/Black_Billed_Cuckoo_0073_795304.jpg,272,182,031.Black_billed_Cuckoo,42,18,221,170,131,94,179,152
../../CUB_200_2011/images\031.Black_billed_Cuckoo/Black_Billed_Cuckoo_0008_795305.jpg,500,333,031.Black_billed_Cuckoo,172,43,349,307,260,175,177,264
../../CUB_200_2011/images\031.Black_billed_Cuckoo/Black_Billed_Cuckoo_0095_795307.jpg,299,450,031.Black_billed_Cuckoo,64,64,195,413,129,238,131,349
../../CUB_200_2011/images\031.Black_billed_Cuckoo/Black_Billed_Cuckoo_0042_795308.jpg,500,381,031.Black_billed_Cuckoo,164,45,342,374,253,209,178,329
../../CUB_200_2011/images\031.Black_billed_Cuckoo/Black_Billed_Cuckoo_0062_795309.jpg,300,325,031.Black_billed_Cuckoo,1,33,283,305,142,169,282,272
../../CUB_200_2011/images\031.Black_billed_Cuckoo/Black_Billed_Cuckoo_0070_795310.jpg,356,500,031.Black_billed_Cuckoo,10,121,280,436,145,278,270,315
../../CUB_200_2011/images\031.Black_billed_Cuckoo/Black_Billed_Cuckoo_0092_795313.jpg,400,500,031.Black_billed_Cuckoo,35,28,369,483,202,255,334,455
../../CUB_200_2011/images\031.Black_billed_Cuckoo/Black_Billed_Cuckoo_0083_795315.jpg,500,333,031.Black_billed_Cuckoo,80,55,367,319,223,187,287,264
../../CUB_200_2011/images\031.Black_billed_Cuckoo/Black_Billed_Cuckoo_0093_795316.jpg,334,276,031.Black_billed_Cuckoo,73,22,291,255,182,138,218,233
../../CUB_200_2011/images\031.Black_billed_Cuckoo/Black_Billed_Cuckoo_0022_795319.jpg,307,400,031.Black_billed_Cuckoo,80,60,220,389,150,224,140,329
../../CUB_200_2011/images\031.Black_billed_Cuckoo/Black_Billed_Cuckoo_0034_795320.jpg,334,500,031.Black_billed_Cuckoo,93,148,254,480,173,314,161,332
../../CUB_200_2011/images\031.Black_billed_Cuckoo/Black_Billed_Cuckoo_0053_795321.jpg,500,333,031.Black_billed_Cuckoo,209,53,366,293,287,173,157,240
../../CUB_200_2011/images\031.Black_billed_Cuckoo/Black_Billed_Cuckoo_0089_795322.jpg,389,500,031.Black_billed_Cuckoo,58,159,220,458,139,308,162,299
../../CUB_200_2011/images\031.Black_billed_Cuckoo/Black_Billed_Cuckoo_0057_795323.jpg,384,480,031.Black_billed_Cuckoo,56,58,341,429,198,243,285,371
../../CUB_200_2011/images\031.Black_billed_Cuckoo/Black_Billed_Cuckoo_0043_795324.jpg,389,500,031.Black_billed_Cuckoo,62,165,236,456,149,310,174,291
../../CUB_200_2011/images\031.Black_billed_Cuckoo/Black_Billed_Cuckoo_0069_795326.jpg,333,500,031.Black_billed_Cuckoo,66,167,314,449,190,308,248,282
../../CUB_200_2011/images\031.Black_billed_Cuckoo/Black_Billed_Cuckoo_0061_795327.jpg,350,233,031.Black_billed_Cuckoo,0,6,294,233,147,119,294,227
../../CUB_200_2011/images\031.Black_billed_Cuckoo/Black_Billed_Cuckoo_0046_795328.jpg,500,375,031.Black_billed_Cuckoo,25,69,430,374,227,221,405,305
../../CUB_200_2011/images\031.Black_billed_Cuckoo/Black_Billed_Cuckoo_0019_795329.jpg,500,333,031.Black_billed_Cuckoo,125,71,331,290,228,180,206,219
../../CUB_200_2011/images\031.Black_billed_Cuckoo/Black_Billed_Cuckoo_0037_795330.jpg,353,500,031.Black_billed_Cuckoo,136,93,297,491,216,292,161,398
../../CUB_200_2011/images\031.Black_billed_Cuckoo/Black_Billed_Cuckoo_0024_795331.jpg,500,373,031.Black_billed_Cuckoo,161,75,344,239,252,157,183,164
../../CUB_200_2011/images\031.Black_billed_Cuckoo/Black_Billed_Cuckoo_0090_26311.jpg,375,500,031.Black_billed_Cuckoo,80,132,275,486,177,309,195,354
../../CUB_200_2011/images\031.Black_billed_Cuckoo/Black_Billed_Cuckoo_0054_26313.jpg,500,333,031.Black_billed_Cuckoo,190,132,397,333,293,232,207,201
../../CUB_200_2011/images\031.Black_billed_Cuckoo/Black_Billed_Cuckoo_0031_26318.jpg,500,339,031.Black_billed_Cuckoo,109,84,486,217,297,150,377,133
../../CUB_200_2011/images\031.Black_billed_Cuckoo/Black_Billed_Cuckoo_0027_26319.jpg,500,375,031.Black_billed_Cuckoo,90,75,430,252,260,163,340,177
../../CUB_200_2011/images\031.Black_billed_Cuckoo/Black_Billed_Cuckoo_0007_26320.jpg,500,333,031.Black_billed_Cuckoo,155,59,354,254,254,156,199,195
../../CUB_200_2011/images\032.Mangrove_Cuckoo/Mangrove_Cuckoo_0029_794624.jpg,500,335,032.Mangrove_Cuckoo,22,49,378,313,200,181,356,264
../../CUB_200_2011/images\032.Mangrove_Cuckoo/Mangrove_Cuckoo_0022_794625.jpg,240,320,032.Mangrove_Cuckoo,65,75,198,301,131,188,133,226
../../CUB_200_2011/images\032.Mangrove_Cuckoo/Mangrove_Cuckoo_0041_26370.jpg,484,500,032.Mangrove_Cuckoo,77,96,377,294,227,195,300,198
../../CUB_200_2011/images\032.Mangrove_Cuckoo/Mangrove_Cuckoo_0051_794627.jpg,500,333,032.Mangrove_Cuckoo,156,84,267,275,211,179,111,191
../../CUB_200_2011/images\032.Mangrove_Cuckoo/Mangrove_Cuckoo_0042_794628.jpg,495,500,032.Mangrove_Cuckoo,48,144,434,498,241,321,386,354
../../CUB_200_2011/images\032.Mangrove_Cuckoo/Mangrove_Cuckoo_0020_794629.jpg,300,288,032.Mangrove_Cuckoo,81,48,205,269,143,158,124,221
../../CUB_200_2011/images\032.Mangrove_Cuckoo/Mangrove_Cuckoo_0024_794630.jpg,500,331,032.Mangrove_Cuckoo,6,7,500,330,253,168,494,323
../../CUB_200_2011/images\032.Mangrove_Cuckoo/Mangrove_Cuckoo_0025_26375.jpg,500,333,032.Mangrove_Cuckoo,14,102,383,296,198,199,369,194
../../CUB_200_2011/images\032.Mangrove_Cuckoo/Mangrove_Cuckoo_0039_26348.jpg,357,500,032.Mangrove_Cuckoo,139,30,277,491,208,260,138,461
../../CUB_200_2011/images\032.Mangrove_Cuckoo/Mangrove_Cuckoo_0040_26378.jpg,305,500,032.Mangrove_Cuckoo,84,79,208,405,146,242,124,326
../../CUB_200_2011/images\032.Mangrove_Cuckoo/Mangrove_Cuckoo_0015_26380.jpg,383,500,032.Mangrove_Cuckoo,124,195,295,446,209,320,171,251
../../CUB_200_2011/images\032.Mangrove_Cuckoo/Mangrove_Cuckoo_0006_794626.jpg,500,466,032.Mangrove_Cuckoo,141,87,337,426,239,256,196,339
../../CUB_200_2011/images\032.Mangrove_Cuckoo/Mangrove_Cuckoo_0012_26382.jpg,500,331,032.Mangrove_Cuckoo,146,117,454,305,300,211,308,188
../../CUB_200_2011/images\032.Mangrove_Cuckoo/Mangrove_Cuckoo_0014_26388.jpg,500,333,032.Mangrove_Cuckoo,198,132,333,288,265,210,135,156
../../CUB_200_2011/images\032.Mangrove_Cuckoo/Mangrove_Cuckoo_0037_26389.jpg,500,375,032.Mangrove_Cuckoo,10,25,459,364,234,194,449,339
../../CUB_200_2011/images\032.Mangrove_Cuckoo/Mangrove_Cuckoo_0053_26390.jpg,378,500,032.Mangrove_Cuckoo,107,88,256,488,181,288,149,400
../../CUB_200_2011/images\032.Mangrove_Cuckoo/Mangrove_Cuckoo_0044_26393.jpg,500,316,032.Mangrove_Cuckoo,156,87,336,271,246,179,180,184
../../CUB_200_2011/images\032.Mangrove_Cuckoo/Mangrove_Cuckoo_0048_26351.jpg,420,500,032.Mangrove_Cuckoo,81,135,321,408,201,271,240,273
../../CUB_200_2011/images\032.Mangrove_Cuckoo/Mangrove_Cuckoo_0010_26399.jpg,500,375,032.Mangrove_Cuckoo,167,30,362,364,264,197,195,334
../../CUB_200_2011/images\032.Mangrove_Cuckoo/Mangrove_Cuckoo_0031_26401.jpg,500,365,032.Mangrove_Cuckoo,28,45,495,305,261,175,467,260
../../CUB_200_2011/images\032.Mangrove_Cuckoo/Mangrove_Cuckoo_0011_26406.jpg,339,500,032.Mangrove_Cuckoo,0,103,316,387,158,245,316,284
../../CUB_200_2011/images\032.Mangrove_Cuckoo/Mangrove_Cuckoo_0023_26409.jpg,500,500,032.Mangrove_Cuckoo,19,91,452,385,235,238,433,294
../../CUB_200_2011/images\032.Mangrove_Cuckoo/Mangrove_Cuckoo_0002_26410.jpg,375,500,032.Mangrove_Cuckoo,21,100,276,349,148,224,255,249
../../CUB_200_2011/images\032.Mangrove_Cuckoo/Mangrove_Cuckoo_0049_794631.jpg,375,500,032.Mangrove_Cuckoo,83,163,335,465,209,314,252,302
../../CUB_200_2011/images\032.Mangrove_Cuckoo/Mangrove_Cuckoo_0009_26354.jpg,500,333,032.Mangrove_Cuckoo,132,36,332,319,232,177,200,283
../../CUB_200_2011/images\032.Mangrove_Cuckoo/Mangrove_Cuckoo_0034_26415.jpg,500,375,032.Mangrove_Cuckoo,286,114,386,311,336,212,100,197
../../CUB_200_2011/images\032.Mangrove_Cuckoo/Mangrove_Cuckoo_0030_26350.jpg,500,375,032.Mangrove_Cuckoo,173,62,342,275,257,168,169,213
../../CUB_200_2011/images\032.Mangrove_Cuckoo/Mangrove_Cuckoo_0028_26358.jpg,500,333,032.Mangrove_Cuckoo,68,70,307,323,187,196,239,253
../../CUB_200_2011/images\032.Mangrove_Cuckoo/Mangrove_Cuckoo_0027_26360.jpg,334,500,032.Mangrove_Cuckoo,39,52,227,482,133,267,188,430
../../CUB_200_2011/images\032.Mangrove_Cuckoo/Mangrove_Cuckoo_0018_794593.jpg,140,202,032.Mangrove_Cuckoo,15,14,123,177,69,95,108,163
../../CUB_200_2011/images\032.Mangrove_Cuckoo/Mangrove_Cuckoo_0050_794594.jpg,500,408,032.Mangrove_Cuckoo,46,111,314,260,180,185,268,149
../../CUB_200_2011/images\032.Mangrove_Cuckoo/Mangrove_Cuckoo_0035_794595.jpg,220,218,032.Mangrove_Cuckoo,34,10,183,205,108,107,149,195
../../CUB_200_2011/images\032.Mangrove_Cuckoo/Mangrove_Cuckoo_0005_794599.jpg,333,360,032.Mangrove_Cuckoo,25,33,294,343,159,188,269,310
../../CUB_200_2011/images\032.Mangrove_Cuckoo/Mangrove_Cuckoo_0038_794600.jpg,500,377,032.Mangrove_Cuckoo,52,43,459,326,255,184,407,283
../../CUB_200_2011/images\032.Mangrove_Cuckoo/Mangrove_Cuckoo_0001_794601.jpg,320,360,032.Mangrove_Cuckoo,23,12,321,345,172,178,298,333
../../CUB_200_2011/images\032.Mangrove_Cuckoo/Mangrove_Cuckoo_0021_794602.jpg,500,336,032.Mangrove_Cuckoo,0,29,482,332,241,180,482,303
../../CUB_200_2011/images\032.Mangrove_Cuckoo/Mangrove_Cuckoo_0032_794603.jpg,500,440,032.Mangrove_Cuckoo,102,39,470,433,286,236,368,394
../../CUB_200_2011/images\032.Mangrove_Cuckoo/Mangrove_Cuckoo_0047_794604.jpg,236,320,032.Mangrove_Cuckoo,35,68,199,253,117,160,164,185
../../CUB_200_2011/images\032.Mangrove_Cuckoo/Mangrove_Cuckoo_0043_794605.jpg,469,352,032.Mangrove_Cuckoo,160,94,265,335,212,214,105,241
../../CUB_200_2011/images\032.Mangrove_Cuckoo/Mangrove_Cuckoo_0036_794606.jpg,364,400,032.Mangrove_Cuckoo,77,35,229,383,153,209,152,348
../../CUB_200_2011/images\032.Mangrove_Cuckoo/Mangrove_Cuckoo_0016_794607.jpg,140,176,032.Mangrove_Cuckoo,1,13,133,172,67,92,132,159
../../CUB_200_2011/images\032.Mangrove_Cuckoo/Mangrove_Cuckoo_0052_794608.jpg,500,372,032.Mangrove_Cuckoo,2,128,407,361,204,244,405,233
../../CUB_200_2011/images\032.Mangrove_Cuckoo/Mangrove_Cuckoo_0026_794609.jpg,267,400,032.Mangrove_Cuckoo,56,63,181,333,118,198,125,270
../../CUB_200_2011/images\032.Mangrove_Cuckoo/Mangrove_Cuckoo_0007_794610.jpg,370,238,032.Mangrove_Cuckoo,125,46,245,226,185,136,120,180
../../CUB_200_2011/images\032.Mangrove_Cuckoo/Mangrove_Cuckoo_0045_794612.jpg,500,387,032.Mangrove_Cuckoo,145,57,443,300,294,178,298,243
../../CUB_200_2011/images\032.Mangrove_Cuckoo/Mangrove_Cuckoo_0008_26357.jpg,500,333,032.Mangrove_Cuckoo,208,39,352,323,280,181,144,284
../../CUB_200_2011/images\032.Mangrove_Cuckoo/Mangrove_Cuckoo_0004_794614.jpg,300,275,032.Mangrove_Cuckoo,68,36,270,214,169,125,202,178
../../CUB_200_2011/images\032.Mangrove_Cuckoo/Mangrove_Cuckoo_0033_26359.jpg,500,333,032.Mangrove_Cuckoo,179,92,331,332,255,212,152,240
../../CUB_200_2011/images\032.Mangrove_Cuckoo/Mangrove_Cuckoo_0046_794616.jpg,350,350,032.Mangrove_Cuckoo,17,39,304,307,160,173,287,268
../../CUB_200_2011/images\032.Mangrove_Cuckoo/Mangrove_Cuckoo_0003_794619.jpg,407,500,032.Mangrove_Cuckoo,67,63,332,485,199,274,265,422
../../CUB_200_2011/images\032.Mangrove_Cuckoo/Mangrove_Cuckoo_0013_794620.jpg,230,277,032.Mangrove_Cuckoo,59,39,183,258,121,148,124,219
../../CUB_200_2011/images\032.Mangrove_Cuckoo/Mangrove_Cuckoo_0019_794621.jpg,500,433,032.Mangrove_Cuckoo,137,95,357,417,247,256,220,322
../../CUB_200_2011/images\032.Mangrove_Cuckoo/Mangrove_Cuckoo_0017_794623.jpg,300,496,032.Mangrove_Cuckoo,48,37,244,451,146,244,196,414
../../CUB_200_2011/images\033.Yellow_billed_Cuckoo/Yellow_Billed_Cuckoo_0048_26632.jpg,436,500,033.Yellow_billed_Cuckoo,94,69,363,417,228,243,269,348
../../CUB_200_2011/images\033.Yellow_billed_Cuckoo/Yellow_Billed_Cuckoo_0023_26637.jpg,500,357,033.Yellow_billed_Cuckoo,94,138,195,256,144,197,101,118
../../CUB_200_2011/images\033.Yellow_billed_Cuckoo/Yellow_Billed_Cuckoo_0094_26643.jpg,500,337,033.Yellow_billed_Cuckoo,205,117,365,323,285,220,160,206
../../CUB_200_2011/images\033.Yellow_billed_Cuckoo/Yellow_Billed_Cuckoo_0027_26844.jpg,500,333,033.Yellow_billed_Cuckoo,99,109,361,277,230,193,262,168
../../CUB_200_2011/images\033.Yellow_billed_Cuckoo/Yellow_Billed_Cuckoo_0117_26651.jpg,418,500,033.Yellow_billed_Cuckoo,117,116,366,444,241,280,249,328
../../CUB_200_2011/images\033.Yellow_billed_Cuckoo/Yellow_Billed_Cuckoo_0082_26655.jpg,500,375,033.Yellow_billed_Cuckoo,33,76,403,266,218,171,370,190
../../CUB_200_2011/images\033.Yellow_billed_Cuckoo/Yellow_Billed_Cuckoo_0009_26656.jpg,500,361,033.Yellow_billed_Cuckoo,129,45,365,335,247,190,236,290
../../CUB_200_2011/images\033.Yellow_billed_Cuckoo/Yellow_Billed_Cuckoo_0078_26888.jpg,400,500,033.Yellow_billed_Cuckoo,88,79,285,456,186,267,197,377
../../CUB_200_2011/images\033.Yellow_billed_Cuckoo/Yellow_Billed_Cuckoo_0022_26423.jpg,500,346,033.Yellow_billed_Cuckoo,163,96,412,217,287,156,249,121
../../CUB_200_2011/images\033.Yellow_billed_Cuckoo/Yellow_Billed_Cuckoo_0050_26424.jpg,500,375,033.Yellow_billed_Cuckoo,31,83,496,290,263,186,465,207
../../CUB_200_2011/images\033.Yellow_billed_Cuckoo/Yellow_Billed_Cuckoo_0036_26682.jpg,357,500,033.Yellow_billed_Cuckoo,166,227,292,331,229,279,126,104
../../CUB_200_2011/images\033.Yellow_billed_Cuckoo/Yellow_Billed_Cuckoo_0005_26684.jpg,420,280,033.Yellow_billed_Cuckoo,74,55,220,257,147,156,146,202
../../CUB_200_2011/images\033.Yellow_billed_Cuckoo/Yellow_Billed_Cuckoo_0045_26685.jpg,500,333,033.Yellow_billed_Cuckoo,35,37,210,322,122,179,175,285
../../CUB_200_2011/images\033.Yellow_billed_Cuckoo/Yellow_Billed_Cuckoo_0060_26686.jpg,400,500,033.Yellow_billed_Cuckoo,76,54,243,465,159,259,167,411
../../CUB_200_2011/images\033.Yellow_billed_Cuckoo/Yellow_Billed_Cuckoo_0007_26687.jpg,379,500,033.Yellow_billed_Cuckoo,109,62,286,499,197,280,177,437
../../CUB_200_2011/images\033.Yellow_billed_Cuckoo/Yellow_Billed_Cuckoo_0093_26432.jpg,500,366,033.Yellow_billed_Cuckoo,3,17,477,359,240,188,474,342
../../CUB_200_2011/images\033.Yellow_billed_Cuckoo/Yellow_Billed_Cuckoo_0042_26479.jpg,500,341,033.Yellow_billed_Cuckoo,75,123,351,268,213,195,276,145
../../CUB_200_2011/images\033.Yellow_billed_Cuckoo/Yellow_Billed_Cuckoo_0061_26692.jpg,500,395,033.Yellow_billed_Cuckoo,164,57,326,351,245,204,162,294
../../CUB_200_2011/images\033.Yellow_billed_Cuckoo/Yellow_Billed_Cuckoo_0034_26694.jpg,333,500,033.Yellow_billed_Cuckoo,88,153,194,445,141,299,106,292
../../CUB_200_2011/images\033.Yellow_billed_Cuckoo/Yellow_Billed_Cuckoo_0028_26446.jpg,500,400,033.Yellow_billed_Cuckoo,115,87,410,265,262,176,295,178
../../CUB_200_2011/images\033.Yellow_billed_Cuckoo/Yellow_Billed_Cuckoo_0039_26510.jpg,500,400,033.Yellow_billed_Cuckoo,185,117,324,336,254,226,139,219
../../CUB_200_2011/images\033.Yellow_billed_Cuckoo/Yellow_Billed_Cuckoo_0012_26712.jpg,500,333,033.Yellow_billed_Cuckoo,114,97,268,319,191,208,154,222
../../CUB_200_2011/images\033.Yellow_billed_Cuckoo/Yellow_Billed_Cuckoo_0097_26713.jpg,500,347,033.Yellow_billed_Cuckoo,120,159,403,294,261,226,283,135
../../CUB_200_2011/images\033.Yellow_billed_Cuckoo/Yellow_Billed_Cuckoo_0090_26714.jpg,500,335,033.Yellow_billed_Cuckoo,0,120,397,333,198,226,397,213
../../CUB_200_2011/images\033.Yellow_billed_Cuckoo/Yellow_Billed_Cuckoo_0002_26715.jpg,500,445,033.Yellow_billed_Cuckoo,59,113,356,294,207,203,297,181
../../CUB_200_2011/images\033.Yellow_billed_Cuckoo/Yellow_Billed_Cuckoo_0074_26466.jpg,500,313,033.Yellow_billed_Cuckoo,88,68,205,196,146,132,117,128
../../CUB_200_2011/images\033.Yellow_billed_Cuckoo/Yellow_Billed_Cuckoo_0091_26428.jpg,500,395,033.Yellow_billed_Cuckoo,67,61,490,390,278,225,423,329
../../CUB_200_2011/images\033.Yellow_billed_Cuckoo/Yellow_Billed_Cuckoo_0081_26429.jpg,500,357,033.Yellow_billed_Cuckoo,28,53,471,250,249,151,443,197
../../CUB_200_2011/images\033.Yellow_billed_Cuckoo/Yellow_Billed_Cuckoo_0053_26738.jpg,334,500,033.Yellow_billed_Cuckoo,71,124,267,451,169,287,196,327
../../CUB_200_2011/images\033.Yellow_billed_Cuckoo/Yellow_Billed_Cuckoo_0073_26744.jpg,500,390,033.Yellow_billed_Cuckoo,164,134,362,285,263,209,198,151
../../CUB_200_2011/images\033.Yellow_billed_Cuckoo/Yellow_Billed_Cuckoo_0077_26431.jpg,400,500,033.Yellow_billed_Cuckoo,80,114,329,427,204,270,249,313
../../CUB_200_2011/images\033.Yellow_billed_Cuckoo/Yellow_Billed_Cuckoo_0043_26492.jpg,500,356,033.Yellow_billed_Cuckoo,124,60,430,323,277,191,306,263
../../CUB_200_2011/images\033.Yellow_billed_Cuckoo/Yellow_Billed_Cuckoo_0014_26754.jpg,362,500,033.Yellow_billed_Cuckoo,131,190,338,463,234,326,207,273
../../CUB_200_2011/images\033.Yellow_billed_Cuckoo/Yellow_Billed_Cuckoo_0098_26501.jpg,500,333,033.Yellow_billed_Cuckoo,149,67,351,225,250,146,202,158
../../CUB_200_2011/images\033.Yellow_billed_Cuckoo/Yellow_Billed_Cuckoo_0084_26761.jpg,333,500,033.Yellow_billed_Cuckoo,120,169,239,407,179,288,119,238
../../CUB_200_2011/images\033.Yellow_billed_Cuckoo/Yellow_Billed_Cuckoo_0049_26766.jpg,465,500,033.Yellow_billed_Cuckoo,203,117,350,451,276,284,147,334
../../CUB_200_2011/images\033.Yellow_billed_Cuckoo/Yellow_Billed_Cuckoo_0033_26521.jpg,500,382,033.Yellow_billed_Cuckoo,170,94,365,346,267,220,195,252
../../CUB_200_2011/images\033.Yellow_billed_Cuckoo/Yellow_Billed_Cuckoo_0004_26790.jpg,500,360,033.Yellow_billed_Cuckoo,216,130,377,290,296,210,161,160
../../CUB_200_2011/images\033.Yellow_billed_Cuckoo/Yellow_Billed_Cuckoo_0018_26535.jpg,366,500,033.Yellow_billed_Cuckoo,110,78,274,457,192,267,164,379
../../CUB_200_2011/images\033.Yellow_billed_Cuckoo/Yellow_Billed_Cuckoo_0026_26794.jpg,500,325,033.Yellow_billed_Cuckoo,90,47,446,225,268,136,356,178
../../CUB_200_2011/images\033.Yellow_billed_Cuckoo/Yellow_Billed_Cuckoo_0010_26795.jpg,357,500,033.Yellow_billed_Cuckoo,31,90,283,472,157,281,252,382
../../CUB_200_2011/images\033.Yellow_billed_Cuckoo/Yellow_Billed_Cuckoo_0003_26797.jpg,386,500,033.Yellow_billed_Cuckoo,84,46,358,434,221,240,274,388
../../CUB_200_2011/images\033.Yellow_billed_Cuckoo/Yellow_Billed_Cuckoo_0116_26544.jpg,333,500,033.Yellow_billed_Cuckoo,35,88,302,408,168,248,267,320
../../CUB_200_2011/images\033.Yellow_billed_Cuckoo/Yellow_Billed_Cuckoo_0019_26803.jpg,500,442,033.Yellow_billed_Cuckoo,82,115,353,308,217,211,271,193
../../CUB_200_2011/images\033.Yellow_billed_Cuckoo/Yellow_Billed_Cuckoo_0119_26550.jpg,500,400,033.Yellow_billed_Cuckoo,105,24,324,282,214,153,219,258
../../CUB_200_2011/images\033.Yellow_billed_Cuckoo/Yellow_Billed_Cuckoo_0121_26807.jpg,500,361,033.Yellow_billed_Cuckoo,117,74,245,251,181,162,128,177
../../CUB_200_2011/images\033.Yellow_billed_Cuckoo/Yellow_Billed_Cuckoo_0088_26812.jpg,308,500,033.Yellow_billed_Cuckoo,71,51,234,486,152,268,163,435
../../CUB_200_2011/images\033.Yellow_billed_Cuckoo/Yellow_Billed_Cuckoo_0104_26814.jpg,500,375,033.Yellow_billed_Cuckoo,188,143,328,304,258,223,140,161
../../CUB_200_2011/images\033.Yellow_billed_Cuckoo/Yellow_Billed_Cuckoo_0038_26912.jpg,500,375,033.Yellow_billed_Cuckoo,133,68,326,263,229,165,193,195
../../CUB_200_2011/images\033.Yellow_billed_Cuckoo/Yellow_Billed_Cuckoo_0059_26828.jpg,356,500,033.Yellow_billed_Cuckoo,98,138,204,412,151,275,106,274
../../CUB_200_2011/images\033.Yellow_billed_Cuckoo/Yellow_Billed_Cuckoo_0024_26832.jpg,500,333,033.Yellow_billed_Cuckoo,46,1,362,221,204,111,316,220
../../CUB_200_2011/images\033.Yellow_billed_Cuckoo/Yellow_Billed_Cuckoo_0006_26578.jpg,500,386,033.Yellow_billed_Cuckoo,118,71,302,363,210,217,184,292
../../CUB_200_2011/images\033.Yellow_billed_Cuckoo/Yellow_Billed_Cuckoo_0107_26838.jpg,500,375,033.Yellow_billed_Cuckoo,104,112,304,269,204,190,200,157
../../CUB_200_2011/images\033.Yellow_billed_Cuckoo/Yellow_Billed_Cuckoo_0069_26597.jpg,379,500,033.Yellow_billed_Cuckoo,123,90,311,478,217,284,188,388
../../CUB_200_2011/images\033.Yellow_billed_Cuckoo/Yellow_Billed_Cuckoo_0066_26600.jpg,333,500,033.Yellow_billed_Cuckoo,102,176,214,401,158,288,112,225
../../CUB_200_2011/images\033.Yellow_billed_Cuckoo/Yellow_Billed_Cuckoo_0092_26859.jpg,333,500,033.Yellow_billed_Cuckoo,65,26,208,465,136,245,143,439
../../CUB_200_2011/images\033.Yellow_billed_Cuckoo/Yellow_Billed_Cuckoo_0029_26865.jpg,500,375,033.Yellow_billed_Cuckoo,210,125,322,333,266,229,112,208
../../CUB_200_2011/images\033.Yellow_billed_Cuckoo/Yellow_Billed_Cuckoo_0032_26616.jpg,407,500,033.Yellow_billed_Cuckoo,68,86,325,462,196,274,257,376
../../CUB_200_2011/images\033.Yellow_billed_Cuckoo/Yellow_Billed_Cuckoo_0067_26878.jpg,500,401,033.Yellow_billed_Cuckoo,168,106,390,372,279,239,222,266
../../CUB_200_2011/images\034.Gray_crowned_Rosy_Finch/Gray_Crowned_Rosy_Finch_0078_27136.jpg,304,500,034.Gray_crowned_Rosy_Finch,56,100,202,209,129,154,146,109
../../CUB_200_2011/images\034.Gray_crowned_Rosy_Finch/Gray_Crowned_Rosy_Finch_0042_27143.jpg,500,375,034.Gray_crowned_Rosy_Finch,101,142,346,315,223,228,245,173
../../CUB_200_2011/images\034.Gray_crowned_Rosy_Finch/Gray_Crowned_Rosy_Finch_0027_27153.jpg,459,500,034.Gray_crowned_Rosy_Finch,146,136,398,397,272,266,252,261
../../CUB_200_2011/images\034.Gray_crowned_Rosy_Finch/Gray_Crowned_Rosy_Finch_0074_27156.jpg,500,327,034.Gray_crowned_Rosy_Finch,17,136,353,298,185,217,336,162
../../CUB_200_2011/images\034.Gray_crowned_Rosy_Finch/Gray_Crowned_Rosy_Finch_0026_27160.jpg,493,500,034.Gray_crowned_Rosy_Finch,99,97,347,495,223,296,248,398
../../CUB_200_2011/images\034.Gray_crowned_Rosy_Finch/Gray_Crowned_Rosy_Finch_0075_27165.jpg,500,366,034.Gray_crowned_Rosy_Finch,27,72,402,277,214,174,375,205
../../CUB_200_2011/images\034.Gray_crowned_Rosy_Finch/Gray_Crowned_Rosy_Finch_0016_27181.jpg,500,483,034.Gray_crowned_Rosy_Finch,48,161,209,349,128,255,161,188
../../CUB_200_2011/images\034.Gray_crowned_Rosy_Finch/Gray_Crowned_Rosy_Finch_0043_26990.jpg,500,396,034.Gray_crowned_Rosy_Finch,35,67,352,352,193,209,317,285
../../CUB_200_2011/images\034.Gray_crowned_Rosy_Finch/Gray_Crowned_Rosy_Finch_0019_27192.jpg,499,500,034.Gray_crowned_Rosy_Finch,178,217,396,421,287,319,218,204
../../CUB_200_2011/images\034.Gray_crowned_Rosy_Finch/Gray_Crowned_Rosy_Finch_0068_27196.jpg,500,375,034.Gray_crowned_Rosy_Finch,140,74,418,271,279,172,278,197
../../CUB_200_2011/images\034.Gray_crowned_Rosy_Finch/Gray_Crowned_Rosy_Finch_0076_27200.jpg,500,375,034.Gray_crowned_Rosy_Finch,181,53,420,246,300,149,239,193
../../CUB_200_2011/images\034.Gray_crowned_Rosy_Finch/Gray_Crowned_Rosy_Finch_0009_26977.jpg,439,500,034.Gray_crowned_Rosy_Finch,113,68,390,428,251,248,277,360
../../CUB_200_2011/images\034.Gray_crowned_Rosy_Finch/Gray_Crowned_Rosy_Finch_0001_27211.jpg,500,333,034.Gray_crowned_Rosy_Finch,157,27,328,284,242,155,171,257
../../CUB_200_2011/images\034.Gray_crowned_Rosy_Finch/Gray_Crowned_Rosy_Finch_0018_26978.jpg,500,333,034.Gray_crowned_Rosy_Finch,154,37,461,284,307,160,307,247
../../CUB_200_2011/images\034.Gray_crowned_Rosy_Finch/Gray_Crowned_Rosy_Finch_0067_797289.jpg,350,322,034.Gray_crowned_Rosy_Finch,39,27,311,292,175,159,272,265
../../CUB_200_2011/images\034.Gray_crowned_Rosy_Finch/Gray_Crowned_Rosy_Finch_0061_26979.jpg,500,487,034.Gray_crowned_Rosy_Finch,97,36,458,466,277,251,361,430
../../CUB_200_2011/images\034.Gray_crowned_Rosy_Finch/Gray_Crowned_Rosy_Finch_0004_797272.jpg,500,465,034.Gray_crowned_Rosy_Finch,188,144,304,280,246,212,116,136
../../CUB_200_2011/images\034.Gray_crowned_Rosy_Finch/Gray_Crowned_Rosy_Finch_0048_27236.jpg,500,310,034.Gray_crowned_Rosy_Finch,214,78,448,263,331,170,234,185
../../CUB_200_2011/images\034.Gray_crowned_Rosy_Finch/Gray_Crowned_Rosy_Finch_0025_797274.jpg,500,387,034.Gray_crowned_Rosy_Finch,143,91,409,340,276,215,266,249
../../CUB_200_2011/images\034.Gray_crowned_Rosy_Finch/Gray_Crowned_Rosy_Finch_0053_797276.jpg,500,334,034.Gray_crowned_Rosy_Finch,43,50,349,308,196,179,306,258
../../CUB_200_2011/images\034.Gray_crowned_Rosy_Finch/Gray_Crowned_Rosy_Finch_0007_797278.jpg,334,500,034.Gray_crowned_Rosy_Finch,40,62,208,202,124,132,168,140
../../CUB_200_2011/images\034.Gray_crowned_Rosy_Finch/Gray_Crowned_Rosy_Finch_0044_26976.jpg,500,357,034.Gray_crowned_Rosy_Finch,104,74,476,292,290,183,372,218
../../CUB_200_2011/images\034.Gray_crowned_Rosy_Finch/Gray_Crowned_Rosy_Finch_0083_797281.jpg,372,500,034.Gray_crowned_Rosy_Finch,67,72,272,435,169,253,205,363
../../CUB_200_2011/images\034.Gray_crowned_Rosy_Finch/Gray_Crowned_Rosy_Finch_0006_797284.jpg,265,289,034.Gray_crowned_Rosy_Finch,4,12,248,253,126,132,244,241
../../CUB_200_2011/images\034.Gray_crowned_Rosy_Finch/Gray_Crowned_Rosy_Finch_0071_797285.jpg,500,324,034.Gray_crowned_Rosy_Finch,126,44,468,311,297,177,342,267
../../CUB_200_2011/images\034.Gray_crowned_Rosy_Finch/Gray_Crowned_Rosy_Finch_0021_797286.jpg,500,459,034.Gray_crowned_Rosy_Finch,135,52,418,352,276,202,283,300
../../CUB_200_2011/images\034.Gray_crowned_Rosy_Finch/Gray_Crowned_Rosy_Finch_0036_797287.jpg,300,247,034.Gray_crowned_Rosy_Finch,38,63,250,189,144,126,212,126
../../CUB_200_2011/images\034.Gray_crowned_Rosy_Finch/Gray_Crowned_Rosy_Finch_0023_797288.jpg,500,329,034.Gray_crowned_Rosy_Finch,36,71,422,279,229,175,386,208
../../CUB_200_2011/images\034.Gray_crowned_Rosy_Finch/Gray_Crowned_Rosy_Finch_0040_26985.jpg,500,375,034.Gray_crowned_Rosy_Finch,143,13,310,278,226,145,167,265
../../CUB_200_2011/images\034.Gray_crowned_Rosy_Finch/Gray_Crowned_Rosy_Finch_0015_797291.jpg,500,500,034.Gray_crowned_Rosy_Finch,137,100,399,462,268,281,262,362
../../CUB_200_2011/images\034.Gray_crowned_Rosy_Finch/Gray_Crowned_Rosy_Finch_0051_26988.jpg,455,500,034.Gray_crowned_Rosy_Finch,26,68,386,472,206,270,360,404
../../CUB_200_2011/images\034.Gray_crowned_Rosy_Finch/Gray_Crowned_Rosy_Finch_0056_797293.jpg,375,500,034.Gray_crowned_Rosy_Finch,83,69,367,389,225,229,284,320
../../CUB_200_2011/images\034.Gray_crowned_Rosy_Finch/Gray_Crowned_Rosy_Finch_0079_797294.jpg,500,333,034.Gray_crowned_Rosy_Finch,76,50,280,285,178,167,204,235
../../CUB_200_2011/images\034.Gray_crowned_Rosy_Finch/Gray_Crowned_Rosy_Finch_0046_797295.jpg,400,289,034.Gray_crowned_Rosy_Finch,84,31,267,224,175,127,183,193
../../CUB_200_2011/images\034.Gray_crowned_Rosy_Finch/Gray_Crowned_Rosy_Finch_0066_797298.jpg,500,333,034.Gray_crowned_Rosy_Finch,20,40,420,229,220,134,400,189
../../CUB_200_2011/images\034.Gray_crowned_Rosy_Finch/Gray_Crowned_Rosy_Finch_0031_797299.jpg,400,228,034.Gray_crowned_Rosy_Finch,64,47,376,192,220,119,312,145
../../CUB_200_2011/images\034.Gray_crowned_Rosy_Finch/Gray_Crowned_Rosy_Finch_0029_797300.jpg,474,500,034.Gray_crowned_Rosy_Finch,166,122,438,431,302,276,272,309
../../CUB_200_2011/images\034.Gray_crowned_Rosy_Finch/Gray_Crowned_Rosy_Finch_0065_797301.jpg,500,375,034.Gray_crowned_Rosy_Finch,146,76,487,350,316,213,341,274
../../CUB_200_2011/images\034.Gray_crowned_Rosy_Finch/Gray_Crowned_Rosy_Finch_0047_797303.jpg,500,417,034.Gray_crowned_Rosy_Finch,3,74,420,349,211,211,417,275
../../CUB_200_2011/images\034.Gray_crowned_Rosy_Finch/Gray_Crowned_Rosy_Finch_0034_797305.jpg,500,400,034.Gray_crowned_Rosy_Finch,221,58,412,312,316,185,191,254
../../CUB_200_2011/images\034.Gray_crowned_Rosy_Finch/Gray_Crowned_Rosy_Finch_0038_797309.jpg,500,354,034.Gray_crowned_Rosy_Finch,19,26,384,326,201,176,365,300
../../CUB_200_2011/images\034.Gray_crowned_Rosy_Finch/Gray_Crowned_Rosy_Finch_0064_27007.jpg,500,375,034.Gray_crowned_Rosy_Finch,79,128,343,236,211,182,264,108
../../CUB_200_2011/images\034.Gray_crowned_Rosy_Finch/Gray_Crowned_Rosy_Finch_0072_26993.jpg,500,375,034.Gray_crowned_Rosy_Finch,165,146,420,282,292,214,255,136
../../CUB_200_2011/images\034.Gray_crowned_Rosy_Finch/Gray_Crowned_Rosy_Finch_0022_27028.jpg,500,386,034.Gray_crowned_Rosy_Finch,99,36,494,376,296,206,395,340
../../CUB_200_2011/images\034.Gray_crowned_Rosy_Finch/Gray_Crowned_Rosy_Finch_0052_27032.jpg,500,375,034.Gray_crowned_Rosy_Finch,113,76,380,281,246,178,267,205
../../CUB_200_2011/images\034.Gray_crowned_Rosy_Finch/Gray_Crowned_Rosy_Finch_0084_27034.jpg,500,370,034.Gray_crowned_Rosy_Finch,38,28,322,353,180,190,284,325
../../CUB_200_2011/images\034.Gray_crowned_Rosy_Finch/Gray_Crowned_Rosy_Finch_0010_27039.jpg,500,333,034.Gray_crowned_Rosy_Finch,105,53,499,296,302,174,394,243
../../CUB_200_2011/images\034.Gray_crowned_Rosy_Finch/Gray_Crowned_Rosy_Finch_0024_27057.jpg,500,321,034.Gray_crowned_Rosy_Finch,80,134,270,255,175,194,190,121
../../CUB_200_2011/images\034.Gray_crowned_Rosy_Finch/Gray_Crowned_Rosy_Finch_0012_27062.jpg,500,398,034.Gray_crowned_Rosy_Finch,131,62,478,368,304,215,347,306
../../CUB_200_2011/images\034.Gray_crowned_Rosy_Finch/Gray_Crowned_Rosy_Finch_0030_27068.jpg,500,333,034.Gray_crowned_Rosy_Finch,147,93,284,277,215,185,137,184
../../CUB_200_2011/images\034.Gray_crowned_Rosy_Finch/Gray_Crowned_Rosy_Finch_0037_27088.jpg,500,397,034.Gray_crowned_Rosy_Finch,70,117,376,318,223,217,306,201
../../CUB_200_2011/images\034.Gray_crowned_Rosy_Finch/Gray_Crowned_Rosy_Finch_0073_27104.jpg,500,334,034.Gray_crowned_Rosy_Finch,21,66,451,291,236,178,430,225
../../CUB_200_2011/images\034.Gray_crowned_Rosy_Finch/Gray_Crowned_Rosy_Finch_0041_27105.jpg,500,347,034.Gray_crowned_Rosy_Finch,166,94,423,322,294,208,257,228
../../CUB_200_2011/images\034.Gray_crowned_Rosy_Finch/Gray_Crowned_Rosy_Finch_0057_27107.jpg,381,500,034.Gray_crowned_Rosy_Finch,52,48,299,474,175,261,247,426
../../CUB_200_2011/images\034.Gray_crowned_Rosy_Finch/Gray_Crowned_Rosy_Finch_0080_27108.jpg,333,500,034.Gray_crowned_Rosy_Finch,41,164,277,399,159,281,236,235
../../CUB_200_2011/images\034.Gray_crowned_Rosy_Finch/Gray_Crowned_Rosy_Finch_0013_27110.jpg,500,373,034.Gray_crowned_Rosy_Finch,54,137,311,283,182,210,257,146
../../CUB_200_2011/images\034.Gray_crowned_Rosy_Finch/Gray_Crowned_Rosy_Finch_0055_27112.jpg,500,319,034.Gray_crowned_Rosy_Finch,201,113,499,267,350,190,298,154
../../CUB_200_2011/images\034.Gray_crowned_Rosy_Finch/Gray_Crowned_Rosy_Finch_0028_27114.jpg,372,500,034.Gray_crowned_Rosy_Finch,68,157,366,310,217,233,298,153
../../CUB_200_2011/images\034.Gray_crowned_Rosy_Finch/Gray_Crowned_Rosy_Finch_0063_27123.jpg,500,331,034.Gray_crowned_Rosy_Finch,141,106,261,225,201,165,120,119
../../CUB_200_2011/images\035.Purple_Finch/Purple_Finch_0025_28174.jpg,500,362,035.Purple_Finch,221,108,412,238,316,173,191,130
../../CUB_200_2011/images\035.Purple_Finch/Purple_Finch_0048_27670.jpg,500,374,035.Purple_Finch,178,83,352,340,265,211,174,257
../../CUB_200_2011/images\035.Purple_Finch/Purple_Finch_0115_28190.jpg,337,500,035.Purple_Finch,55,63,296,442,175,252,241,379
../../CUB_200_2011/images\035.Purple_Finch/Purple_Finch_0096_27688.jpg,500,333,035.Purple_Finch,102,29,347,299,224,164,245,270
../../CUB_200_2011/images\035.Purple_Finch/Purple_Finch_0001_27571.jpg,500,375,035.Purple_Finch,100,83,496,327,298,205,396,244
../../CUB_200_2011/images\035.Purple_Finch/Purple_Finch_0050_27702.jpg,500,334,035.Purple_Finch,175,103,482,279,328,191,307,176
../../CUB_200_2011/images\035.Purple_Finch/Purple_Finch_0021_28235.jpg,500,375,035.Purple_Finch,76,57,346,335,211,196,270,278
../../CUB_200_2011/images\035.Purple_Finch/Purple_Finch_0031_28175.jpg,500,360,035.Purple_Finch,254,60,458,311,356,185,204,251
../../CUB_200_2011/images\035.Purple_Finch/Purple_Finch_0110_27750.jpg,500,333,035.Purple_Finch,168,34,442,283,305,158,274,249
../../CUB_200_2011/images\035.Purple_Finch/Purple_Finch_0030_27255.jpg,495,500,035.Purple_Finch,113,121,420,390,266,255,307,269
../../CUB_200_2011/images\035.Purple_Finch/Purple_Finch_0079_27258.jpg,500,333,035.Purple_Finch,224,23,499,177,361,100,275,154
../../CUB_200_2011/images\035.Purple_Finch/Purple_Finch_0119_27260.jpg,500,333,035.Purple_Finch,69,24,478,318,273,171,409,294
../../CUB_200_2011/images\035.Purple_Finch/Purple_Finch_0092_27264.jpg,500,400,035.Purple_Finch,75,33,393,394,234,213,318,361
../../CUB_200_2011/images\035.Purple_Finch/Purple_Finch_0002_27266.jpg,500,333,035.Purple_Finch,126,80,317,192,221,136,191,112
../../CUB_200_2011/images\035.Purple_Finch/Purple_Finch_0098_27280.jpg,500,364,035.Purple_Finch,31,66,445,287,238,176,414,221
../../CUB_200_2011/images\035.Purple_Finch/Purple_Finch_0097_27288.jpg,500,333,035.Purple_Finch,24,36,453,279,238,157,429,243
../../CUB_200_2011/images\035.Purple_Finch/Purple_Finch_0111_27293.jpg,500,358,035.Purple_Finch,106,37,251,318,178,177,145,281
../../CUB_200_2011/images\035.Purple_Finch/Purple_Finch_0046_27295.jpg,500,392,035.Purple_Finch,141,97,413,358,277,227,272,261
../../CUB_200_2011/images\035.Purple_Finch/Purple_Finch_0032_27305.jpg,500,375,035.Purple_Finch,1,59,369,338,185,198,368,279
../../CUB_200_2011/images\035.Purple_Finch/Purple_Finch_0102_27308.jpg,400,500,035.Purple_Finch,154,130,343,410,248,270,189,280
../../CUB_200_2011/images\035.Purple_Finch/Purple_Finch_0014_27322.jpg,500,384,035.Purple_Finch,35,113,349,354,192,233,314,241
../../CUB_200_2011/images\035.Purple_Finch/Purple_Finch_0094_27323.jpg,500,375,035.Purple_Finch,59,97,441,280,250,188,382,183
../../CUB_200_2011/images\035.Purple_Finch/Purple_Finch_0114_27837.jpg,305,500,035.Purple_Finch,111,65,280,291,195,178,169,226
../../CUB_200_2011/images\035.Purple_Finch/Purple_Finch_0117_27427.jpg,262,500,035.Purple_Finch,110,165,263,318,186,241,153,153
../../CUB_200_2011/images\035.Purple_Finch/Purple_Finch_0081_27913.jpg,375,500,035.Purple_Finch,1,84,339,375,170,229,338,291
../../CUB_200_2011/images\035.Purple_Finch/Purple_Finch_0033_27926.jpg,500,334,035.Purple_Finch,256,85,471,313,363,199,215,228
../../CUB_200_2011/images\035.Purple_Finch/Purple_Finch_0133_27928.jpg,500,333,035.Purple_Finch,190,47,301,305,245,176,111,258
../../CUB_200_2011/images\035.Purple_Finch/Purple_Finch_0091_27425.jpg,500,325,035.Purple_Finch,48,91,303,285,175,188,255,194
../../CUB_200_2011/images\035.Purple_Finch/Purple_Finch_0006_27950.jpg,500,500,035.Purple_Finch,214,99,447,243,330,171,233,144
../../CUB_200_2011/images\035.Purple_Finch/Purple_Finch_0076_27441.jpg,500,334,035.Purple_Finch,17,62,413,302,215,182,396,240
../../CUB_200_2011/images\035.Purple_Finch/Purple_Finch_0071_27443.jpg,500,363,035.Purple_Finch,67,72,470,321,268,196,403,249
../../CUB_200_2011/images\035.Purple_Finch/Purple_Finch_0020_27961.jpg,500,375,035.Purple_Finch,48,108,345,285,196,196,297,177
../../CUB_200_2011/images\035.Purple_Finch/Purple_Finch_0059_27966.jpg,500,344,035.Purple_Finch,88,32,331,267,209,149,243,235
../../CUB_200_2011/images\035.Purple_Finch/Purple_Finch_0008_27455.jpg,500,359,035.Purple_Finch,1,89,401,333,201,211,400,244
../../CUB_200_2011/images\035.Purple_Finch/Purple_Finch_0035_27972.jpg,500,375,035.Purple_Finch,125,108,297,259,211,183,172,151
../../CUB_200_2011/images\035.Purple_Finch/Purple_Finch_0103_27461.jpg,500,500,035.Purple_Finch,73,75,303,424,188,249,230,349
../../CUB_200_2011/images\035.Purple_Finch/Purple_Finch_0065_27473.jpg,500,348,035.Purple_Finch,71,70,333,304,202,187,262,234
../../CUB_200_2011/images\035.Purple_Finch/Purple_Finch_0013_27506.jpg,500,400,035.Purple_Finch,106,69,365,353,235,211,259,284
../../CUB_200_2011/images\035.Purple_Finch/Purple_Finch_0049_27507.jpg,500,332,035.Purple_Finch,128,57,427,330,277,193,299,273
../../CUB_200_2011/images\035.Purple_Finch/Purple_Finch_0005_27512.jpg,500,383,035.Purple_Finch,103,83,279,268,191,175,176,185
../../CUB_200_2011/images\035.Purple_Finch/Purple_Finch_0134_27526.jpg,500,500,035.Purple_Finch,100,136,381,346,240,241,281,210
../../CUB_200_2011/images\035.Purple_Finch/Purple_Finch_0053_27543.jpg,500,350,035.Purple_Finch,15,95,429,311,222,203,414,216
../../CUB_200_2011/images\035.Purple_Finch/Purple_Finch_0113_27547.jpg,500,348,035.Purple_Finch,56,59,320,275,188,167,264,216
../../CUB_200_2011/images\035.Purple_Finch/Purple_Finch_0130_27555.jpg,500,335,035.Purple_Finch,33,36,356,299,194,167,323,263
../../CUB_200_2011/images\035.Purple_Finch/Purple_Finch_0011_27633.jpg,333,500,035.Purple_Finch,135,253,248,367,191,310,113,114
../../CUB_200_2011/images\035.Purple_Finch/Purple_Finch_0088_28076.jpg,500,375,035.Purple_Finch,158,44,419,339,288,191,261,295
../../CUB_200_2011/images\035.Purple_Finch/Purple_Finch_0004_27565.jpg,500,333,035.Purple_Finch,148,91,499,322,323,206,351,231
../../CUB_200_2011/images\035.Purple_Finch/Purple_Finch_0124_27567.jpg,500,463,035.Purple_Finch,18,147,330,320,174,233,312,173
../../CUB_200_2011/images\035.Purple_Finch/Purple_Finch_0104_28088.jpg,500,340,035.Purple_Finch,150,65,336,285,243,175,186,220
../../CUB_200_2011/images\035.Purple_Finch/Purple_Finch_0074_28101.jpg,500,357,035.Purple_Finch,90,44,458,321,274,182,368,277
../../CUB_200_2011/images\035.Purple_Finch/Purple_Finch_0120_27597.jpg,500,400,035.Purple_Finch,131,43,390,365,260,204,259,322
../../CUB_200_2011/images\035.Purple_Finch/Purple_Finch_0118_27604.jpg,500,333,035.Purple_Finch,232,120,337,251,284,185,105,131
../../CUB_200_2011/images\035.Purple_Finch/Purple_Finch_0043_28117.jpg,400,500,035.Purple_Finch,66,61,249,410,157,235,183,349
../../CUB_200_2011/images\035.Purple_Finch/Purple_Finch_0106_27607.jpg,333,500,035.Purple_Finch,55,104,300,410,177,257,245,306
../../CUB_200_2011/images\035.Purple_Finch/Purple_Finch_0023_27986.jpg,500,314,035.Purple_Finch,49,120,230,222,139,171,181,102
../../CUB_200_2011/images\035.Purple_Finch/Purple_Finch_0108_28143.jpg,372,500,035.Purple_Finch,115,116,256,342,185,229,141,226
../../CUB_200_2011/images\035.Purple_Finch/Purple_Finch_0067_27431.jpg,500,195,035.Purple_Finch,114,48,291,165,202,106,177,117
../../CUB_200_2011/images\035.Purple_Finch/Purple_Finch_0086_27637.jpg,500,333,035.Purple_Finch,129,96,297,311,213,203,168,215
../../CUB_200_2011/images\035.Purple_Finch/Purple_Finch_0082_27639.jpg,500,333,035.Purple_Finch,118,97,295,281,206,189,177,184
../../CUB_200_2011/images\035.Purple_Finch/Purple_Finch_0036_27641.jpg,500,363,035.Purple_Finch,94,119,447,299,270,209,353,180
../../CUB_200_2011/images\036.Northern_Flicker/Northern_Flicker_0072_28678.jpg,369,500,036.Northern_Flicker,116,140,252,471,184,305,136,331
../../CUB_200_2011/images\036.Northern_Flicker/Northern_Flicker_0036_28681.jpg,496,500,036.Northern_Flicker,71,119,445,392,258,255,374,273
../../CUB_200_2011/images\036.Northern_Flicker/Northern_Flicker_0041_28697.jpg,500,333,036.Northern_Flicker,45,38,336,275,190,156,291,237
../../CUB_200_2011/images\036.Northern_Flicker/Northern_Flicker_0093_28700.jpg,500,353,036.Northern_Flicker,45,58,385,320,215,189,340,262
../../CUB_200_2011/images\036.Northern_Flicker/Northern_Flicker_0094_28726.jpg,500,399,036.Northern_Flicker,151,77,299,362,225,219,148,285
../../CUB_200_2011/images\036.Northern_Flicker/Northern_Flicker_0075_28729.jpg,500,500,036.Northern_Flicker,96,134,373,401,234,267,277,267
../../CUB_200_2011/images\036.Northern_Flicker/Northern_Flicker_0034_28740.jpg,500,333,036.Northern_Flicker,175,51,349,329,262,190,174,278
../../CUB_200_2011/images\036.Northern_Flicker/Northern_Flicker_0021_28741.jpg,500,375,036.Northern_Flicker,42,83,416,317,229,200,374,234
../../CUB_200_2011/images\036.Northern_Flicker/Northern_Flicker_0037_28751.jpg,500,333,036.Northern_Flicker,110,19,346,311,228,165,236,292
../../CUB_200_2011/images\036.Northern_Flicker/Northern_Flicker_0050_28284.jpg,500,500,036.Northern_Flicker,67,54,418,442,242,248,351,388
../../CUB_200_2011/images\036.Northern_Flicker/Northern_Flicker_0091_28799.jpg,375,500,036.Northern_Flicker,71,64,232,461,151,262,161,397
../../CUB_200_2011/images\036.Northern_Flicker/Northern_Flicker_0006_28290.jpg,300,450,036.Northern_Flicker,5,126,261,312,133,219,256,186
../../CUB_200_2011/images\036.Northern_Flicker/Northern_Flicker_0135_28291.jpg,375,500,036.Northern_Flicker,6,104,358,434,182,269,352,330
../../CUB_200_2011/images\036.Northern_Flicker/Northern_Flicker_0099_28312.jpg,500,304,036.Northern_Flicker,195,103,420,272,307,187,225,169
../../CUB_200_2011/images\036.Northern_Flicker/Northern_Flicker_0132_28313.jpg,500,500,036.Northern_Flicker,193,91,328,395,260,243,135,304
../../CUB_200_2011/images\036.Northern_Flicker/Northern_Flicker_0084_28318.jpg,500,375,036.Northern_Flicker,24,31,393,347,208,189,369,316
../../CUB_200_2011/images\036.Northern_Flicker/Northern_Flicker_0105_28836.jpg,500,328,036.Northern_Flicker,180,33,440,326,310,179,260,293
../../CUB_200_2011/images\036.Northern_Flicker/Northern_Flicker_0068_28330.jpg,500,333,036.Northern_Flicker,88,124,375,299,231,211,287,175
../../CUB_200_2011/images\036.Northern_Flicker/Northern_Flicker_0035_28332.jpg,364,500,036.Northern_Flicker,56,67,220,456,138,261,164,389
../../CUB_200_2011/images\036.Northern_Flicker/Northern_Flicker_0078_28338.jpg,500,333,036.Northern_Flicker,197,101,404,263,300,182,207,162
../../CUB_200_2011/images\036.Northern_Flicker/Northern_Flicker_0077_28341.jpg,358,500,036.Northern_Flicker,71,57,271,478,171,267,200,421
../../CUB_200_2011/images\036.Northern_Flicker/Northern_Flicker_0055_28344.jpg,288,500,036.Northern_Flicker,69,24,257,486,163,255,188,462
../../CUB_200_2011/images\036.Northern_Flicker/Northern_Flicker_0086_28360.jpg,416,500,036.Northern_Flicker,94,98,350,464,222,281,256,366
../../CUB_200_2011/images\036.Northern_Flicker/Northern_Flicker_0104_28371.jpg,332,500,036.Northern_Flicker,108,145,209,336,158,240,101,191
../../CUB_200_2011/images\036.Northern_Flicker/Northern_Flicker_0085_28378.jpg,500,393,036.Northern_Flicker,50,191,276,362,163,276,226,171
../../CUB_200_2011/images\036.Northern_Flicker/Northern_Flicker_0123_28381.jpg,500,375,036.Northern_Flicker,148,88,377,374,262,231,229,286
../../CUB_200_2011/images\036.Northern_Flicker/Northern_Flicker_0004_28854.jpg,500,463,036.Northern_Flicker,200,73,370,432,285,252,170,359
../../CUB_200_2011/images\036.Northern_Flicker/Northern_Flicker_0100_28898.jpg,401,500,036.Northern_Flicker,107,129,346,381,226,255,239,252
../../CUB_200_2011/images\036.Northern_Flicker/Northern_Flicker_0046_28391.jpg,500,375,036.Northern_Flicker,57,87,390,274,223,180,333,187
../../CUB_200_2011/images\036.Northern_Flicker/Northern_Flicker_0054_28913.jpg,500,332,036.Northern_Flicker,5,20,492,328,248,174,487,308
../../CUB_200_2011/images\036.Northern_Flicker/Northern_Flicker_0111_28402.jpg,500,338,036.Northern_Flicker,51,69,498,329,274,199,447,260
../../CUB_200_2011/images\036.Northern_Flicker/Northern_Flicker_0136_28918.jpg,500,331,036.Northern_Flicker,175,140,287,285,231,212,112,145
../../CUB_200_2011/images\036.Northern_Flicker/Northern_Flicker_0139_28419.jpg,449,500,036.Northern_Flicker,88,80,289,417,188,248,201,337
../../CUB_200_2011/images\036.Northern_Flicker/Northern_Flicker_0095_28938.jpg,400,500,036.Northern_Flicker,73,134,352,390,212,262,279,256
../../CUB_200_2011/images\036.Northern_Flicker/Northern_Flicker_0022_28952.jpg,500,401,036.Northern_Flicker,113,67,269,385,191,226,156,318
../../CUB_200_2011/images\036.Northern_Flicker/Northern_Flicker_0106_28441.jpg,500,333,036.Northern_Flicker,118,57,483,269,300,163,365,212
../../CUB_200_2011/images\036.Northern_Flicker/Northern_Flicker_0053_28445.jpg,500,375,036.Northern_Flicker,58,121,341,370,199,245,283,249
../../CUB_200_2011/images\036.Northern_Flicker/Northern_Flicker_0045_28805.jpg,500,333,036.Northern_Flicker,5,89,413,317,209,203,408,228
../../CUB_200_2011/images\036.Northern_Flicker/Northern_Flicker_0131_28962.jpg,500,377,036.Northern_Flicker,218,157,342,333,280,245,124,176
../../CUB_200_2011/images\036.Northern_Flicker/Northern_Flicker_0124_28966.jpg,476,500,036.Northern_Flicker,44,112,315,362,179,237,271,250
../../CUB_200_2011/images\036.Northern_Flicker/Northern_Flicker_0011_28466.jpg,500,357,036.Northern_Flicker,63,108,366,305,214,206,303,197
../../CUB_200_2011/images\036.Northern_Flicker/Northern_Flicker_0138_28476.jpg,500,334,036.Northern_Flicker,23,43,291,305,157,174,268,262
../../CUB_200_2011/images\036.Northern_Flicker/Northern_Flicker_0125_28485.jpg,500,386,036.Northern_Flicker,24,45,370,335,197,190,346,290
../../CUB_200_2011/images\036.Northern_Flicker/Northern_Flicker_0059_28488.jpg,342,500,036.Northern_Flicker,83,54,265,475,174,264,182,421
../../CUB_200_2011/images\036.Northern_Flicker/Northern_Flicker_0090_28491.jpg,500,361,036.Northern_Flicker,48,83,273,316,160,199,225,233
../../CUB_200_2011/images\036.Northern_Flicker/Northern_Flicker_0118_28500.jpg,500,211,036.Northern_Flicker,206,15,473,169,339,92,267,154
../../CUB_200_2011/images\036.Northern_Flicker/Northern_Flicker_0108_28502.jpg,500,365,036.Northern_Flicker,249,153,488,361,368,257,239,208
../../CUB_200_2011/images\036.Northern_Flicker/Northern_Flicker_0129_29022.jpg,333,500,036.Northern_Flicker,68,111,328,470,198,290,260,359
../../CUB_200_2011/images\036.Northern_Flicker/Northern_Flicker_0024_29041.jpg,500,500,036.Northern_Flicker,195,79,362,457,278,268,167,378
../../CUB_200_2011/images\036.Northern_Flicker/Northern_Flicker_0008_28591.jpg,400,500,036.Northern_Flicker,101,79,306,474,203,276,205,395
../../CUB_200_2011/images\036.Northern_Flicker/Northern_Flicker_0044_28592.jpg,500,333,036.Northern_Flicker,21,72,314,300,167,186,293,228
../../CUB_200_2011/images\036.Northern_Flicker/Northern_Flicker_0110_28602.jpg,458,500,036.Northern_Flicker,49,38,391,472,220,255,342,434
../../CUB_200_2011/images\036.Northern_Flicker/Northern_Flicker_0016_28603.jpg,500,373,036.Northern_Flicker,51,103,288,308,169,205,237,205
../../CUB_200_2011/images\036.Northern_Flicker/Northern_Flicker_0057_28606.jpg,500,333,036.Northern_Flicker,53,17,426,332,239,174,373,315
../../CUB_200_2011/images\036.Northern_Flicker/Northern_Flicker_0096_28623.jpg,333,500,036.Northern_Flicker,56,78,233,473,144,275,177,395
../../CUB_200_2011/images\036.Northern_Flicker/Northern_Flicker_0079_28630.jpg,431,500,036.Northern_Flicker,113,209,249,354,181,281,136,145
../../CUB_200_2011/images\036.Northern_Flicker/Northern_Flicker_0127_28411.jpg,500,333,036.Northern_Flicker,39,41,414,277,226,159,375,236
../../CUB_200_2011/images\036.Northern_Flicker/Northern_Flicker_0069_28924.jpg,500,333,036.Northern_Flicker,123,75,359,256,241,165,236,181
../../CUB_200_2011/images\036.Northern_Flicker/Northern_Flicker_0051_28650.jpg,357,500,036.Northern_Flicker,93,64,294,468,193,266,201,404
../../CUB_200_2011/images\036.Northern_Flicker/Northern_Flicker_0107_28667.jpg,500,465,036.Northern_Flicker,117,139,473,455,295,297,356,316
../../CUB_200_2011/images\037.Acadian_Flycatcher/Acadian_Flycatcher_0066_29190.jpg,500,370,037.Acadian_Flycatcher,199,98,306,243,252,170,107,145
../../CUB_200_2011/images\037.Acadian_Flycatcher/Acadian_Flycatcher_0033_29195.jpg,500,333,037.Acadian_Flycatcher,182,109,318,258,250,183,136,149
../../CUB_200_2011/images\037.Acadian_Flycatcher/Acadian_Flycatcher_0067_29197.jpg,500,333,037.Acadian_Flycatcher,118,117,231,237,174,177,113,120
../../CUB_200_2011/images\037.Acadian_Flycatcher/Acadian_Flycatcher_0010_29199.jpg,500,375,037.Acadian_Flycatcher,193,117,429,299,311,208,236,182
../../CUB_200_2011/images\037.Acadian_Flycatcher/Acadian_Flycatcher_0022_29145.jpg,500,376,037.Acadian_Flycatcher,43,91,467,330,255,210,424,239
../../CUB_200_2011/images\037.Acadian_Flycatcher/Acadian_Flycatcher_0016_29217.jpg,382,500,037.Acadian_Flycatcher,78,193,195,391,136,292,117,198
../../CUB_200_2011/images\037.Acadian_Flycatcher/Acadian_Flycatcher_0013_29232.jpg,500,333,037.Acadian_Flycatcher,130,35,402,306,266,170,272,271
../../CUB_200_2011/images\037.Acadian_Flycatcher/Acadian_Flycatcher_0070_29150.jpg,420,280,037.Acadian_Flycatcher,120,31,383,258,251,144,263,227
../../CUB_200_2011/images\037.Acadian_Flycatcher/Acadian_Flycatcher_0009_29155.jpg,500,375,037.Acadian_Flycatcher,59,113,205,243,132,178,146,130
../../CUB_200_2011/images\037.Acadian_Flycatcher/Acadian_Flycatcher_0036_795577.jpg,500,333,037.Acadian_Flycatcher,195,31,433,209,314,120,238,178
../../CUB_200_2011/images\037.Acadian_Flycatcher/Acadian_Flycatcher_0069_795579.jpg,402,366,037.Acadian_Flycatcher,96,47,288,324,192,185,192,277
../../CUB_200_2011/images\037.Acadian_Flycatcher/Acadian_Flycatcher_0030_795591.jpg,400,300,037.Acadian_Flycatcher,131,41,260,294,195,167,129,253
../../CUB_200_2011/images\037.Acadian_Flycatcher/Acadian_Flycatcher_0020_29069.jpg,500,401,037.Acadian_Flycatcher,162,96,319,313,240,204,157,217
../../CUB_200_2011/images\037.Acadian_Flycatcher/Acadian_Flycatcher_0065_29070.jpg,500,355,037.Acadian_Flycatcher,7,0,403,231,205,115,396,231
../../CUB_200_2011/images\037.Acadian_Flycatcher/Acadian_Flycatcher_0051_29077.jpg,388,500,037.Acadian_Flycatcher,41,41,258,473,149,257,217,432
../../CUB_200_2011/images\037.Acadian_Flycatcher/Acadian_Flycatcher_0056_29086.jpg,500,358,037.Acadian_Flycatcher,155,94,295,317,225,205,140,223
../../CUB_200_2011/images\037.Acadian_Flycatcher/Acadian_Flycatcher_0003_29094.jpg,500,400,037.Acadian_Flycatcher,216,68,403,344,309,206,187,276
../../CUB_200_2011/images\037.Acadian_Flycatcher/Acadian_Flycatcher_0059_29102.jpg,500,333,037.Acadian_Flycatcher,80,90,272,329,176,209,192,239
../../CUB_200_2011/images\037.Acadian_Flycatcher/Acadian_Flycatcher_0054_29113.jpg,500,424,037.Acadian_Flycatcher,166,98,466,422,316,260,300,324
../../CUB_200_2011/images\037.Acadian_Flycatcher/Acadian_Flycatcher_0015_795578.jpg,230,174,037.Acadian_Flycatcher,16,28,192,154,104,91,176,126
../../CUB_200_2011/images\037.Acadian_Flycatcher/Acadian_Flycatcher_0043_29115.jpg,500,362,037.Acadian_Flycatcher,150,78,334,296,242,187,184,218
../../CUB_200_2011/images\037.Acadian_Flycatcher/Acadian_Flycatcher_0049_795580.jpg,500,357,037.Acadian_Flycatcher,44,97,271,287,157,192,227,190
../../CUB_200_2011/images\037.Acadian_Flycatcher/Acadian_Flycatcher_0031_795582.jpg,500,420,037.Acadian_Flycatcher,99,91,385,263,242,177,286,172
../../CUB_200_2011/images\037.Acadian_Flycatcher/Acadian_Flycatcher_0034_795583.jpg,400,285,037.Acadian_Flycatcher,99,48,248,221,173,134,149,173
../../CUB_200_2011/images\037.Acadian_Flycatcher/Acadian_Flycatcher_0064_795584.jpg,400,314,037.Acadian_Flycatcher,88,88,377,232,232,160,289,144
../../CUB_200_2011/images\037.Acadian_Flycatcher/Acadian_Flycatcher_0063_795585.jpg,500,332,037.Acadian_Flycatcher,120,36,243,281,181,158,123,245
../../CUB_200_2011/images\037.Acadian_Flycatcher/Acadian_Flycatcher_0045_795587.jpg,320,213,037.Acadian_Flycatcher,110,44,251,163,180,103,141,119
../../CUB_200_2011/images\037.Acadian_Flycatcher/Acadian_Flycatcher_0068_795590.jpg,409,500,037.Acadian_Flycatcher,52,45,286,476,169,260,234,431
../../CUB_200_2011/images\037.Acadian_Flycatcher/Acadian_Flycatcher_0042_29127.jpg,500,477,037.Acadian_Flycatcher,19,49,478,420,248,234,459,371
../../CUB_200_2011/images\037.Acadian_Flycatcher/Acadian_Flycatcher_0019_795592.jpg,500,346,037.Acadian_Flycatcher,182,45,409,321,295,183,227,276
../../CUB_200_2011/images\037.Acadian_Flycatcher/Acadian_Flycatcher_0047_795593.jpg,352,500,037.Acadian_Flycatcher,90,18,314,462,202,240,224,444
../../CUB_200_2011/images\037.Acadian_Flycatcher/Acadian_Flycatcher_0021_795594.jpg,500,370,037.Acadian_Flycatcher,198,151,391,284,294,217,193,133
../../CUB_200_2011/images\037.Acadian_Flycatcher/Acadian_Flycatcher_0006_795595.jpg,500,500,037.Acadian_Flycatcher,40,87,451,446,245,266,411,359
../../CUB_200_2011/images\037.Acadian_Flycatcher/Acadian_Flycatcher_0046_795596.jpg,275,260,037.Acadian_Flycatcher,99,31,218,244,158,137,119,213
../../CUB_200_2011/images\037.Acadian_Flycatcher/Acadian_Flycatcher_0017_795598.jpg,371,400,037.Acadian_Flycatcher,70,55,356,368,213,211,286,313
../../CUB_200_2011/images\037.Acadian_Flycatcher/Acadian_Flycatcher_0008_795599.jpg,368,500,037.Acadian_Flycatcher,25,134,250,426,137,280,225,292
../../CUB_200_2011/images\037.Acadian_Flycatcher/Acadian_Flycatcher_0007_795600.jpg,500,371,037.Acadian_Flycatcher,135,57,288,340,211,198,153,283
../../CUB_200_2011/images\037.Acadian_Flycatcher/Acadian_Flycatcher_0058_795602.jpg,140,160,037.Acadian_Flycatcher,11,25,133,142,72,83,122,117
../../CUB_200_2011/images\037.Acadian_Flycatcher/Acadian_Flycatcher_0072_795603.jpg,500,449,037.Acadian_Flycatcher,75,131,305,366,190,248,230,235
../../CUB_200_2011/images\037.Acadian_Flycatcher/Acadian_Flycatcher_0060_795604.jpg,500,365,037.Acadian_Flycatcher,224,54,458,301,341,177,234,247
../../CUB_200_2011/images\037.Acadian_Flycatcher/Acadian_Flycatcher_0041_795605.jpg,399,500,037.Acadian_Flycatcher,188,81,340,460,264,270,152,379
../../CUB_200_2011/images\037.Acadian_Flycatcher/Acadian_Flycatcher_0039_795606.jpg,500,375,037.Acadian_Flycatcher,139,51,398,361,268,206,259,310
../../CUB_200_2011/images\037.Acadian_Flycatcher/Acadian_Flycatcher_0014_795607.jpg,395,500,037.Acadian_Flycatcher,65,66,272,458,168,262,207,392
../../CUB_200_2011/images\037.Acadian_Flycatcher/Acadian_Flycatcher_0050_795608.jpg,494,500,037.Acadian_Flycatcher,14,23,446,484,230,253,432,461
../../CUB_200_2011/images\037.Acadian_Flycatcher/Acadian_Flycatcher_0055_795609.jpg,500,342,037.Acadian_Flycatcher,183,35,388,314,285,174,205,279
../../CUB_200_2011/images\037.Acadian_Flycatcher/Acadian_Flycatcher_0052_795610.jpg,325,488,037.Acadian_Flycatcher,49,166,253,388,151,277,204,222
../../CUB_200_2011/images\037.Acadian_Flycatcher/Acadian_Flycatcher_0028_795611.jpg,500,350,037.Acadian_Flycatcher,92,80,339,314,215,197,247,234
../../CUB_200_2011/images\037.Acadian_Flycatcher/Acadian_Flycatcher_0012_795612.jpg,386,500,037.Acadian_Flycatcher,82,82,310,439,196,260,228,357
../../CUB_200_2011/images\037.Acadian_Flycatcher/Acadian_Flycatcher_0038_795616.jpg,359,400,037.Acadian_Flycatcher,75,94,328,272,201,183,253,178
../../CUB_200_2011/images\037.Acadian_Flycatcher/Acadian_Flycatcher_0035_795618.jpg,500,360,037.Acadian_Flycatcher,195,76,344,273,269,174,149,197
../../CUB_200_2011/images\037.Acadian_Flycatcher/Acadian_Flycatcher_0053_795620.jpg,350,500,037.Acadian_Flycatcher,30,118,283,334,156,226,253,216
../../CUB_200_2011/images\037.Acadian_Flycatcher/Acadian_Flycatcher_0005_29157.jpg,391,500,037.Acadian_Flycatcher,126,101,369,309,247,205,243,208
../../CUB_200_2011/images\037.Acadian_Flycatcher/Acadian_Flycatcher_0032_795622.jpg,500,375,037.Acadian_Flycatcher,24,64,490,331,257,197,466,267
../../CUB_200_2011/images\037.Acadian_Flycatcher/Acadian_Flycatcher_0004_795623.jpg,288,216,037.Acadian_Flycatcher,92,18,214,214,153,116,122,196
../../CUB_200_2011/images\037.Acadian_Flycatcher/Acadian_Flycatcher_0044_795624.jpg,400,500,037.Acadian_Flycatcher,113,70,284,406,198,238,171,336
../../CUB_200_2011/images\037.Acadian_Flycatcher/Acadian_Flycatcher_0071_795627.jpg,256,292,037.Acadian_Flycatcher,16,26,241,283,128,154,225,257
../../CUB_200_2011/images\037.Acadian_Flycatcher/Acadian_Flycatcher_0073_795628.jpg,500,500,037.Acadian_Flycatcher,144,24,370,477,257,250,226,453
../../CUB_200_2011/images\037.Acadian_Flycatcher/Acadian_Flycatcher_0040_795629.jpg,400,287,037.Acadian_Flycatcher,143,69,298,219,220,144,155,150
../../CUB_200_2011/images\037.Acadian_Flycatcher/Acadian_Flycatcher_0024_29173.jpg,500,415,037.Acadian_Flycatcher,234,170,453,374,343,272,219,204
../../CUB_200_2011/images\038.Great_Crested_Flycatcher/Great_Crested_Flycatcher_0028_29696.jpg,500,333,038.Great_Crested_Flycatcher,47,66,401,301,224,183,354,235
../../CUB_200_2011/images\038.Great_Crested_Flycatcher/Great_Crested_Flycatcher_0004_29701.jpg,500,301,038.Great_Crested_Flycatcher,221,125,338,233,279,179,117,108
../../CUB_200_2011/images\038.Great_Crested_Flycatcher/Great_Crested_Flycatcher_0108_29712.jpg,500,497,038.Great_Crested_Flycatcher,167,133,352,439,259,286,185,306
../../CUB_200_2011/images\038.Great_Crested_Flycatcher/Great_Crested_Flycatcher_0084_29716.jpg,500,396,038.Great_Crested_Flycatcher,152,79,364,329,258,204,212,250
../../CUB_200_2011/images\038.Great_Crested_Flycatcher/Great_Crested_Flycatcher_0040_29447.jpg,500,405,038.Great_Crested_Flycatcher,63,50,437,352,250,201,374,302
../../CUB_200_2011/images\038.Great_Crested_Flycatcher/Great_Crested_Flycatcher_0038_29533.jpg,500,333,038.Great_Crested_Flycatcher,145,103,468,293,306,198,323,190
../../CUB_200_2011/images\038.Great_Crested_Flycatcher/Great_Crested_Flycatcher_0087_29252.jpg,386,500,038.Great_Crested_Flycatcher,74,100,347,472,210,286,273,372
../../CUB_200_2011/images\038.Great_Crested_Flycatcher/Great_Crested_Flycatcher_0012_29264.jpg,464,500,038.Great_Crested_Flycatcher,72,24,448,483,260,253,376,459
../../CUB_200_2011/images\038.Great_Crested_Flycatcher/Great_Crested_Flycatcher_0119_29778.jpg,500,376,038.Great_Crested_Flycatcher,173,65,405,331,289,198,232,266
../../CUB_200_2011/images\038.Great_Crested_Flycatcher/Great_Crested_Flycatcher_0050_29786.jpg,334,500,038.Great_Crested_Flycatcher,51,129,276,379,163,254,225,250
../../CUB_200_2011/images\038.Great_Crested_Flycatcher/Great_Crested_Flycatcher_0070_29455.jpg,362,500,038.Great_Crested_Flycatcher,127,128,251,459,189,293,124,331
../../CUB_200_2011/images\038.Great_Crested_Flycatcher/Great_Crested_Flycatcher_0007_29280.jpg,500,498,038.Great_Crested_Flycatcher,68,42,422,476,245,259,354,434
../../CUB_200_2011/images\038.Great_Crested_Flycatcher/Great_Crested_Flycatcher_0105_29456.jpg,425,500,038.Great_Crested_Flycatcher,105,117,284,382,194,249,179,265
../../CUB_200_2011/images\038.Great_Crested_Flycatcher/Great_Crested_Flycatcher_0019_29801.jpg,499,500,038.Great_Crested_Flycatcher,49,38,398,448,223,243,349,410
../../CUB_200_2011/images\038.Great_Crested_Flycatcher/Great_Crested_Flycatcher_0124_29294.jpg,500,356,038.Great_Crested_Flycatcher,112,121,486,286,299,203,374,165
../../CUB_200_2011/images\038.Great_Crested_Flycatcher/Great_Crested_Flycatcher_0061_29807.jpg,313,500,038.Great_Crested_Flycatcher,72,82,231,466,151,274,159,384
../../CUB_200_2011/images\038.Great_Crested_Flycatcher/Great_Crested_Flycatcher_0132_29300.jpg,500,333,038.Great_Crested_Flycatcher,94,40,450,317,272,178,356,277
../../CUB_200_2011/images\038.Great_Crested_Flycatcher/Great_Crested_Flycatcher_0139_29302.jpg,500,377,038.Great_Crested_Flycatcher,184,111,318,302,251,206,134,191
../../CUB_200_2011/images\038.Great_Crested_Flycatcher/Great_Crested_Flycatcher_0099_29305.jpg,500,374,038.Great_Crested_Flycatcher,16,46,472,328,244,187,456,282
../../CUB_200_2011/images\038.Great_Crested_Flycatcher/Great_Crested_Flycatcher_0031_29825.jpg,500,334,038.Great_Crested_Flycatcher,203,109,399,247,301,178,196,138
../../CUB_200_2011/images\038.Great_Crested_Flycatcher/Great_Crested_Flycatcher_0133_29314.jpg,498,500,038.Great_Crested_Flycatcher,132,79,389,397,260,238,257,318
../../CUB_200_2011/images\038.Great_Crested_Flycatcher/Great_Crested_Flycatcher_0009_29831.jpg,500,494,038.Great_Crested_Flycatcher,193,188,387,351,290,269,194,163
../../CUB_200_2011/images\038.Great_Crested_Flycatcher/Great_Crested_Flycatcher_0131_29329.jpg,500,357,038.Great_Crested_Flycatcher,109,90,232,266,170,178,123,176
../../CUB_200_2011/images\038.Great_Crested_Flycatcher/Great_Crested_Flycatcher_0073_29330.jpg,422,500,038.Great_Crested_Flycatcher,121,110,361,392,241,251,240,282
../../CUB_200_2011/images\038.Great_Crested_Flycatcher/Great_Crested_Flycatcher_0067_29384.jpg,500,352,038.Great_Crested_Flycatcher,155,52,316,244,235,148,161,192
../../CUB_200_2011/images\038.Great_Crested_Flycatcher/Great_Crested_Flycatcher_0006_29362.jpg,500,333,038.Great_Crested_Flycatcher,124,118,303,331,213,224,179,213
../../CUB_200_2011/images\038.Great_Crested_Flycatcher/Great_Crested_Flycatcher_0085_29812.jpg,399,500,038.Great_Crested_Flycatcher,125,115,278,351,201,233,153,236
../../CUB_200_2011/images\038.Great_Crested_Flycatcher/Great_Crested_Flycatcher_0120_29472.jpg,500,479,038.Great_Crested_Flycatcher,221,186,377,431,299,308,156,245
../../CUB_200_2011/images\038.Great_Crested_Flycatcher/Great_Crested_Flycatcher_0049_29474.jpg,466,500,038.Great_Crested_Flycatcher,30,106,390,396,210,251,360,290
../../CUB_200_2011/images\038.Great_Crested_Flycatcher/Great_Crested_Flycatcher_0010_29396.jpg,338,500,038.Great_Crested_Flycatcher,53,78,227,352,140,215,174,274
../../CUB_200_2011/images\038.Great_Crested_Flycatcher/Great_Crested_Flycatcher_0097_29398.jpg,367,500,038.Great_Crested_Flycatcher,109,101,310,360,209,230,201,259
../../CUB_200_2011/images\038.Great_Crested_Flycatcher/Great_Crested_Flycatcher_0016_29406.jpg,500,461,038.Great_Crested_Flycatcher,154,110,353,289,253,199,199,179
../../CUB_200_2011/images\038.Great_Crested_Flycatcher/Great_Crested_Flycatcher_0068_29416.jpg,458,500,038.Great_Crested_Flycatcher,90,62,368,449,229,255,278,387
../../CUB_200_2011/images\038.Great_Crested_Flycatcher/Great_Crested_Flycatcher_0021_29929.jpg,500,354,038.Great_Crested_Flycatcher,146,35,301,336,223,185,155,301
../../CUB_200_2011/images\038.Great_Crested_Flycatcher/Great_Crested_Flycatcher_0042_29438.jpg,500,402,038.Great_Crested_Flycatcher,107,130,257,338,182,234,150,208
../../CUB_200_2011/images\038.Great_Crested_Flycatcher/Great_Crested_Flycatcher_0082_29445.jpg,500,333,038.Great_Crested_Flycatcher,166,100,483,286,324,193,317,186
../../CUB_200_2011/images\038.Great_Crested_Flycatcher/Great_Crested_Flycatcher_0033_29959.jpg,500,333,038.Great_Crested_Flycatcher,88,85,434,279,261,182,346,194
../../CUB_200_2011/images\038.Great_Crested_Flycatcher/Great_Crested_Flycatcher_0023_29481.jpg,390,500,038.Great_Crested_Flycatcher,21,215,276,406,148,310,255,191
../../CUB_200_2011/images\038.Great_Crested_Flycatcher/Great_Crested_Flycatcher_0044_29995.jpg,500,375,038.Great_Crested_Flycatcher,213,47,428,313,320,180,215,266
../../CUB_200_2011/images\038.Great_Crested_Flycatcher/Great_Crested_Flycatcher_0066_29488.jpg,500,375,038.Great_Crested_Flycatcher,265,113,380,344,322,228,115,231
../../CUB_200_2011/images\038.Great_Crested_Flycatcher/Great_Crested_Flycatcher_0136_29490.jpg,377,500,038.Great_Crested_Flycatcher,39,27,368,475,203,251,329,448
../../CUB_200_2011/images\038.Great_Crested_Flycatcher/Great_Crested_Flycatcher_0013_29496.jpg,403,500,038.Great_Crested_Flycatcher,19,57,356,488,187,272,337,431
../../CUB_200_2011/images\038.Great_Crested_Flycatcher/Great_Crested_Flycatcher_0107_29501.jpg,440,500,038.Great_Crested_Flycatcher,70,92,370,484,220,288,300,392
../../CUB_200_2011/images\038.Great_Crested_Flycatcher/Great_Crested_Flycatcher_0063_29507.jpg,500,333,038.Great_Crested_Flycatcher,272,138,404,268,338,203,132,130
../../CUB_200_2011/images\038.Great_Crested_Flycatcher/Great_Crested_Flycatcher_0024_29516.jpg,334,500,038.Great_Crested_Flycatcher,76,115,288,405,182,260,212,290
../../CUB_200_2011/images\038.Great_Crested_Flycatcher/Great_Crested_Flycatcher_0086_29518.jpg,400,500,038.Great_Crested_Flycatcher,85,81,287,406,186,243,202,325
../../CUB_200_2011/images\038.Great_Crested_Flycatcher/Great_Crested_Flycatcher_0041_29521.jpg,486,500,038.Great_Crested_Flycatcher,12,89,377,407,194,248,365,318
../../CUB_200_2011/images\038.Great_Crested_Flycatcher/Great_Crested_Flycatcher_0058_29523.jpg,377,500,038.Great_Crested_Flycatcher,34,43,363,490,198,266,329,447
../../CUB_200_2011/images\038.Great_Crested_Flycatcher/Great_Crested_Flycatcher_0051_29530.jpg,500,454,038.Great_Crested_Flycatcher,37,44,317,415,177,229,280,371
../../CUB_200_2011/images\038.Great_Crested_Flycatcher/Great_Crested_Flycatcher_0027_29532.jpg,333,500,038.Great_Crested_Flycatcher,35,99,258,444,146,271,223,345
../../CUB_200_2011/images\038.Great_Crested_Flycatcher/Great_Crested_Flycatcher_0111_29543.jpg,402,500,038.Great_Crested_Flycatcher,147,93,307,395,227,244,160,302
../../CUB_200_2011/images\038.Great_Crested_Flycatcher/Great_Crested_Flycatcher_0064_29546.jpg,500,324,038.Great_Crested_Flycatcher,182,80,364,231,273,155,182,151
../../CUB_200_2011/images\038.Great_Crested_Flycatcher/Great_Crested_Flycatcher_0074_29553.jpg,357,500,038.Great_Crested_Flycatcher,78,14,338,499,208,256,260,485
../../CUB_200_2011/images\038.Great_Crested_Flycatcher/Great_Crested_Flycatcher_0092_29583.jpg,419,500,038.Great_Crested_Flycatcher,161,62,282,447,221,254,121,385
../../CUB_200_2011/images\038.Great_Crested_Flycatcher/Great_Crested_Flycatcher_0048_29586.jpg,457,500,038.Great_Crested_Flycatcher,137,97,267,337,202,217,130,240
../../CUB_200_2011/images\038.Great_Crested_Flycatcher/Great_Crested_Flycatcher_0089_29592.jpg,500,375,038.Great_Crested_Flycatcher,115,100,308,345,211,222,193,245
../../CUB_200_2011/images\038.Great_Crested_Flycatcher/Great_Crested_Flycatcher_0125_29593.jpg,355,500,038.Great_Crested_Flycatcher,44,81,326,445,185,263,282,364
../../CUB_200_2011/images\038.Great_Crested_Flycatcher/Great_Crested_Flycatcher_0069_29603.jpg,500,500,038.Great_Crested_Flycatcher,38,108,404,382,221,245,366,274
../../CUB_200_2011/images\038.Great_Crested_Flycatcher/Great_Crested_Flycatcher_0030_29645.jpg,472,372,038.Great_Crested_Flycatcher,55,93,332,289,193,191,277,196
../../CUB_200_2011/images\038.Great_Crested_Flycatcher/Great_Crested_Flycatcher_0036_29693.jpg,500,423,038.Great_Crested_Flycatcher,35,11,385,419,210,215,350,408
../../CUB_200_2011/images\039.Least_Flycatcher/Least_Flycatcher_0036_30213.jpg,400,500,039.Least_Flycatcher,54,84,245,340,149,212,191,256
../../CUB_200_2011/images\039.Least_Flycatcher/Least_Flycatcher_0060_30214.jpg,375,500,039.Least_Flycatcher,66,65,303,415,184,240,237,350
../../CUB_200_2011/images\039.Least_Flycatcher/Least_Flycatcher_0001_30221.jpg,393,500,039.Least_Flycatcher,103,45,348,470,225,257,245,425
../../CUB_200_2011/images\039.Least_Flycatcher/Least_Flycatcher_0011_30222.jpg,400,500,039.Least_Flycatcher,86,129,258,323,172,226,172,194
../../CUB_200_2011/images\039.Least_Flycatcher/Least_Flycatcher_0024_30230.jpg,410,500,039.Least_Flycatcher,93,105,327,406,210,255,234,301
../../CUB_200_2011/images\039.Least_Flycatcher/Least_Flycatcher_0096_30233.jpg,333,500,039.Least_Flycatcher,122,114,267,438,194,276,145,324
../../CUB_200_2011/images\039.Least_Flycatcher/Least_Flycatcher_0013_30240.jpg,379,500,039.Least_Flycatcher,30,123,285,469,157,296,255,346
../../CUB_200_2011/images\039.Least_Flycatcher/Least_Flycatcher_0079_30256.jpg,500,423,039.Least_Flycatcher,193,71,388,377,290,224,195,306
../../CUB_200_2011/images\039.Least_Flycatcher/Least_Flycatcher_0006_30262.jpg,500,497,039.Least_Flycatcher,184,109,307,388,245,248,123,279
../../CUB_200_2011/images\039.Least_Flycatcher/Least_Flycatcher_0034_30151.jpg,500,394,039.Least_Flycatcher,171,122,319,349,245,235,148,227
../../CUB_200_2011/images\039.Least_Flycatcher/Least_Flycatcher_0095_30277.jpg,500,315,039.Least_Flycatcher,37,118,209,269,123,193,172,151
../../CUB_200_2011/images\039.Least_Flycatcher/Least_Flycatcher_0015_30280.jpg,354,500,039.Least_Flycatcher,62,67,321,449,191,258,259,382
../../CUB_200_2011/images\039.Least_Flycatcher/Least_Flycatcher_0057_30282.jpg,399,500,039.Least_Flycatcher,111,139,301,448,206,293,190,309
../../CUB_200_2011/images\039.Least_Flycatcher/Least_Flycatcher_0077_30296.jpg,417,500,039.Least_Flycatcher,130,73,346,442,238,257,216,369
../../CUB_200_2011/images\039.Least_Flycatcher/Least_Flycatcher_0009_30303.jpg,391,500,039.Least_Flycatcher,141,163,253,409,197,286,112,246
../../CUB_200_2011/images\039.Least_Flycatcher/Least_Flycatcher_0092_30154.jpg,333,500,039.Least_Flycatcher,97,143,202,373,149,258,105,230
../../CUB_200_2011/images\039.Least_Flycatcher/Least_Flycatcher_0046_30316.jpg,420,280,039.Least_Flycatcher,161,54,262,254,211,154,101,200
../../CUB_200_2011/images\039.Least_Flycatcher/Least_Flycatcher_0085_30318.jpg,500,423,039.Least_Flycatcher,248,47,408,364,328,205,160,317
../../CUB_200_2011/images\039.Least_Flycatcher/Least_Flycatcher_0052_30321.jpg,500,470,039.Least_Flycatcher,206,147,321,322,263,234,115,175
../../CUB_200_2011/images\039.Least_Flycatcher/Least_Flycatcher_0064_30328.jpg,500,395,039.Least_Flycatcher,151,98,427,319,289,208,276,221
../../CUB_200_2011/images\039.Least_Flycatcher/Least_Flycatcher_0100_30338.jpg,500,462,039.Least_Flycatcher,140,65,463,461,301,263,323,396
../../CUB_200_2011/images\039.Least_Flycatcher/Least_Flycatcher_0007_30339.jpg,500,419,039.Least_Flycatcher,145,107,354,368,249,237,209,261
../../CUB_200_2011/images\039.Least_Flycatcher/Least_Flycatcher_0044_30349.jpg,500,458,039.Least_Flycatcher,169,93,336,410,252,251,167,317
../../CUB_200_2011/images\039.Least_Flycatcher/Least_Flycatcher_0023_30352.jpg,500,456,039.Least_Flycatcher,158,129,305,428,231,278,147,299
../../CUB_200_2011/images\039.Least_Flycatcher/Least_Flycatcher_0021_30355.jpg,500,498,039.Least_Flycatcher,195,110,358,463,276,286,163,353
../../CUB_200_2011/images\039.Least_Flycatcher/Least_Flycatcher_0065_30357.jpg,500,357,039.Least_Flycatcher,113,85,260,311,186,198,147,226
../../CUB_200_2011/images\039.Least_Flycatcher/Least_Flycatcher_0019_30358.jpg,329,500,039.Least_Flycatcher,7,8,282,492,144,250,275,484
../../CUB_200_2011/images\039.Least_Flycatcher/Least_Flycatcher_0049_30361.jpg,500,333,039.Least_Flycatcher,152,91,452,279,302,185,300,188
../../CUB_200_2011/images\039.Least_Flycatcher/Least_Flycatcher_0029_30362.jpg,500,375,039.Least_Flycatcher,184,96,316,330,250,213,132,234
../../CUB_200_2011/images\039.Least_Flycatcher/Least_Flycatcher_0040_30366.jpg,500,470,039.Least_Flycatcher,134,111,320,334,227,222,186,223
../../CUB_200_2011/images\039.Least_Flycatcher/Least_Flycatcher_0076_30117.jpg,500,334,039.Least_Flycatcher,136,58,341,263,238,160,205,205
../../CUB_200_2011/images\039.Least_Flycatcher/Least_Flycatcher_0097_30122.jpg,500,334,039.Least_Flycatcher,179,51,308,280,243,165,129,229
../../CUB_200_2011/images\039.Least_Flycatcher/Least_Flycatcher_0087_30123.jpg,500,400,039.Least_Flycatcher,165,145,334,257,249,201,169,112
../../CUB_200_2011/images\039.Least_Flycatcher/Least_Flycatcher_0081_30380.jpg,500,357,039.Least_Flycatcher,172,86,333,294,252,190,161,208
../../CUB_200_2011/images\039.Least_Flycatcher/Least_Flycatcher_0038_30127.jpg,500,338,039.Least_Flycatcher,70,35,413,307,241,171,343,272
../../CUB_200_2011/images\039.Least_Flycatcher/Least_Flycatcher_0062_30131.jpg,388,500,039.Least_Flycatcher,93,136,324,481,208,308,231,345
../../CUB_200_2011/images\039.Least_Flycatcher/Least_Flycatcher_0047_30393.jpg,375,500,039.Least_Flycatcher,72,54,294,467,183,260,222,413
../../CUB_200_2011/images\039.Least_Flycatcher/Least_Flycatcher_0004_30140.jpg,500,459,039.Least_Flycatcher,69,27,483,445,276,236,414,418
../../CUB_200_2011/images\039.Least_Flycatcher/Least_Flycatcher_0067_30397.jpg,500,358,039.Least_Flycatcher,102,94,323,314,212,204,221,220
../../CUB_200_2011/images\039.Least_Flycatcher/Least_Flycatcher_0005_30142.jpg,500,361,039.Least_Flycatcher,69,94,368,339,218,216,299,245
../../CUB_200_2011/images\039.Least_Flycatcher/Least_Flycatcher_0058_30143.jpg,333,500,039.Least_Flycatcher,4,113,154,270,79,191,150,157
../../CUB_200_2011/images\039.Least_Flycatcher/Least_Flycatcher_0032_30146.jpg,401,500,039.Least_Flycatcher,125,101,316,388,220,244,191,287
../../CUB_200_2011/images\039.Least_Flycatcher/Least_Flycatcher_0070_30147.jpg,500,357,039.Least_Flycatcher,154,52,297,347,225,199,143,295
../../CUB_200_2011/images\039.Least_Flycatcher/Least_Flycatcher_0010_30149.jpg,500,428,039.Least_Flycatcher,221,68,420,357,320,212,199,289
../../CUB_200_2011/images\039.Least_Flycatcher/Least_Flycatcher_0059_30152.jpg,401,500,039.Least_Flycatcher,101,95,294,427,197,261,193,332
../../CUB_200_2011/images\039.Least_Flycatcher/Least_Flycatcher_0082_30132.jpg,500,400,039.Least_Flycatcher,57,85,392,398,224,241,335,313
../../CUB_200_2011/images\039.Least_Flycatcher/Least_Flycatcher_0061_30429.jpg,487,500,039.Least_Flycatcher,132,94,262,365,197,229,130,271
../../CUB_200_2011/images\039.Least_Flycatcher/Least_Flycatcher_0045_30174.jpg,500,375,039.Least_Flycatcher,198,35,318,284,258,159,120,249
../../CUB_200_2011/images\039.Least_Flycatcher/Least_Flycatcher_0026_30434.jpg,500,363,039.Least_Flycatcher,136,108,314,291,225,199,178,183
../../CUB_200_2011/images\039.Least_Flycatcher/Least_Flycatcher_0093_30435.jpg,500,496,039.Least_Flycatcher,100,86,242,435,171,260,142,349
../../CUB_200_2011/images\039.Least_Flycatcher/Least_Flycatcher_0075_30441.jpg,500,444,039.Least_Flycatcher,132,115,361,352,246,233,229,237
../../CUB_200_2011/images\039.Least_Flycatcher/Least_Flycatcher_0050_30189.jpg,397,500,039.Least_Flycatcher,124,151,336,460,230,305,212,309
../../CUB_200_2011/images\039.Least_Flycatcher/Least_Flycatcher_0063_30190.jpg,500,499,039.Least_Flycatcher,161,197,311,351,236,274,150,154
../../CUB_200_2011/images\039.Least_Flycatcher/Least_Flycatcher_0033_30449.jpg,483,500,039.Least_Flycatcher,95,153,351,378,223,265,256,225
../../CUB_200_2011/images\039.Least_Flycatcher/Least_Flycatcher_0054_30450.jpg,500,375,039.Least_Flycatcher,108,65,433,357,270,211,325,292
../../CUB_200_2011/images\039.Least_Flycatcher/Least_Flycatcher_0099_30200.jpg,500,357,039.Least_Flycatcher,16,80,233,339,124,209,217,259
../../CUB_200_2011/images\039.Least_Flycatcher/Least_Flycatcher_0080_30457.jpg,500,350,039.Least_Flycatcher,147,73,334,329,240,201,187,256
../../CUB_200_2011/images\039.Least_Flycatcher/Least_Flycatcher_0017_30460.jpg,500,277,039.Least_Flycatcher,218,129,497,269,357,199,279,140
../../CUB_200_2011/images\039.Least_Flycatcher/Least_Flycatcher_0018_30462.jpg,400,500,039.Least_Flycatcher,98,176,289,320,193,248,191,144
../../CUB_200_2011/images\040.Olive_sided_Flycatcher/Olive_Sided_Flycatcher_0041_30470.jpg,396,478,040.Olive_sided_Flycatcher,78,69,383,472,230,270,305,403
../../CUB_200_2011/images\040.Olive_sided_Flycatcher/Olive_Sided_Flycatcher_0054_30732.jpg,500,375,040.Olive_sided_Flycatcher,179,32,349,316,264,174,170,284
../../CUB_200_2011/images\040.Olive_sided_Flycatcher/Olive_Sided_Flycatcher_0064_30485.jpg,432,473,040.Olive_sided_Flycatcher,91,88,301,368,196,228,210,280
../../CUB_200_2011/images\040.Olive_sided_Flycatcher/Olive_Sided_Flycatcher_0025_30486.jpg,487,500,040.Olive_sided_Flycatcher,223,56,439,365,331,210,216,309
../../CUB_200_2011/images\040.Olive_sided_Flycatcher/Olive_Sided_Flycatcher_0070_30490.jpg,403,500,040.Olive_sided_Flycatcher,114,86,377,462,245,274,263,376
../../CUB_200_2011/images\040.Olive_sided_Flycatcher/Olive_Sided_Flycatcher_0077_30492.jpg,329,500,040.Olive_sided_Flycatcher,112,128,218,381,165,254,106,253
../../CUB_200_2011/images\040.Olive_sided_Flycatcher/Olive_Sided_Flycatcher_0067_30749.jpg,375,500,040.Olive_sided_Flycatcher,129,88,230,225,179,156,101,137
../../CUB_200_2011/images\040.Olive_sided_Flycatcher/Olive_Sided_Flycatcher_0078_30752.jpg,374,500,040.Olive_sided_Flycatcher,111,66,214,284,162,175,103,218
../../CUB_200_2011/images\040.Olive_sided_Flycatcher/Olive_Sided_Flycatcher_0031_30502.jpg,375,500,040.Olive_sided_Flycatcher,25,117,335,390,180,253,310,273
../../CUB_200_2011/images\040.Olive_sided_Flycatcher/Olive_Sided_Flycatcher_0080_30515.jpg,399,500,040.Olive_sided_Flycatcher,122,85,272,461,197,273,150,376
../../CUB_200_2011/images\040.Olive_sided_Flycatcher/Olive_Sided_Flycatcher_0002_30776.jpg,496,500,040.Olive_sided_Flycatcher,124,101,412,395,268,248,288,294
../../CUB_200_2011/images\040.Olive_sided_Flycatcher/Olive_Sided_Flycatcher_0026_30525.jpg,500,333,040.Olive_sided_Flycatcher,38,47,499,332,268,189,461,285
../../CUB_200_2011/images\040.Olive_sided_Flycatcher/Olive_Sided_Flycatcher_0037_30784.jpg,500,478,040.Olive_sided_Flycatcher,196,134,359,327,277,230,163,193
../../CUB_200_2011/images\040.Olive_sided_Flycatcher/Olive_Sided_Flycatcher_0046_30529.jpg,500,394,040.Olive_sided_Flycatcher,154,84,359,326,256,205,205,242
../../CUB_200_2011/images\040.Olive_sided_Flycatcher/Olive_Sided_Flycatcher_0033_30532.jpg,500,375,040.Olive_sided_Flycatcher,139,55,343,299,241,177,204,244
../../CUB_200_2011/images\040.Olive_sided_Flycatcher/Olive_Sided_Flycatcher_0059_30536.jpg,500,399,040.Olive_sided_Flycatcher,171,85,302,316,236,200,131,231
../../CUB_200_2011/images\040.Olive_sided_Flycatcher/Olive_Sided_Flycatcher_0061_30540.jpg,500,375,040.Olive_sided_Flycatcher,315,118,417,325,366,221,102,207
../../CUB_200_2011/images\040.Olive_sided_Flycatcher/Olive_Sided_Flycatcher_0035_30799.jpg,500,375,040.Olive_sided_Flycatcher,92,83,394,310,243,196,302,227
../../CUB_200_2011/images\040.Olive_sided_Flycatcher/Olive_Sided_Flycatcher_0069_30544.jpg,500,446,040.Olive_sided_Flycatcher,142,127,306,327,224,227,164,200
../../CUB_200_2011/images\040.Olive_sided_Flycatcher/Olive_Sided_Flycatcher_0072_796877.jpg,357,500,040.Olive_sided_Flycatcher,104,133,257,453,180,293,153,320
../../CUB_200_2011/images\040.Olive_sided_Flycatcher/Olive_Sided_Flycatcher_0005_30734.jpg,333,500,040.Olive_sided_Flycatcher,121,107,283,343,202,225,162,236
../../CUB_200_2011/images\040.Olive_sided_Flycatcher/Olive_Sided_Flycatcher_0013_30550.jpg,500,333,040.Olive_sided_Flycatcher,124,109,391,256,257,182,267,147
../../CUB_200_2011/images\040.Olive_sided_Flycatcher/Olive_Sided_Flycatcher_0022_30551.jpg,372,492,040.Olive_sided_Flycatcher,69,56,215,441,142,248,146,385
../../CUB_200_2011/images\040.Olive_sided_Flycatcher/Olive_Sided_Flycatcher_0086_30553.jpg,500,364,040.Olive_sided_Flycatcher,156,83,324,324,240,203,168,241
../../CUB_200_2011/images\040.Olive_sided_Flycatcher/Olive_Sided_Flycatcher_0076_30555.jpg,500,334,040.Olive_sided_Flycatcher,273,102,395,246,334,174,122,144
../../CUB_200_2011/images\040.Olive_sided_Flycatcher/Olive_Sided_Flycatcher_0074_30816.jpg,500,333,040.Olive_sided_Flycatcher,167,77,411,239,289,158,244,162
../../CUB_200_2011/images\040.Olive_sided_Flycatcher/Olive_Sided_Flycatcher_0006_30824.jpg,500,375,040.Olive_sided_Flycatcher,137,89,279,369,208,229,142,280
../../CUB_200_2011/images\040.Olive_sided_Flycatcher/Olive_Sided_Flycatcher_0056_30570.jpg,375,500,040.Olive_sided_Flycatcher,145,52,306,499,225,275,161,447
../../CUB_200_2011/images\040.Olive_sided_Flycatcher/Olive_Sided_Flycatcher_0040_30620.jpg,500,353,040.Olive_sided_Flycatcher,158,103,300,255,229,179,142,152
../../CUB_200_2011/images\040.Olive_sided_Flycatcher/Olive_Sided_Flycatcher_0043_30632.jpg,500,333,040.Olive_sided_Flycatcher,171,31,321,314,246,172,150,283
../../CUB_200_2011/images\040.Olive_sided_Flycatcher/Olive_Sided_Flycatcher_0052_30639.jpg,335,500,040.Olive_sided_Flycatcher,33,97,256,448,144,272,223,351
../../CUB_200_2011/images\040.Olive_sided_Flycatcher/Olive_Sided_Flycatcher_0071_30647.jpg,469,500,040.Olive_sided_Flycatcher,168,181,278,319,223,250,110,138
../../CUB_200_2011/images\040.Olive_sided_Flycatcher/Olive_Sided_Flycatcher_0014_30651.jpg,500,333,040.Olive_sided_Flycatcher,199,100,322,281,260,190,123,181
../../CUB_200_2011/images\040.Olive_sided_Flycatcher/Olive_Sided_Flycatcher_0048_30656.jpg,333,500,040.Olive_sided_Flycatcher,96,117,278,348,187,232,182,231
../../CUB_200_2011/images\040.Olive_sided_Flycatcher/Olive_Sided_Flycatcher_0079_30662.jpg,394,500,040.Olive_sided_Flycatcher,133,127,241,352,187,239,108,225
../../CUB_200_2011/images\040.Olive_sided_Flycatcher/Olive_Sided_Flycatcher_0012_796876.jpg,453,420,040.Olive_sided_Flycatcher,40,32,401,377,220,204,361,345
../../CUB_200_2011/images\040.Olive_sided_Flycatcher/Olive_Sided_Flycatcher_0001_30669.jpg,500,333,040.Olive_sided_Flycatcher,150,76,376,282,263,179,226,206
../../CUB_200_2011/images\040.Olive_sided_Flycatcher/Olive_Sided_Flycatcher_0050_796878.jpg,394,500,040.Olive_sided_Flycatcher,78,112,241,484,159,298,163,372
../../CUB_200_2011/images\040.Olive_sided_Flycatcher/Olive_Sided_Flycatcher_0055_796879.jpg,230,311,040.Olive_sided_Flycatcher,35,42,174,280,104,161,139,238
../../CUB_200_2011/images\040.Olive_sided_Flycatcher/Olive_Sided_Flycatcher_0034_30672.jpg,500,422,040.Olive_sided_Flycatcher,198,88,497,236,347,162,299,148
../../CUB_200_2011/images\040.Olive_sided_Flycatcher/Olive_Sided_Flycatcher_0020_796881.jpg,240,297,040.Olive_sided_Flycatcher,47,44,222,296,134,170,175,252
../../CUB_200_2011/images\040.Olive_sided_Flycatcher/Olive_Sided_Flycatcher_0018_796882.jpg,370,500,040.Olive_sided_Flycatcher,101,100,244,372,172,236,143,272
../../CUB_200_2011/images\040.Olive_sided_Flycatcher/Olive_Sided_Flycatcher_0058_796883.jpg,500,376,040.Olive_sided_Flycatcher,111,47,213,362,162,204,102,315
../../CUB_200_2011/images\040.Olive_sided_Flycatcher/Olive_Sided_Flycatcher_0038_796884.jpg,500,500,040.Olive_sided_Flycatcher,146,65,403,476,274,270,257,411
../../CUB_200_2011/images\040.Olive_sided_Flycatcher/Olive_Sided_Flycatcher_0009_796885.jpg,454,500,040.Olive_sided_Flycatcher,263,87,376,393,319,240,113,306
../../CUB_200_2011/images\040.Olive_sided_Flycatcher/Olive_Sided_Flycatcher_0042_796886.jpg,473,500,040.Olive_sided_Flycatcher,79,43,408,455,243,249,329,412
../../CUB_200_2011/images\040.Olive_sided_Flycatcher/Olive_Sided_Flycatcher_0023_796887.jpg,500,375,040.Olive_sided_Flycatcher,143,93,429,292,286,192,286,199
../../CUB_200_2011/images\040.Olive_sided_Flycatcher/Olive_Sided_Flycatcher_0045_796888.jpg,453,339,040.Olive_sided_Flycatcher,156,65,288,308,222,186,132,243
../../CUB_200_2011/images\040.Olive_sided_Flycatcher/Olive_Sided_Flycatcher_0049_796889.jpg,392,500,040.Olive_sided_Flycatcher,81,93,227,403,154,248,146,310
../../CUB_200_2011/images\040.Olive_sided_Flycatcher/Olive_Sided_Flycatcher_0082_796893.jpg,483,500,040.Olive_sided_Flycatcher,88,37,362,455,225,246,274,418
../../CUB_200_2011/images\040.Olive_sided_Flycatcher/Olive_Sided_Flycatcher_0008_30686.jpg,500,375,040.Olive_sided_Flycatcher,59,66,351,326,205,196,292,260
../../CUB_200_2011/images\040.Olive_sided_Flycatcher/Olive_Sided_Flycatcher_0081_796895.jpg,387,500,040.Olive_sided_Flycatcher,21,60,333,250,177,155,312,190
../../CUB_200_2011/images\040.Olive_sided_Flycatcher/Olive_Sided_Flycatcher_0030_796896.jpg,275,485,040.Olive_sided_Flycatcher,67,93,212,422,139,257,145,329
../../CUB_200_2011/images\040.Olive_sided_Flycatcher/Olive_Sided_Flycatcher_0021_796880.jpg,450,458,040.Olive_sided_Flycatcher,112,34,262,424,187,229,150,390
../../CUB_200_2011/images\040.Olive_sided_Flycatcher/Olive_Sided_Flycatcher_0057_796898.jpg,478,500,040.Olive_sided_Flycatcher,195,24,395,457,295,240,200,433
../../CUB_200_2011/images\040.Olive_sided_Flycatcher/Olive_Sided_Flycatcher_0017_30704.jpg,500,400,040.Olive_sided_Flycatcher,179,128,307,303,243,215,128,175
../../CUB_200_2011/images\040.Olive_sided_Flycatcher/Olive_Sided_Flycatcher_0075_30712.jpg,388,500,040.Olive_sided_Flycatcher,134,118,274,358,204,238,140,240
../../CUB_200_2011/images\040.Olive_sided_Flycatcher/Olive_Sided_Flycatcher_0032_30713.jpg,233,350,040.Olive_sided_Flycatcher,21,39,207,321,114,180,186,282
../../CUB_200_2011/images\040.Olive_sided_Flycatcher/Olive_Sided_Flycatcher_0016_30717.jpg,469,500,040.Olive_sided_Flycatcher,145,123,271,400,208,261,126,277
../../CUB_200_2011/images\040.Olive_sided_Flycatcher/Olive_Sided_Flycatcher_0027_30549.jpg,500,334,040.Olive_sided_Flycatcher,97,53,410,263,253,158,313,210
../../CUB_200_2011/images\041.Scissor_tailed_Flycatcher/Scissor_Tailed_Flycatcher_0098_41731.jpg,500,346,041.Scissor_tailed_Flycatcher,87,47,397,300,242,173,310,253
../../CUB_200_2011/images\041.Scissor_tailed_Flycatcher/Scissor_Tailed_Flycatcher_0096_41733.jpg,500,333,041.Scissor_tailed_Flycatcher,196,71,332,175,264,123,136,104
../../CUB_200_2011/images\041.Scissor_tailed_Flycatcher/Scissor_Tailed_Flycatcher_0042_41990.jpg,500,407,041.Scissor_tailed_Flycatcher,269,163,416,316,342,239,147,153
../../CUB_200_2011/images\041.Scissor_tailed_Flycatcher/Scissor_Tailed_Flycatcher_0059_41998.jpg,500,400,041.Scissor_tailed_Flycatcher,124,88,493,285,308,186,369,197
../../CUB_200_2011/images\041.Scissor_tailed_Flycatcher/Scissor_Tailed_Flycatcher_0044_42002.jpg,500,375,041.Scissor_tailed_Flycatcher,92,81,358,310,225,195,266,229
../../CUB_200_2011/images\041.Scissor_tailed_Flycatcher/Scissor_Tailed_Flycatcher_0028_42010.jpg,500,370,041.Scissor_tailed_Flycatcher,242,139,361,328,301,233,119,189
../../CUB_200_2011/images\041.Scissor_tailed_Flycatcher/Scissor_Tailed_Flycatcher_0108_42013.jpg,500,313,041.Scissor_tailed_Flycatcher,152,26,437,296,294,161,285,270
../../CUB_200_2011/images\041.Scissor_tailed_Flycatcher/Scissor_Tailed_Flycatcher_0094_42018.jpg,500,386,041.Scissor_tailed_Flycatcher,205,50,359,370,282,210,154,320
../../CUB_200_2011/images\041.Scissor_tailed_Flycatcher/Scissor_Tailed_Flycatcher_0038_41649.jpg,375,500,041.Scissor_tailed_Flycatcher,113,91,252,407,182,249,139,316
../../CUB_200_2011/images\041.Scissor_tailed_Flycatcher/Scissor_Tailed_Flycatcher_0013_42024.jpg,334,500,041.Scissor_tailed_Flycatcher,48,131,304,419,176,275,256,288
../../CUB_200_2011/images\041.Scissor_tailed_Flycatcher/Scissor_Tailed_Flycatcher_0035_42025.jpg,334,500,041.Scissor_tailed_Flycatcher,103,103,311,277,207,190,208,174
../../CUB_200_2011/images\041.Scissor_tailed_Flycatcher/Scissor_Tailed_Flycatcher_0117_42026.jpg,500,363,041.Scissor_tailed_Flycatcher,137,111,362,229,249,170,225,118
../../CUB_200_2011/images\041.Scissor_tailed_Flycatcher/Scissor_Tailed_Flycatcher_0125_41906.jpg,500,400,041.Scissor_tailed_Flycatcher,141,143,330,289,235,216,189,146
../../CUB_200_2011/images\041.Scissor_tailed_Flycatcher/Scissor_Tailed_Flycatcher_0026_41774.jpg,400,500,041.Scissor_tailed_Flycatcher,192,68,371,262,281,165,179,194
../../CUB_200_2011/images\041.Scissor_tailed_Flycatcher/Scissor_Tailed_Flycatcher_0025_42032.jpg,500,328,041.Scissor_tailed_Flycatcher,173,111,496,321,334,216,323,210
../../CUB_200_2011/images\041.Scissor_tailed_Flycatcher/Scissor_Tailed_Flycatcher_0033_41782.jpg,500,333,041.Scissor_tailed_Flycatcher,88,99,475,264,281,181,387,165
../../CUB_200_2011/images\041.Scissor_tailed_Flycatcher/Scissor_Tailed_Flycatcher_0055_42051.jpg,500,333,041.Scissor_tailed_Flycatcher,4,44,433,291,218,167,429,247
../../CUB_200_2011/images\041.Scissor_tailed_Flycatcher/Scissor_Tailed_Flycatcher_0100_41796.jpg,357,500,041.Scissor_tailed_Flycatcher,102,128,286,410,194,269,184,282
../../CUB_200_2011/images\041.Scissor_tailed_Flycatcher/Scissor_Tailed_Flycatcher_0089_41810.jpg,262,360,041.Scissor_tailed_Flycatcher,61,69,248,333,154,201,187,264
../../CUB_200_2011/images\041.Scissor_tailed_Flycatcher/Scissor_Tailed_Flycatcher_0118_42067.jpg,500,384,041.Scissor_tailed_Flycatcher,75,85,189,352,132,218,114,267
../../CUB_200_2011/images\041.Scissor_tailed_Flycatcher/Scissor_Tailed_Flycatcher_0069_41827.jpg,500,378,041.Scissor_tailed_Flycatcher,184,134,386,267,285,200,202,133
../../CUB_200_2011/images\041.Scissor_tailed_Flycatcher/Scissor_Tailed_Flycatcher_0072_42085.jpg,500,375,041.Scissor_tailed_Flycatcher,57,98,360,222,208,160,303,124
../../CUB_200_2011/images\041.Scissor_tailed_Flycatcher/Scissor_Tailed_Flycatcher_0085_41830.jpg,375,500,041.Scissor_tailed_Flycatcher,22,97,360,386,191,241,338,289
../../CUB_200_2011/images\041.Scissor_tailed_Flycatcher/Scissor_Tailed_Flycatcher_0068_41835.jpg,500,357,041.Scissor_tailed_Flycatcher,193,150,410,262,301,206,217,112
../../CUB_200_2011/images\041.Scissor_tailed_Flycatcher/Scissor_Tailed_Flycatcher_0031_41836.jpg,500,396,041.Scissor_tailed_Flycatcher,22,70,459,371,240,220,437,301
../../CUB_200_2011/images\041.Scissor_tailed_Flycatcher/Scissor_Tailed_Flycatcher_0121_41843.jpg,375,500,041.Scissor_tailed_Flycatcher,33,90,234,214,133,152,201,124
../../CUB_200_2011/images\041.Scissor_tailed_Flycatcher/Scissor_Tailed_Flycatcher_0003_41849.jpg,500,395,041.Scissor_tailed_Flycatcher,52,142,342,271,197,206,290,129
../../CUB_200_2011/images\041.Scissor_tailed_Flycatcher/Scissor_Tailed_Flycatcher_0082_41852.jpg,500,333,041.Scissor_tailed_Flycatcher,89,66,394,224,241,145,305,158
../../CUB_200_2011/images\041.Scissor_tailed_Flycatcher/Scissor_Tailed_Flycatcher_0076_41597.jpg,417,500,041.Scissor_tailed_Flycatcher,124,177,393,333,258,255,269,156
../../CUB_200_2011/images\041.Scissor_tailed_Flycatcher/Scissor_Tailed_Flycatcher_0016_42111.jpg,334,500,041.Scissor_tailed_Flycatcher,60,126,172,226,116,176,112,100
../../CUB_200_2011/images\041.Scissor_tailed_Flycatcher/Scissor_Tailed_Flycatcher_0006_41601.jpg,361,500,041.Scissor_tailed_Flycatcher,33,119,277,451,155,285,244,332
../../CUB_200_2011/images\041.Scissor_tailed_Flycatcher/Scissor_Tailed_Flycatcher_0019_41936.jpg,500,359,041.Scissor_tailed_Flycatcher,59,125,369,268,214,196,310,143
../../CUB_200_2011/images\041.Scissor_tailed_Flycatcher/Scissor_Tailed_Flycatcher_0111_42118.jpg,500,387,041.Scissor_tailed_Flycatcher,85,49,476,270,280,159,391,221
../../CUB_200_2011/images\041.Scissor_tailed_Flycatcher/Scissor_Tailed_Flycatcher_0119_41879.jpg,500,333,041.Scissor_tailed_Flycatcher,70,74,473,240,271,157,403,166
../../CUB_200_2011/images\041.Scissor_tailed_Flycatcher/Scissor_Tailed_Flycatcher_0110_42136.jpg,500,333,041.Scissor_tailed_Flycatcher,78,41,418,311,248,176,340,270
../../CUB_200_2011/images\041.Scissor_tailed_Flycatcher/Scissor_Tailed_Flycatcher_0115_42137.jpg,500,319,041.Scissor_tailed_Flycatcher,139,83,458,222,298,152,319,139
../../CUB_200_2011/images\041.Scissor_tailed_Flycatcher/Scissor_Tailed_Flycatcher_0123_41638.jpg,500,388,041.Scissor_tailed_Flycatcher,126,126,469,341,297,233,343,215
../../CUB_200_2011/images\041.Scissor_tailed_Flycatcher/Scissor_Tailed_Flycatcher_0004_41643.jpg,500,332,041.Scissor_tailed_Flycatcher,25,73,369,259,197,166,344,186
../../CUB_200_2011/images\041.Scissor_tailed_Flycatcher/Scissor_Tailed_Flycatcher_0048_41646.jpg,500,400,041.Scissor_tailed_Flycatcher,140,130,436,279,288,204,296,149
../../CUB_200_2011/images\041.Scissor_tailed_Flycatcher/Scissor_Tailed_Flycatcher_0060_41655.jpg,500,333,041.Scissor_tailed_Flycatcher,129,13,473,312,301,162,344,299
../../CUB_200_2011/images\041.Scissor_tailed_Flycatcher/Scissor_Tailed_Flycatcher_0007_41917.jpg,500,342,041.Scissor_tailed_Flycatcher,87,105,463,234,275,169,376,129
../../CUB_200_2011/images\041.Scissor_tailed_Flycatcher/Scissor_Tailed_Flycatcher_0023_42117.jpg,500,339,041.Scissor_tailed_Flycatcher,113,55,297,239,205,147,184,184
../../CUB_200_2011/images\041.Scissor_tailed_Flycatcher/Scissor_Tailed_Flycatcher_0021_41931.jpg,500,375,041.Scissor_tailed_Flycatcher,104,71,437,355,270,213,333,284
../../CUB_200_2011/images\041.Scissor_tailed_Flycatcher/Scissor_Tailed_Flycatcher_0008_41670.jpg,500,333,041.Scissor_tailed_Flycatcher,100,87,434,205,267,146,334,118
../../CUB_200_2011/images\041.Scissor_tailed_Flycatcher/Scissor_Tailed_Flycatcher_0002_41762.jpg,500,364,041.Scissor_tailed_Flycatcher,111,94,342,333,226,213,231,239
../../CUB_200_2011/images\041.Scissor_tailed_Flycatcher/Scissor_Tailed_Flycatcher_0122_41679.jpg,500,483,041.Scissor_tailed_Flycatcher,293,242,417,418,355,330,124,176
../../CUB_200_2011/images\041.Scissor_tailed_Flycatcher/Scissor_Tailed_Flycatcher_0020_41680.jpg,500,375,041.Scissor_tailed_Flycatcher,59,124,364,294,211,209,305,170
../../CUB_200_2011/images\041.Scissor_tailed_Flycatcher/Scissor_Tailed_Flycatcher_0103_41938.jpg,500,333,041.Scissor_tailed_Flycatcher,151,68,302,264,226,166,151,196
../../CUB_200_2011/images\041.Scissor_tailed_Flycatcher/Scissor_Tailed_Flycatcher_0106_41684.jpg,500,375,041.Scissor_tailed_Flycatcher,116,120,420,340,268,230,304,220
../../CUB_200_2011/images\041.Scissor_tailed_Flycatcher/Scissor_Tailed_Flycatcher_0077_41688.jpg,500,332,041.Scissor_tailed_Flycatcher,15,82,343,233,179,157,328,151
../../CUB_200_2011/images\041.Scissor_tailed_Flycatcher/Scissor_Tailed_Flycatcher_0058_41948.jpg,500,344,041.Scissor_tailed_Flycatcher,106,76,303,312,204,194,197,236
../../CUB_200_2011/images\041.Scissor_tailed_Flycatcher/Scissor_Tailed_Flycatcher_0062_41952.jpg,340,500,041.Scissor_tailed_Flycatcher,38,144,256,399,147,271,218,255
../../CUB_200_2011/images\041.Scissor_tailed_Flycatcher/Scissor_Tailed_Flycatcher_0126_41905.jpg,469,324,041.Scissor_tailed_Flycatcher,136,87,332,195,234,141,196,108
../../CUB_200_2011/images\041.Scissor_tailed_Flycatcher/Scissor_Tailed_Flycatcher_0088_41700.jpg,479,500,041.Scissor_tailed_Flycatcher,131,154,369,499,250,326,238,345
../../CUB_200_2011/images\041.Scissor_tailed_Flycatcher/Scissor_Tailed_Flycatcher_0097_41701.jpg,500,333,041.Scissor_tailed_Flycatcher,10,121,390,261,200,191,380,140
../../CUB_200_2011/images\041.Scissor_tailed_Flycatcher/Scissor_Tailed_Flycatcher_0114_41704.jpg,500,400,041.Scissor_tailed_Flycatcher,51,94,405,345,228,219,354,251
../../CUB_200_2011/images\041.Scissor_tailed_Flycatcher/Scissor_Tailed_Flycatcher_0092_41767.jpg,400,500,041.Scissor_tailed_Flycatcher,109,87,307,234,208,160,198,147
../../CUB_200_2011/images\041.Scissor_tailed_Flycatcher/Scissor_Tailed_Flycatcher_0012_41853.jpg,500,377,041.Scissor_tailed_Flycatcher,92,84,466,349,279,216,374,265
../../CUB_200_2011/images\041.Scissor_tailed_Flycatcher/Scissor_Tailed_Flycatcher_0109_41720.jpg,400,500,041.Scissor_tailed_Flycatcher,1,104,281,403,141,253,280,299
../../CUB_200_2011/images\041.Scissor_tailed_Flycatcher/Scissor_Tailed_Flycatcher_0005_41727.jpg,500,375,041.Scissor_tailed_Flycatcher,164,132,305,250,234,191,141,118
../../CUB_200_2011/images\042.Vermilion_Flycatcher/Vermilion_Flycatcher_0019_42241.jpg,431,500,042.Vermilion_Flycatcher,96,75,320,408,208,241,224,333
../../CUB_200_2011/images\042.Vermilion_Flycatcher/Vermilion_Flycatcher_0020_42498.jpg,500,436,042.Vermilion_Flycatcher,145,127,422,313,283,220,277,186
../../CUB_200_2011/images\042.Vermilion_Flycatcher/Vermilion_Flycatcher_0069_42502.jpg,353,500,042.Vermilion_Flycatcher,121,149,265,295,193,222,144,146
../../CUB_200_2011/images\042.Vermilion_Flycatcher/Vermilion_Flycatcher_0025_42248.jpg,401,500,042.Vermilion_Flycatcher,95,168,235,272,165,220,140,104
../../CUB_200_2011/images\042.Vermilion_Flycatcher/Vermilion_Flycatcher_0070_42250.jpg,500,418,042.Vermilion_Flycatcher,163,169,332,305,247,237,169,136
../../CUB_200_2011/images\042.Vermilion_Flycatcher/Vermilion_Flycatcher_0012_42253.jpg,500,327,042.Vermilion_Flycatcher,173,69,360,314,266,191,187,245
../../CUB_200_2011/images\042.Vermilion_Flycatcher/Vermilion_Flycatcher_0059_42261.jpg,500,413,042.Vermilion_Flycatcher,170,65,474,318,322,191,304,253
../../CUB_200_2011/images\042.Vermilion_Flycatcher/Vermilion_Flycatcher_0038_42262.jpg,500,493,042.Vermilion_Flycatcher,164,187,374,353,269,270,210,166
../../CUB_200_2011/images\042.Vermilion_Flycatcher/Vermilion_Flycatcher_0042_42266.jpg,380,500,042.Vermilion_Flycatcher,48,112,306,383,177,247,258,271
../../CUB_200_2011/images\042.Vermilion_Flycatcher/Vermilion_Flycatcher_0030_42523.jpg,500,329,042.Vermilion_Flycatcher,27,160,281,314,154,237,254,154
../../CUB_200_2011/images\042.Vermilion_Flycatcher/Vermilion_Flycatcher_0014_42533.jpg,500,333,042.Vermilion_Flycatcher,186,76,348,231,267,153,162,155
../../CUB_200_2011/images\042.Vermilion_Flycatcher/Vermilion_Flycatcher_0068_42535.jpg,500,333,042.Vermilion_Flycatcher,201,135,322,289,261,212,121,154
../../CUB_200_2011/images\042.Vermilion_Flycatcher/Vermilion_Flycatcher_0035_42282.jpg,500,333,042.Vermilion_Flycatcher,220,62,420,253,320,157,200,191
../../CUB_200_2011/images\042.Vermilion_Flycatcher/Vermilion_Flycatcher_0060_42293.jpg,500,333,042.Vermilion_Flycatcher,151,68,472,311,311,189,321,243
../../CUB_200_2011/images\042.Vermilion_Flycatcher/Vermilion_Flycatcher_0052_42551.jpg,500,436,042.Vermilion_Flycatcher,56,89,370,403,213,246,314,314
../../CUB_200_2011/images\042.Vermilion_Flycatcher/Vermilion_Flycatcher_0062_42552.jpg,500,358,042.Vermilion_Flycatcher,106,93,216,216,161,154,110,123
../../CUB_200_2011/images\042.Vermilion_Flycatcher/Vermilion_Flycatcher_0048_42298.jpg,500,358,042.Vermilion_Flycatcher,157,52,387,315,272,183,230,263
../../CUB_200_2011/images\042.Vermilion_Flycatcher/Vermilion_Flycatcher_0024_42506.jpg,500,333,042.Vermilion_Flycatcher,138,58,363,298,250,178,225,240
../../CUB_200_2011/images\042.Vermilion_Flycatcher/Vermilion_Flycatcher_0022_42559.jpg,500,333,042.Vermilion_Flycatcher,192,49,459,308,325,178,267,259
../../CUB_200_2011/images\042.Vermilion_Flycatcher/Vermilion_Flycatcher_0044_42305.jpg,500,334,042.Vermilion_Flycatcher,170,127,279,249,224,188,109,122
../../CUB_200_2011/images\042.Vermilion_Flycatcher/Vermilion_Flycatcher_0057_42562.jpg,500,360,042.Vermilion_Flycatcher,163,94,314,288,238,191,151,194
../../CUB_200_2011/images\042.Vermilion_Flycatcher/Vermilion_Flycatcher_0006_42564.jpg,500,335,042.Vermilion_Flycatcher,45,36,274,245,159,140,229,209
../../CUB_200_2011/images\042.Vermilion_Flycatcher/Vermilion_Flycatcher_0023_42565.jpg,500,333,042.Vermilion_Flycatcher,179,68,296,210,237,139,117,142
../../CUB_200_2011/images\042.Vermilion_Flycatcher/Vermilion_Flycatcher_0058_42311.jpg,500,376,042.Vermilion_Flycatcher,62,156,198,285,130,220,136,129
../../CUB_200_2011/images\042.Vermilion_Flycatcher/Vermilion_Flycatcher_0003_42316.jpg,383,500,042.Vermilion_Flycatcher,41,67,381,373,211,220,340,306
../../CUB_200_2011/images\042.Vermilion_Flycatcher/Vermilion_Flycatcher_0073_42573.jpg,375,500,042.Vermilion_Flycatcher,103,102,303,293,203,197,200,191
../../CUB_200_2011/images\042.Vermilion_Flycatcher/Vermilion_Flycatcher_0011_42554.jpg,500,334,042.Vermilion_Flycatcher,261,108,395,241,328,174,134,133
../../CUB_200_2011/images\042.Vermilion_Flycatcher/Vermilion_Flycatcher_0033_42522.jpg,500,333,042.Vermilion_Flycatcher,105,80,322,229,213,154,217,149
../../CUB_200_2011/images\042.Vermilion_Flycatcher/Vermilion_Flycatcher_0018_42474.jpg,500,375,042.Vermilion_Flycatcher,80,43,463,295,271,169,383,252
../../CUB_200_2011/images\042.Vermilion_Flycatcher/Vermilion_Flycatcher_0026_42375.jpg,500,337,042.Vermilion_Flycatcher,98,42,407,271,252,156,309,229
../../CUB_200_2011/images\042.Vermilion_Flycatcher/Vermilion_Flycatcher_0021_42378.jpg,500,333,042.Vermilion_Flycatcher,157,54,471,214,314,134,314,160
../../CUB_200_2011/images\042.Vermilion_Flycatcher/Vermilion_Flycatcher_0049_42380.jpg,500,448,042.Vermilion_Flycatcher,167,85,409,329,288,207,242,244
../../CUB_200_2011/images\042.Vermilion_Flycatcher/Vermilion_Flycatcher_0027_42388.jpg,500,395,042.Vermilion_Flycatcher,161,81,351,241,256,161,190,160
../../CUB_200_2011/images\042.Vermilion_Flycatcher/Vermilion_Flycatcher_0036_42389.jpg,361,500,042.Vermilion_Flycatcher,76,101,290,431,183,266,214,330
../../CUB_200_2011/images\042.Vermilion_Flycatcher/Vermilion_Flycatcher_0002_42390.jpg,500,410,042.Vermilion_Flycatcher,175,68,465,365,320,216,290,297
../../CUB_200_2011/images\042.Vermilion_Flycatcher/Vermilion_Flycatcher_0004_42395.jpg,500,406,042.Vermilion_Flycatcher,18,36,475,390,246,213,457,354
../../CUB_200_2011/images\042.Vermilion_Flycatcher/Vermilion_Flycatcher_0061_42397.jpg,354,500,042.Vermilion_Flycatcher,146,60,302,194,224,127,156,134
../../CUB_200_2011/images\042.Vermilion_Flycatcher/Vermilion_Flycatcher_0040_42398.jpg,471,500,042.Vermilion_Flycatcher,183,146,289,394,236,270,106,248
../../CUB_200_2011/images\042.Vermilion_Flycatcher/Vermilion_Flycatcher_0017_42407.jpg,500,371,042.Vermilion_Flycatcher,130,40,334,318,232,179,204,278
../../CUB_200_2011/images\042.Vermilion_Flycatcher/Vermilion_Flycatcher_0039_42423.jpg,500,333,042.Vermilion_Flycatcher,132,111,292,261,212,186,160,150
../../CUB_200_2011/images\042.Vermilion_Flycatcher/Vermilion_Flycatcher_0034_42356.jpg,500,354,042.Vermilion_Flycatcher,203,78,429,229,316,153,226,151
../../CUB_200_2011/images\042.Vermilion_Flycatcher/Vermilion_Flycatcher_0071_42429.jpg,367,500,042.Vermilion_Flycatcher,39,102,269,408,154,255,230,306
../../CUB_200_2011/images\042.Vermilion_Flycatcher/Vermilion_Flycatcher_0063_42179.jpg,500,333,042.Vermilion_Flycatcher,235,80,490,259,362,169,255,179
../../CUB_200_2011/images\042.Vermilion_Flycatcher/Vermilion_Flycatcher_0043_42182.jpg,500,326,042.Vermilion_Flycatcher,79,26,411,296,245,161,332,270
../../CUB_200_2011/images\042.Vermilion_Flycatcher/Vermilion_Flycatcher_0053_42184.jpg,500,333,042.Vermilion_Flycatcher,25,72,245,216,135,144,220,144
../../CUB_200_2011/images\042.Vermilion_Flycatcher/Vermilion_Flycatcher_0067_42185.jpg,500,357,042.Vermilion_Flycatcher,169,64,440,345,304,204,271,281
../../CUB_200_2011/images\042.Vermilion_Flycatcher/Vermilion_Flycatcher_0055_42442.jpg,500,446,042.Vermilion_Flycatcher,231,118,405,389,318,253,174,271
../../CUB_200_2011/images\042.Vermilion_Flycatcher/Vermilion_Flycatcher_0016_42196.jpg,500,400,042.Vermilion_Flycatcher,11,55,316,398,163,226,305,343
../../CUB_200_2011/images\042.Vermilion_Flycatcher/Vermilion_Flycatcher_0028_42197.jpg,448,500,042.Vermilion_Flycatcher,74,66,333,449,203,257,259,383
../../CUB_200_2011/images\042.Vermilion_Flycatcher/Vermilion_Flycatcher_0031_42201.jpg,500,365,042.Vermilion_Flycatcher,201,119,366,240,283,179,165,121
../../CUB_200_2011/images\042.Vermilion_Flycatcher/Vermilion_Flycatcher_0054_42210.jpg,334,500,042.Vermilion_Flycatcher,88,153,289,313,188,233,201,160
../../CUB_200_2011/images\042.Vermilion_Flycatcher/Vermilion_Flycatcher_0065_42467.jpg,500,333,042.Vermilion_Flycatcher,174,83,350,250,262,166,176,167
../../CUB_200_2011/images\042.Vermilion_Flycatcher/Vermilion_Flycatcher_0007_42214.jpg,500,398,042.Vermilion_Flycatcher,30,102,271,339,150,220,241,237
../../CUB_200_2011/images\042.Vermilion_Flycatcher/Vermilion_Flycatcher_0032_42216.jpg,500,500,042.Vermilion_Flycatcher,207,120,423,426,315,273,216,306
../../CUB_200_2011/images\042.Vermilion_Flycatcher/Vermilion_Flycatcher_0072_42218.jpg,500,390,042.Vermilion_Flycatcher,38,55,403,362,220,208,365,307
../../CUB_200_2011/images\042.Vermilion_Flycatcher/Vermilion_Flycatcher_0045_42219.jpg,500,344,042.Vermilion_Flycatcher,106,40,484,322,295,181,378,282
../../CUB_200_2011/images\042.Vermilion_Flycatcher/Vermilion_Flycatcher_0005_42478.jpg,500,333,042.Vermilion_Flycatcher,179,74,316,329,247,201,137,255
../../CUB_200_2011/images\042.Vermilion_Flycatcher/Vermilion_Flycatcher_0050_42479.jpg,500,419,042.Vermilion_Flycatcher,199,116,320,257,259,186,121,141
../../CUB_200_2011/images\042.Vermilion_Flycatcher/Vermilion_Flycatcher_0047_42488.jpg,302,228,042.Vermilion_Flycatcher,82,37,219,203,150,120,137,166
../../CUB_200_2011/images\042.Vermilion_Flycatcher/Vermilion_Flycatcher_0009_42234.jpg,500,388,042.Vermilion_Flycatcher,83,38,478,371,280,204,395,333
../../CUB_200_2011/images\043.Yellow_bellied_Flycatcher/Yellow_Bellied_Flycatcher_0013_42769.jpg,500,400,043.Yellow_bellied_Flycatcher,106,153,289,306,197,229,183,153
../../CUB_200_2011/images\043.Yellow_bellied_Flycatcher/Yellow_Bellied_Flycatcher_0050_42598.jpg,389,500,043.Yellow_bellied_Flycatcher,64,34,324,487,194,260,260,453
../../CUB_200_2011/images\043.Yellow_bellied_Flycatcher/Yellow_Bellied_Flycatcher_0036_42591.jpg,500,500,043.Yellow_bellied_Flycatcher,94,121,379,372,236,246,285,251
../../CUB_200_2011/images\043.Yellow_bellied_Flycatcher/Yellow_Bellied_Flycatcher_0035_795464.jpg,398,500,043.Yellow_bellied_Flycatcher,94,109,331,438,212,273,237,329
../../CUB_200_2011/images\043.Yellow_bellied_Flycatcher/Yellow_Bellied_Flycatcher_0040_795465.jpg,404,500,043.Yellow_bellied_Flycatcher,139,68,254,292,196,180,115,224
../../CUB_200_2011/images\043.Yellow_bellied_Flycatcher/Yellow_Bellied_Flycatcher_0064_795466.jpg,350,350,043.Yellow_bellied_Flycatcher,136,77,241,266,188,171,105,189
../../CUB_200_2011/images\043.Yellow_bellied_Flycatcher/Yellow_Bellied_Flycatcher_0047_795468.jpg,410,500,043.Yellow_bellied_Flycatcher,100,125,356,401,228,263,256,276
../../CUB_200_2011/images\043.Yellow_bellied_Flycatcher/Yellow_Bellied_Flycatcher_0012_795469.jpg,500,371,043.Yellow_bellied_Flycatcher,180,36,347,354,263,195,167,318
../../CUB_200_2011/images\043.Yellow_bellied_Flycatcher/Yellow_Bellied_Flycatcher_0051_795470.jpg,313,270,043.Yellow_bellied_Flycatcher,52,25,269,236,160,130,217,211
../../CUB_200_2011/images\043.Yellow_bellied_Flycatcher/Yellow_Bellied_Flycatcher_0045_42575.jpg,393,500,043.Yellow_bellied_Flycatcher,85,68,301,461,193,264,216,393
../../CUB_200_2011/images\043.Yellow_bellied_Flycatcher/Yellow_Bellied_Flycatcher_0021_795472.jpg,344,500,043.Yellow_bellied_Flycatcher,112,146,267,381,189,263,155,235
../../CUB_200_2011/images\043.Yellow_bellied_Flycatcher/Yellow_Bellied_Flycatcher_0006_795473.jpg,320,240,043.Yellow_bellied_Flycatcher,24,40,247,239,135,139,223,199
../../CUB_200_2011/images\043.Yellow_bellied_Flycatcher/Yellow_Bellied_Flycatcher_0032_42578.jpg,500,458,043.Yellow_bellied_Flycatcher,109,135,356,392,232,263,247,257
../../CUB_200_2011/images\043.Yellow_bellied_Flycatcher/Yellow_Bellied_Flycatcher_0031_42580.jpg,416,500,043.Yellow_bellied_Flycatcher,170,56,321,449,245,252,151,393
../../CUB_200_2011/images\043.Yellow_bellied_Flycatcher/Yellow_Bellied_Flycatcher_0038_795477.jpg,500,400,043.Yellow_bellied_Flycatcher,166,140,278,272,222,206,112,132
../../CUB_200_2011/images\043.Yellow_bellied_Flycatcher/Yellow_Bellied_Flycatcher_0023_795478.jpg,318,318,043.Yellow_bellied_Flycatcher,49,16,304,288,176,152,255,272
../../CUB_200_2011/images\043.Yellow_bellied_Flycatcher/Yellow_Bellied_Flycatcher_0061_795479.jpg,500,434,043.Yellow_bellied_Flycatcher,77,10,460,432,268,221,383,422
../../CUB_200_2011/images\043.Yellow_bellied_Flycatcher/Yellow_Bellied_Flycatcher_0044_795480.jpg,500,396,043.Yellow_bellied_Flycatcher,188,75,414,369,301,222,226,294
../../CUB_200_2011/images\043.Yellow_bellied_Flycatcher/Yellow_Bellied_Flycatcher_0020_795482.jpg,360,400,043.Yellow_bellied_Flycatcher,63,61,250,348,156,204,187,287
../../CUB_200_2011/images\043.Yellow_bellied_Flycatcher/Yellow_Bellied_Flycatcher_0029_795483.jpg,500,335,043.Yellow_bellied_Flycatcher,107,47,279,327,193,187,172,280
../../CUB_200_2011/images\043.Yellow_bellied_Flycatcher/Yellow_Bellied_Flycatcher_0025_795484.jpg,334,500,043.Yellow_bellied_Flycatcher,60,125,246,423,153,274,186,298
../../CUB_200_2011/images\043.Yellow_bellied_Flycatcher/Yellow_Bellied_Flycatcher_0057_795485.jpg,334,500,043.Yellow_bellied_Flycatcher,136,76,272,449,204,262,136,373
../../CUB_200_2011/images\043.Yellow_bellied_Flycatcher/Yellow_Bellied_Flycatcher_0003_795487.jpg,361,400,043.Yellow_bellied_Flycatcher,73,45,313,366,193,205,240,321
../../CUB_200_2011/images\043.Yellow_bellied_Flycatcher/Yellow_Bellied_Flycatcher_0001_795488.jpg,420,280,043.Yellow_bellied_Flycatcher,82,39,267,262,174,150,185,223
../../CUB_200_2011/images\043.Yellow_bellied_Flycatcher/Yellow_Bellied_Flycatcher_0026_795489.jpg,334,500,043.Yellow_bellied_Flycatcher,27,116,259,416,143,266,232,300
../../CUB_200_2011/images\043.Yellow_bellied_Flycatcher/Yellow_Bellied_Flycatcher_0017_795490.jpg,500,334,043.Yellow_bellied_Flycatcher,199,111,394,307,296,209,195,196
../../CUB_200_2011/images\043.Yellow_bellied_Flycatcher/Yellow_Bellied_Flycatcher_0007_795491.jpg,500,304,043.Yellow_bellied_Flycatcher,13,17,498,303,255,160,485,286
../../CUB_200_2011/images\043.Yellow_bellied_Flycatcher/Yellow_Bellied_Flycatcher_0053_795493.jpg,369,500,043.Yellow_bellied_Flycatcher,48,128,249,454,148,291,201,326
../../CUB_200_2011/images\043.Yellow_bellied_Flycatcher/Yellow_Bellied_Flycatcher_0018_795494.jpg,275,206,043.Yellow_bellied_Flycatcher,85,26,208,182,146,104,123,156
../../CUB_200_2011/images\043.Yellow_bellied_Flycatcher/Yellow_Bellied_Flycatcher_0010_795498.jpg,284,450,043.Yellow_bellied_Flycatcher,19,28,275,426,147,227,256,398
../../CUB_200_2011/images\043.Yellow_bellied_Flycatcher/Yellow_Bellied_Flycatcher_0037_795500.jpg,335,500,043.Yellow_bellied_Flycatcher,39,61,283,409,161,235,244,348
../../CUB_200_2011/images\043.Yellow_bellied_Flycatcher/Yellow_Bellied_Flycatcher_0015_795504.jpg,500,332,043.Yellow_bellied_Flycatcher,151,124,349,228,250,176,198,104
../../CUB_200_2011/images\043.Yellow_bellied_Flycatcher/Yellow_Bellied_Flycatcher_0048_795505.jpg,500,281,043.Yellow_bellied_Flycatcher,307,27,425,280,366,153,118,253
../../CUB_200_2011/images\043.Yellow_bellied_Flycatcher/Yellow_Bellied_Flycatcher_0055_795507.jpg,333,500,043.Yellow_bellied_Flycatcher,99,72,297,405,198,238,198,333
../../CUB_200_2011/images\043.Yellow_bellied_Flycatcher/Yellow_Bellied_Flycatcher_0046_795508.jpg,140,213,043.Yellow_bellied_Flycatcher,12,26,123,198,67,112,111,172
../../CUB_200_2011/images\043.Yellow_bellied_Flycatcher/Yellow_Bellied_Flycatcher_0009_795510.jpg,500,421,043.Yellow_bellied_Flycatcher,171,98,384,365,277,231,213,267
../../CUB_200_2011/images\043.Yellow_bellied_Flycatcher/Yellow_Bellied_Flycatcher_0034_795511.jpg,261,310,043.Yellow_bellied_Flycatcher,35,38,232,260,133,149,197,222
../../CUB_200_2011/images\043.Yellow_bellied_Flycatcher/Yellow_Bellied_Flycatcher_0019_795512.jpg,400,500,043.Yellow_bellied_Flycatcher,166,120,292,441,229,280,126,321
../../CUB_200_2011/images\043.Yellow_bellied_Flycatcher/Yellow_Bellied_Flycatcher_0004_795513.jpg,230,306,043.Yellow_bellied_Flycatcher,39,49,166,270,102,159,127,221
../../CUB_200_2011/images\043.Yellow_bellied_Flycatcher/Yellow_Bellied_Flycatcher_0066_795514.jpg,500,375,043.Yellow_bellied_Flycatcher,191,80,352,272,271,176,161,192
../../CUB_200_2011/images\043.Yellow_bellied_Flycatcher/Yellow_Bellied_Flycatcher_0052_42621.jpg,500,500,043.Yellow_bellied_Flycatcher,152,24,396,477,274,250,244,453
../../CUB_200_2011/images\043.Yellow_bellied_Flycatcher/Yellow_Bellied_Flycatcher_0005_42627.jpg,500,334,043.Yellow_bellied_Flycatcher,136,93,245,270,190,181,109,177
../../CUB_200_2011/images\043.Yellow_bellied_Flycatcher/Yellow_Bellied_Flycatcher_0065_42635.jpg,500,419,043.Yellow_bellied_Flycatcher,71,50,261,341,166,195,190,291
../../CUB_200_2011/images\043.Yellow_bellied_Flycatcher/Yellow_Bellied_Flycatcher_0028_42639.jpg,500,500,043.Yellow_bellied_Flycatcher,68,213,226,323,147,268,158,110
../../CUB_200_2011/images\043.Yellow_bellied_Flycatcher/Yellow_Bellied_Flycatcher_0049_42593.jpg,500,375,043.Yellow_bellied_Flycatcher,177,116,330,334,253,225,153,218
../../CUB_200_2011/images\043.Yellow_bellied_Flycatcher/Yellow_Bellied_Flycatcher_0027_42649.jpg,500,406,043.Yellow_bellied_Flycatcher,154,82,310,327,232,204,156,245
../../CUB_200_2011/images\043.Yellow_bellied_Flycatcher/Yellow_Bellied_Flycatcher_0014_42608.jpg,500,437,043.Yellow_bellied_Flycatcher,294,206,420,406,357,306,126,200
../../CUB_200_2011/images\043.Yellow_bellied_Flycatcher/Yellow_Bellied_Flycatcher_0062_42693.jpg,403,500,043.Yellow_bellied_Flycatcher,121,159,235,338,178,248,114,179
../../CUB_200_2011/images\043.Yellow_bellied_Flycatcher/Yellow_Bellied_Flycatcher_0033_42695.jpg,500,329,043.Yellow_bellied_Flycatcher,28,46,467,329,247,187,439,283
../../CUB_200_2011/images\043.Yellow_bellied_Flycatcher/Yellow_Bellied_Flycatcher_0068_42701.jpg,500,333,043.Yellow_bellied_Flycatcher,0,49,438,331,219,190,438,282
../../CUB_200_2011/images\043.Yellow_bellied_Flycatcher/Yellow_Bellied_Flycatcher_0008_42703.jpg,500,375,043.Yellow_bellied_Flycatcher,1,47,406,296,203,171,405,249
../../CUB_200_2011/images\043.Yellow_bellied_Flycatcher/Yellow_Bellied_Flycatcher_0063_42704.jpg,500,355,043.Yellow_bellied_Flycatcher,159,93,418,286,288,189,259,193
../../CUB_200_2011/images\043.Yellow_bellied_Flycatcher/Yellow_Bellied_Flycatcher_0024_42616.jpg,500,343,043.Yellow_bellied_Flycatcher,255,65,399,303,327,184,144,238
../../CUB_200_2011/images\043.Yellow_bellied_Flycatcher/Yellow_Bellied_Flycatcher_0060_42595.jpg,500,400,043.Yellow_bellied_Flycatcher,163,70,411,385,287,227,248,315
../../CUB_200_2011/images\043.Yellow_bellied_Flycatcher/Yellow_Bellied_Flycatcher_0054_42709.jpg,500,333,043.Yellow_bellied_Flycatcher,231,49,363,299,297,174,132,250
../../CUB_200_2011/images\043.Yellow_bellied_Flycatcher/Yellow_Bellied_Flycatcher_0039_795471.jpg,500,363,043.Yellow_bellied_Flycatcher,196,62,341,325,268,193,145,263
../../CUB_200_2011/images\043.Yellow_bellied_Flycatcher/Yellow_Bellied_Flycatcher_0041_42719.jpg,447,500,043.Yellow_bellied_Flycatcher,134,140,295,428,214,284,161,288
../../CUB_200_2011/images\043.Yellow_bellied_Flycatcher/Yellow_Bellied_Flycatcher_0011_42734.jpg,438,500,043.Yellow_bellied_Flycatcher,144,138,399,387,271,262,255,249
../../CUB_200_2011/images\043.Yellow_bellied_Flycatcher/Yellow_Bellied_Flycatcher_0016_795476.jpg,500,300,043.Yellow_bellied_Flycatcher,37,58,320,231,178,144,283,173
../../CUB_200_2011/images\044.Frigatebird/Frigatebird_0089_43013.jpg,500,391,044.Frigatebird,62,5,371,372,216,188,309,367
../../CUB_200_2011/images\044.Frigatebird/Frigatebird_0057_43016.jpg,500,333,044.Frigatebird,143,102,495,309,319,205,352,207
../../CUB_200_2011/images\044.Frigatebird/Frigatebird_0054_43019.jpg,500,490,044.Frigatebird,29,25,471,462,250,243,442,437
../../CUB_200_2011/images\044.Frigatebird/Frigatebird_0069_43541.jpg,334,500,044.Frigatebird,16,186,217,360,116,273,201,174
../../CUB_200_2011/images\044.Frigatebird/Frigatebird_0074_43035.jpg,500,328,044.Frigatebird,72,1,471,252,271,126,399,251
../../CUB_200_2011/images\044.Frigatebird/Frigatebird_0122_43549.jpg,500,333,044.Frigatebird,154,49,422,261,288,155,268,212
../../CUB_200_2011/images\044.Frigatebird/Frigatebird_0073_43038.jpg,500,333,044.Frigatebird,84,69,260,245,172,157,176,176
../../CUB_200_2011/images\044.Frigatebird/Frigatebird_0047_43039.jpg,500,375,044.Frigatebird,226,37,380,347,303,192,154,310
../../CUB_200_2011/images\044.Frigatebird/Frigatebird_0119_43042.jpg,281,500,044.Frigatebird,23,132,222,425,122,278,199,293
../../CUB_200_2011/images\044.Frigatebird/Frigatebird_0051_43043.jpg,360,500,044.Frigatebird,1,91,342,447,171,269,341,356
../../CUB_200_2011/images\044.Frigatebird/Frigatebird_0049_43044.jpg,500,334,044.Frigatebird,2,14,441,332,221,173,439,318
../../CUB_200_2011/images\044.Frigatebird/Frigatebird_0034_43053.jpg,354,500,044.Frigatebird,4,63,339,446,171,254,335,383
../../CUB_200_2011/images\044.Frigatebird/Frigatebird_0060_43054.jpg,500,318,044.Frigatebird,53,22,422,302,237,162,369,280
../../CUB_200_2011/images\044.Frigatebird/Frigatebird_0097_43567.jpg,500,375,044.Frigatebird,87,76,363,373,225,224,276,297
../../CUB_200_2011/images\044.Frigatebird/Frigatebird_0008_43058.jpg,500,348,044.Frigatebird,79,40,289,266,184,153,210,226
../../CUB_200_2011/images\044.Frigatebird/Frigatebird_0096_43571.jpg,500,375,044.Frigatebird,192,99,308,370,250,234,116,271
../../CUB_200_2011/images\044.Frigatebird/Frigatebird_0012_43062.jpg,500,333,044.Frigatebird,30,103,344,274,187,188,314,171
../../CUB_200_2011/images\044.Frigatebird/Frigatebird_0080_43064.jpg,500,333,044.Frigatebird,3,49,379,331,191,190,376,282
../../CUB_200_2011/images\044.Frigatebird/Frigatebird_0091_43066.jpg,451,500,044.Frigatebird,95,102,289,408,192,255,194,306
../../CUB_200_2011/images\044.Frigatebird/Frigatebird_0050_43084.jpg,500,333,044.Frigatebird,33,19,437,255,235,137,404,236
../../CUB_200_2011/images\044.Frigatebird/Frigatebird_0001_43101.jpg,500,333,044.Frigatebird,67,86,439,240,253,163,372,154
../../CUB_200_2011/images\044.Frigatebird/Frigatebird_0023_43110.jpg,500,335,044.Frigatebird,35,62,483,280,259,171,448,218
../../CUB_200_2011/images\044.Frigatebird/Frigatebird_0015_43132.jpg,500,319,044.Frigatebird,133,34,471,319,302,176,338,285
../../CUB_200_2011/images\044.Frigatebird/Frigatebird_0016_43159.jpg,500,332,044.Frigatebird,51,7,236,323,143,165,185,316
../../CUB_200_2011/images\044.Frigatebird/Frigatebird_0129_43183.jpg,500,375,044.Frigatebird,159,2,499,188,329,95,340,186
../../CUB_200_2011/images\044.Frigatebird/Frigatebird_0118_43189.jpg,500,375,044.Frigatebird,118,62,363,336,240,199,245,274
../../CUB_200_2011/images\044.Frigatebird/Frigatebird_0062_43193.jpg,500,375,044.Frigatebird,0,49,372,305,186,177,372,256
../../CUB_200_2011/images\044.Frigatebird/Frigatebird_0088_43201.jpg,500,375,044.Frigatebird,88,2,424,310,256,156,336,308
../../CUB_200_2011/images\044.Frigatebird/Frigatebird_0092_43206.jpg,500,373,044.Frigatebird,58,2,252,368,155,185,194,366
../../CUB_200_2011/images\044.Frigatebird/Frigatebird_0098_43207.jpg,500,333,044.Frigatebird,7,65,415,310,211,187,408,245
../../CUB_200_2011/images\044.Frigatebird/Frigatebird_0011_43213.jpg,400,500,044.Frigatebird,141,130,275,350,208,240,134,220
../../CUB_200_2011/images\044.Frigatebird/Frigatebird_0053_43220.jpg,500,334,044.Frigatebird,128,138,255,271,191,204,127,133
../../CUB_200_2011/images\044.Frigatebird/Frigatebird_0004_43221.jpg,500,426,044.Frigatebird,128,63,388,371,258,217,260,308
../../CUB_200_2011/images\044.Frigatebird/Frigatebird_0058_43251.jpg,500,333,044.Frigatebird,0,50,406,243,203,146,406,193
../../CUB_200_2011/images\044.Frigatebird/Frigatebird_0107_42773.jpg,500,427,044.Frigatebird,55,37,451,398,253,217,396,361
../../CUB_200_2011/images\044.Frigatebird/Frigatebird_0081_42779.jpg,500,400,044.Frigatebird,0,8,456,397,228,202,456,389
../../CUB_200_2011/images\044.Frigatebird/Frigatebird_0095_42785.jpg,500,333,044.Frigatebird,1,30,443,332,222,181,442,302
../../CUB_200_2011/images\044.Frigatebird/Frigatebird_0120_43300.jpg,335,500,044.Frigatebird,116,90,232,293,174,191,116,203
../../CUB_200_2011/images\044.Frigatebird/Frigatebird_0121_42791.jpg,500,400,044.Frigatebird,24,52,355,399,189,225,331,347
../../CUB_200_2011/images\044.Frigatebird/Frigatebird_0068_42795.jpg,375,500,044.Frigatebird,101,144,232,473,166,308,131,329
../../CUB_200_2011/images\044.Frigatebird/Frigatebird_0114_42807.jpg,400,500,044.Frigatebird,20,78,378,447,199,262,358,369
../../CUB_200_2011/images\044.Frigatebird/Frigatebird_0063_42812.jpg,500,388,044.Frigatebird,70,132,407,359,238,245,337,227
../../CUB_200_2011/images\044.Frigatebird/Frigatebird_0045_42823.jpg,500,333,044.Frigatebird,52,48,499,225,275,136,447,177
../../CUB_200_2011/images\044.Frigatebird/Frigatebird_0005_42828.jpg,500,295,044.Frigatebird,135,76,297,253,216,164,162,177
../../CUB_200_2011/images\044.Frigatebird/Frigatebird_0019_43348.jpg,500,375,044.Frigatebird,10,138,490,251,250,194,480,113
../../CUB_200_2011/images\044.Frigatebird/Frigatebird_0059_42838.jpg,500,328,044.Frigatebird,2,69,429,327,215,198,427,258
../../CUB_200_2011/images\044.Frigatebird/Frigatebird_0040_42860.jpg,500,374,044.Frigatebird,161,84,393,264,277,174,232,180
../../CUB_200_2011/images\044.Frigatebird/Frigatebird_0006_43381.jpg,500,335,044.Frigatebird,175,64,291,219,233,141,116,155
../../CUB_200_2011/images\044.Frigatebird/Frigatebird_0112_43394.jpg,500,375,044.Frigatebird,105,31,395,136,250,83,290,105
../../CUB_200_2011/images\044.Frigatebird/Frigatebird_0116_43410.jpg,500,333,044.Frigatebird,52,25,298,297,175,161,246,272
../../CUB_200_2011/images\044.Frigatebird/Frigatebird_0052_43411.jpg,500,333,044.Frigatebird,209,95,321,260,265,177,112,165
../../CUB_200_2011/images\044.Frigatebird/Frigatebird_0035_43420.jpg,500,400,044.Frigatebird,262,77,435,299,348,188,173,222
../../CUB_200_2011/images\044.Frigatebird/Frigatebird_0021_42913.jpg,500,347,044.Frigatebird,135,64,401,249,268,156,266,185
../../CUB_200_2011/images\044.Frigatebird/Frigatebird_0022_43457.jpg,500,347,044.Frigatebird,55,90,416,213,235,151,361,123
../../CUB_200_2011/images\044.Frigatebird/Frigatebird_0115_42973.jpg,500,399,044.Frigatebird,14,61,471,329,242,195,457,268
../../CUB_200_2011/images\044.Frigatebird/Frigatebird_0031_42979.jpg,500,337,044.Frigatebird,0,127,499,297,249,212,499,170
../../CUB_200_2011/images\044.Frigatebird/Frigatebird_0082_42989.jpg,500,500,044.Frigatebird,97,130,469,283,283,206,372,153
../../CUB_200_2011/images\044.Frigatebird/Frigatebird_0084_43006.jpg,500,375,044.Frigatebird,3,2,497,370,250,186,494,368
../../CUB_200_2011/images\044.Frigatebird/Frigatebird_0090_43511.jpg,500,434,044.Frigatebird,43,51,422,427,232,239,379,376
../../CUB_200_2011/images\044.Frigatebird/Frigatebird_0070_43516.jpg,500,375,044.Frigatebird,104,42,497,298,300,170,393,256
../../CUB_200_2011/images\045.Northern_Fulmar/Northern_Fulmar_0029_44049.jpg,500,320,045.Northern_Fulmar,173,34,341,291,257,162,168,257
../../CUB_200_2011/images\045.Northern_Fulmar/Northern_Fulmar_0033_43794.jpg,500,333,045.Northern_Fulmar,139,81,492,305,315,193,353,224
../../CUB_200_2011/images\045.Northern_Fulmar/Northern_Fulmar_0103_44062.jpg,500,335,045.Northern_Fulmar,107,89,339,231,223,160,232,142
../../CUB_200_2011/images\045.Northern_Fulmar/Northern_Fulmar_0023_43809.jpg,500,333,045.Northern_Fulmar,195,80,334,203,264,141,139,123
../../CUB_200_2011/images\045.Northern_Fulmar/Northern_Fulmar_0060_43813.jpg,500,333,045.Northern_Fulmar,200,114,342,264,271,189,142,150
../../CUB_200_2011/images\045.Northern_Fulmar/Northern_Fulmar_0065_44081.jpg,500,298,045.Northern_Fulmar,67,57,357,199,212,128,290,142
../../CUB_200_2011/images\045.Northern_Fulmar/Northern_Fulmar_0074_43955.jpg,500,344,045.Northern_Fulmar,95,59,389,292,242,175,294,233
../../CUB_200_2011/images\045.Northern_Fulmar/Northern_Fulmar_0098_43578.jpg,500,375,045.Northern_Fulmar,16,54,433,296,224,175,417,242
../../CUB_200_2011/images\045.Northern_Fulmar/Northern_Fulmar_0045_43581.jpg,500,411,045.Northern_Fulmar,120,158,287,361,203,259,167,203
../../CUB_200_2011/images\045.Northern_Fulmar/Northern_Fulmar_0050_43839.jpg,500,333,045.Northern_Fulmar,65,69,247,214,156,141,182,145
../../CUB_200_2011/images\045.Northern_Fulmar/Northern_Fulmar_0053_43843.jpg,500,375,045.Northern_Fulmar,115,34,501,283,308,158,386,249
../../CUB_200_2011/images\045.Northern_Fulmar/Northern_Fulmar_0038_43846.jpg,500,333,045.Northern_Fulmar,174,71,328,280,251,175,154,209
../../CUB_200_2011/images\045.Northern_Fulmar/Northern_Fulmar_0019_43853.jpg,500,400,045.Northern_Fulmar,111,125,265,274,188,199,154,149
../../CUB_200_2011/images\045.Northern_Fulmar/Northern_Fulmar_0079_43599.jpg,500,333,045.Northern_Fulmar,29,51,349,289,189,170,320,238
../../CUB_200_2011/images\045.Northern_Fulmar/Northern_Fulmar_0010_44112.jpg,500,375,045.Northern_Fulmar,70,49,456,329,263,189,386,280
../../CUB_200_2011/images\045.Northern_Fulmar/Northern_Fulmar_0058_44114.jpg,500,331,045.Northern_Fulmar,32,171,186,307,109,239,154,136
../../CUB_200_2011/images\045.Northern_Fulmar/Northern_Fulmar_0095_43860.jpg,420,280,045.Northern_Fulmar,44,49,392,232,218,140,348,183
../../CUB_200_2011/images\045.Northern_Fulmar/Northern_Fulmar_0091_44120.jpg,500,333,045.Northern_Fulmar,68,42,494,269,281,155,426,227
../../CUB_200_2011/images\045.Northern_Fulmar/Northern_Fulmar_0097_43865.jpg,500,375,045.Northern_Fulmar,112,73,386,251,249,162,274,178
../../CUB_200_2011/images\045.Northern_Fulmar/Northern_Fulmar_0090_43867.jpg,500,332,045.Northern_Fulmar,7,139,444,241,225,190,437,102
../../CUB_200_2011/images\045.Northern_Fulmar/Northern_Fulmar_0083_43618.jpg,500,300,045.Northern_Fulmar,53,1,298,246,175,123,245,245
../../CUB_200_2011/images\045.Northern_Fulmar/Northern_Fulmar_0012_44131.jpg,500,375,045.Northern_Fulmar,227,137,338,244,282,190,111,107
../../CUB_200_2011/images\045.Northern_Fulmar/Northern_Fulmar_0056_43880.jpg,500,375,045.Northern_Fulmar,86,104,341,251,213,177,255,147
../../CUB_200_2011/images\045.Northern_Fulmar/Northern_Fulmar_0063_43631.jpg,500,333,045.Northern_Fulmar,61,0,388,193,224,96,327,193
../../CUB_200_2011/images\045.Northern_Fulmar/Northern_Fulmar_0076_43893.jpg,500,349,045.Northern_Fulmar,65,42,386,333,225,187,321,291
../../CUB_200_2011/images\045.Northern_Fulmar/Northern_Fulmar_0014_43895.jpg,500,357,045.Northern_Fulmar,156,63,290,239,223,151,134,176
../../CUB_200_2011/images\045.Northern_Fulmar/Northern_Fulmar_0008_43647.jpg,500,315,045.Northern_Fulmar,263,71,365,245,314,158,102,174
../../CUB_200_2011/images\045.Northern_Fulmar/Northern_Fulmar_0049_43906.jpg,500,457,045.Northern_Fulmar,181,119,300,341,240,230,119,222
../../CUB_200_2011/images\045.Northern_Fulmar/Northern_Fulmar_0061_43653.jpg,433,500,045.Northern_Fulmar,113,43,409,215,261,129,296,172
../../CUB_200_2011/images\045.Northern_Fulmar/Northern_Fulmar_0096_43654.jpg,500,333,045.Northern_Fulmar,56,21,224,249,140,135,168,228
../../CUB_200_2011/images\045.Northern_Fulmar/Northern_Fulmar_0081_43912.jpg,500,334,045.Northern_Fulmar,153,43,357,205,255,124,204,162
../../CUB_200_2011/images\045.Northern_Fulmar/Northern_Fulmar_0015_43658.jpg,500,333,045.Northern_Fulmar,164,49,335,228,249,138,171,179
../../CUB_200_2011/images\045.Northern_Fulmar/Northern_Fulmar_0070_43916.jpg,500,375,045.Northern_Fulmar,107,92,316,233,211,162,209,141
../../CUB_200_2011/images\045.Northern_Fulmar/Northern_Fulmar_0041_44013.jpg,500,338,045.Northern_Fulmar,202,64,452,267,327,165,250,203
../../CUB_200_2011/images\045.Northern_Fulmar/Northern_Fulmar_0048_43672.jpg,500,333,045.Northern_Fulmar,95,104,389,320,242,212,294,216
../../CUB_200_2011/images\045.Northern_Fulmar/Northern_Fulmar_0043_43685.jpg,500,333,045.Northern_Fulmar,112,93,383,279,247,186,271,186
../../CUB_200_2011/images\045.Northern_Fulmar/Northern_Fulmar_0039_43689.jpg,500,357,045.Northern_Fulmar,33,34,491,310,262,172,458,276
../../CUB_200_2011/images\045.Northern_Fulmar/Northern_Fulmar_0071_44146.jpg,500,329,045.Northern_Fulmar,57,91,438,234,247,162,381,143
../../CUB_200_2011/images\045.Northern_Fulmar/Northern_Fulmar_0047_43698.jpg,500,369,045.Northern_Fulmar,102,53,330,312,216,182,228,259
../../CUB_200_2011/images\045.Northern_Fulmar/Northern_Fulmar_0016_43958.jpg,500,369,045.Northern_Fulmar,21,43,400,273,210,158,379,230
../../CUB_200_2011/images\045.Northern_Fulmar/Northern_Fulmar_0027_43705.jpg,500,333,045.Northern_Fulmar,157,47,487,230,322,138,330,183
../../CUB_200_2011/images\045.Northern_Fulmar/Northern_Fulmar_0064_43710.jpg,500,333,045.Northern_Fulmar,149,36,283,289,216,162,134,253
../../CUB_200_2011/images\045.Northern_Fulmar/Northern_Fulmar_0037_43712.jpg,500,375,045.Northern_Fulmar,14,117,287,343,150,230,273,226
../../CUB_200_2011/images\045.Northern_Fulmar/Northern_Fulmar_0066_43714.jpg,500,380,045.Northern_Fulmar,42,29,435,344,238,186,393,315
../../CUB_200_2011/images\045.Northern_Fulmar/Northern_Fulmar_0036_43718.jpg,500,333,045.Northern_Fulmar,36,28,301,323,168,175,265,295
../../CUB_200_2011/images\045.Northern_Fulmar/Northern_Fulmar_0077_43730.jpg,500,489,045.Northern_Fulmar,18,74,483,422,250,248,465,348
../../CUB_200_2011/images\045.Northern_Fulmar/Northern_Fulmar_0100_43732.jpg,500,332,045.Northern_Fulmar,134,56,358,167,246,111,224,111
../../CUB_200_2011/images\045.Northern_Fulmar/Northern_Fulmar_0042_43739.jpg,500,378,045.Northern_Fulmar,18,99,393,267,205,183,375,168
../../CUB_200_2011/images\045.Northern_Fulmar/Northern_Fulmar_0021_43743.jpg,500,333,045.Northern_Fulmar,52,1,500,331,276,166,448,330
../../CUB_200_2011/images\045.Northern_Fulmar/Northern_Fulmar_0078_43985.jpg,500,344,045.Northern_Fulmar,79,104,341,237,210,170,262,133
../../CUB_200_2011/images\045.Northern_Fulmar/Northern_Fulmar_0001_43749.jpg,500,350,045.Northern_Fulmar,17,48,484,226,250,137,467,178
../../CUB_200_2011/images\045.Northern_Fulmar/Northern_Fulmar_0031_43750.jpg,500,375,045.Northern_Fulmar,10,53,417,329,213,191,407,276
../../CUB_200_2011/images\045.Northern_Fulmar/Northern_Fulmar_0052_43857.jpg,500,333,045.Northern_Fulmar,175,122,379,222,277,172,204,100
../../CUB_200_2011/images\045.Northern_Fulmar/Northern_Fulmar_0028_43752.jpg,500,333,045.Northern_Fulmar,91,3,496,310,293,156,405,307
../../CUB_200_2011/images\045.Northern_Fulmar/Northern_Fulmar_0006_43753.jpg,500,333,045.Northern_Fulmar,103,36,490,238,296,137,387,202
../../CUB_200_2011/images\045.Northern_Fulmar/Northern_Fulmar_0004_43755.jpg,500,375,045.Northern_Fulmar,108,106,460,264,284,185,352,158
../../CUB_200_2011/images\045.Northern_Fulmar/Northern_Fulmar_0099_44015.jpg,419,500,045.Northern_Fulmar,115,56,279,347,197,201,164,291
../../CUB_200_2011/images\045.Northern_Fulmar/Northern_Fulmar_0046_43760.jpg,500,332,045.Northern_Fulmar,61,14,378,277,219,145,317,263
../../CUB_200_2011/images\045.Northern_Fulmar/Northern_Fulmar_0011_43769.jpg,500,310,045.Northern_Fulmar,40,13,474,246,257,129,434,233
../../CUB_200_2011/images\045.Northern_Fulmar/Northern_Fulmar_0018_43771.jpg,461,500,045.Northern_Fulmar,117,37,339,395,228,216,222,358
../../CUB_200_2011/images\046.Gadwall/Gadwall_0022_31616.jpg,500,310,046.Gadwall,37,64,491,241,264,152,454,177
../../CUB_200_2011/images\046.Gadwall/Gadwall_0001_31235.jpg,500,444,046.Gadwall,113,174,429,288,271,231,316,114
../../CUB_200_2011/images\046.Gadwall/Gadwall_0019_30984.jpg,500,375,046.Gadwall,113,97,256,208,184,152,143,111
../../CUB_200_2011/images\046.Gadwall/Gadwall_0035_30985.jpg,500,278,046.Gadwall,42,43,376,190,209,116,334,147
../../CUB_200_2011/images\046.Gadwall/Gadwall_0058_31660.jpg,500,333,046.Gadwall,128,60,378,272,253,166,250,212
../../CUB_200_2011/images\046.Gadwall/Gadwall_0036_31760.jpg,500,333,046.Gadwall,61,59,318,172,189,115,257,113
../../CUB_200_2011/images\046.Gadwall/Gadwall_0080_31747.jpg,375,500,046.Gadwall,51,7,283,480,167,243,232,473
../../CUB_200_2011/images\046.Gadwall/Gadwall_0039_31013.jpg,500,333,046.Gadwall,134,54,473,234,303,144,339,180
../../CUB_200_2011/images\046.Gadwall/Gadwall_0017_30979.jpg,500,400,046.Gadwall,204,69,329,207,266,138,125,138
../../CUB_200_2011/images\046.Gadwall/Gadwall_0040_31788.jpg,500,306,046.Gadwall,65,82,369,271,217,176,304,189
../../CUB_200_2011/images\046.Gadwall/Gadwall_0007_31537.jpg,406,500,046.Gadwall,130,98,376,270,253,184,246,172
../../CUB_200_2011/images\046.Gadwall/Gadwall_0042_31411.jpg,500,429,046.Gadwall,158,70,391,235,274,152,233,165
../../CUB_200_2011/images\046.Gadwall/Gadwall_0069_31291.jpg,500,333,046.Gadwall,17,26,496,188,256,107,479,162
../../CUB_200_2011/images\046.Gadwall/Gadwall_0004_31669.jpg,367,500,046.Gadwall,68,116,347,388,207,252,279,272
../../CUB_200_2011/images\046.Gadwall/Gadwall_0082_31301.jpg,500,375,046.Gadwall,90,144,392,294,241,219,302,150
../../CUB_200_2011/images\046.Gadwall/Gadwall_0096_31560.jpg,500,336,046.Gadwall,77,33,425,193,251,113,348,160
../../CUB_200_2011/images\046.Gadwall/Gadwall_0079_31052.jpg,500,333,046.Gadwall,4,75,389,207,196,141,385,132
../../CUB_200_2011/images\046.Gadwall/Gadwall_0087_31821.jpg,500,363,046.Gadwall,112,22,479,337,295,179,367,315
../../CUB_200_2011/images\046.Gadwall/Gadwall_0048_31312.jpg,500,333,046.Gadwall,173,111,413,224,293,167,240,113
../../CUB_200_2011/images\046.Gadwall/Gadwall_0014_31570.jpg,500,375,046.Gadwall,154,170,470,291,312,230,316,121
../../CUB_200_2011/images\046.Gadwall/Gadwall_0041_31064.jpg,500,393,046.Gadwall,76,67,473,237,274,152,397,170
../../CUB_200_2011/images\046.Gadwall/Gadwall_0092_31162.jpg,394,500,046.Gadwall,23,76,332,460,177,268,309,384
../../CUB_200_2011/images\046.Gadwall/Gadwall_0064_31504.jpg,500,333,046.Gadwall,237,96,433,204,335,150,196,108
../../CUB_200_2011/images\046.Gadwall/Gadwall_0009_31847.jpg,500,375,046.Gadwall,81,35,444,332,262,183,363,297
../../CUB_200_2011/images\046.Gadwall/Gadwall_0088_31854.jpg,500,400,046.Gadwall,81,166,464,309,272,237,383,143
../../CUB_200_2011/images\046.Gadwall/Gadwall_0030_31855.jpg,500,332,046.Gadwall,94,42,431,258,262,150,337,216
../../CUB_200_2011/images\046.Gadwall/Gadwall_0086_31346.jpg,500,328,046.Gadwall,133,95,363,200,248,147,230,105
../../CUB_200_2011/images\046.Gadwall/Gadwall_0047_31360.jpg,500,384,046.Gadwall,32,69,465,268,248,168,433,199
../../CUB_200_2011/images\046.Gadwall/Gadwall_0028_31623.jpg,500,302,046.Gadwall,97,120,413,239,255,179,316,119
../../CUB_200_2011/images\046.Gadwall/Gadwall_0085_31171.jpg,500,329,046.Gadwall,21,32,466,207,243,119,445,175
../../CUB_200_2011/images\046.Gadwall/Gadwall_0029_31637.jpg,500,289,046.Gadwall,53,101,346,208,199,154,293,107
../../CUB_200_2011/images\046.Gadwall/Gadwall_0076_31639.jpg,500,304,046.Gadwall,163,117,459,241,311,179,296,124
../../CUB_200_2011/images\046.Gadwall/Gadwall_0059_31646.jpg,500,376,046.Gadwall,158,105,481,327,319,216,323,222
../../CUB_200_2011/images\046.Gadwall/Gadwall_0066_31557.jpg,500,348,046.Gadwall,25,108,380,255,202,181,355,147
../../CUB_200_2011/images\046.Gadwall/Gadwall_0068_30886.jpg,500,314,046.Gadwall,62,73,445,213,253,143,383,140
../../CUB_200_2011/images\046.Gadwall/Gadwall_0075_30892.jpg,500,348,046.Gadwall,19,159,329,313,174,236,310,154
../../CUB_200_2011/images\046.Gadwall/Gadwall_0097_30893.jpg,500,333,046.Gadwall,94,96,281,218,187,157,187,122
../../CUB_200_2011/images\046.Gadwall/Gadwall_0093_30898.jpg,500,334,046.Gadwall,100,73,456,228,278,150,356,155
../../CUB_200_2011/images\046.Gadwall/Gadwall_0010_31158.jpg,500,313,046.Gadwall,36,60,353,208,194,134,317,148
../../CUB_200_2011/images\046.Gadwall/Gadwall_0084_31135.jpg,500,397,046.Gadwall,102,80,425,289,263,184,323,209
../../CUB_200_2011/images\046.Gadwall/Gadwall_0095_30911.jpg,500,477,046.Gadwall,148,229,428,363,288,296,280,134
../../CUB_200_2011/images\046.Gadwall/Gadwall_0055_30912.jpg,500,375,046.Gadwall,58,44,305,238,181,141,247,194
../../CUB_200_2011/images\046.Gadwall/Gadwall_0065_31659.jpg,500,401,046.Gadwall,127,121,378,253,252,187,251,132
../../CUB_200_2011/images\046.Gadwall/Gadwall_0052_30915.jpg,500,312,046.Gadwall,65,64,440,259,252,161,375,195
../../CUB_200_2011/images\046.Gadwall/Gadwall_0060_31686.jpg,500,333,046.Gadwall,66,92,390,283,228,187,324,191
../../CUB_200_2011/images\046.Gadwall/Gadwall_0012_30920.jpg,500,396,046.Gadwall,3,4,365,375,184,189,362,371
../../CUB_200_2011/images\046.Gadwall/Gadwall_0050_31223.jpg,500,488,046.Gadwall,121,112,440,254,280,183,319,142
../../CUB_200_2011/images\046.Gadwall/Gadwall_0005_30924.jpg,500,353,046.Gadwall,47,88,430,256,238,172,383,168
../../CUB_200_2011/images\046.Gadwall/Gadwall_0077_30929.jpg,500,371,046.Gadwall,106,116,339,239,222,177,233,123
../../CUB_200_2011/images\046.Gadwall/Gadwall_0070_31187.jpg,500,334,046.Gadwall,76,62,444,209,260,135,368,147
../../CUB_200_2011/images\046.Gadwall/Gadwall_0025_30933.jpg,500,319,046.Gadwall,160,66,407,195,283,130,247,129
../../CUB_200_2011/images\046.Gadwall/Gadwall_0031_30935.jpg,500,375,046.Gadwall,20,83,377,226,198,154,357,143
../../CUB_200_2011/images\046.Gadwall/Gadwall_0049_30936.jpg,500,385,046.Gadwall,88,96,387,224,237,160,299,128
../../CUB_200_2011/images\046.Gadwall/Gadwall_0091_30941.jpg,500,333,046.Gadwall,35,31,422,317,228,174,387,286
../../CUB_200_2011/images\046.Gadwall/Gadwall_0024_30942.jpg,500,331,046.Gadwall,132,66,335,248,233,157,203,182
../../CUB_200_2011/images\046.Gadwall/Gadwall_0071_31655.jpg,500,334,046.Gadwall,157,122,456,226,306,174,299,104
../../CUB_200_2011/images\046.Gadwall/Gadwall_0034_31212.jpg,500,333,046.Gadwall,123,72,292,211,207,141,169,139
../../CUB_200_2011/images\046.Gadwall/Gadwall_0083_30959.jpg,500,333,046.Gadwall,22,130,313,244,167,187,291,114
../../CUB_200_2011/images\046.Gadwall/Gadwall_0027_30966.jpg,500,365,046.Gadwall,108,111,465,215,286,163,357,104
../../CUB_200_2011/images\046.Gadwall/Gadwall_0013_31020.jpg,500,342,046.Gadwall,73,97,414,243,243,170,341,146
../../CUB_200_2011/images\047.American_Goldfinch/American_Goldfinch_0074_32265.jpg,332,500,047.American_Goldfinch,39,169,289,375,164,272,250,206
../../CUB_200_2011/images\047.American_Goldfinch/American_Goldfinch_0017_32272.jpg,400,500,047.American_Goldfinch,51,91,290,408,170,249,239,317
../../CUB_200_2011/images\047.American_Goldfinch/American_Goldfinch_0136_32277.jpg,500,333,047.American_Goldfinch,96,73,241,193,168,133,145,120
../../CUB_200_2011/images\047.American_Goldfinch/American_Goldfinch_0061_32281.jpg,500,333,047.American_Goldfinch,237,59,420,309,328,184,183,250
../../CUB_200_2011/images\047.American_Goldfinch/American_Goldfinch_0133_32802.jpg,500,333,047.American_Goldfinch,193,87,338,282,265,184,145,195
../../CUB_200_2011/images\047.American_Goldfinch/American_Goldfinch_0084_32295.jpg,500,400,047.American_Goldfinch,40,218,302,380,171,299,262,162
../../CUB_200_2011/images\047.American_Goldfinch/American_Goldfinch_0001_32306.jpg,500,390,047.American_Goldfinch,108,84,356,339,232,211,248,255
../../CUB_200_2011/images\047.American_Goldfinch/American_Goldfinch_0040_32323.jpg,500,381,047.American_Goldfinch,204,82,356,331,280,206,152,249
../../CUB_200_2011/images\047.American_Goldfinch/American_Goldfinch_0018_32324.jpg,500,357,047.American_Goldfinch,62,49,264,188,163,118,202,139
../../CUB_200_2011/images\047.American_Goldfinch/American_Goldfinch_0128_32333.jpg,500,372,047.American_Goldfinch,68,72,379,347,223,209,311,275
../../CUB_200_2011/images\047.American_Goldfinch/American_Goldfinch_0012_32338.jpg,500,348,047.American_Goldfinch,102,77,448,287,275,182,346,210
../../CUB_200_2011/images\047.American_Goldfinch/American_Goldfinch_0053_32359.jpg,500,473,047.American_Goldfinch,16,135,223,455,119,295,207,320
../../CUB_200_2011/images\047.American_Goldfinch/American_Goldfinch_0115_32362.jpg,500,357,047.American_Goldfinch,188,69,371,231,279,150,183,162
../../CUB_200_2011/images\047.American_Goldfinch/American_Goldfinch_0087_32363.jpg,500,499,047.American_Goldfinch,107,76,410,469,258,272,303,393
../../CUB_200_2011/images\047.American_Goldfinch/American_Goldfinch_0048_32885.jpg,500,341,047.American_Goldfinch,26,18,453,329,239,173,427,311
../../CUB_200_2011/images\047.American_Goldfinch/American_Goldfinch_0135_32107.jpg,500,500,047.American_Goldfinch,50,215,225,355,137,285,175,140
../../CUB_200_2011/images\047.American_Goldfinch/American_Goldfinch_0096_31876.jpg,500,400,047.American_Goldfinch,81,124,247,315,164,219,166,191
../../CUB_200_2011/images\047.American_Goldfinch/American_Goldfinch_0092_32910.jpg,500,333,047.American_Goldfinch,197,76,368,193,282,134,171,117
../../CUB_200_2011/images\047.American_Goldfinch/American_Goldfinch_0086_31887.jpg,500,362,047.American_Goldfinch,145,89,462,324,303,206,317,235
../../CUB_200_2011/images\047.American_Goldfinch/American_Goldfinch_0049_31889.jpg,500,412,047.American_Goldfinch,191,57,438,385,314,221,247,328
../../CUB_200_2011/images\047.American_Goldfinch/American_Goldfinch_0082_31890.jpg,500,486,047.American_Goldfinch,201,68,428,468,314,268,227,400
../../CUB_200_2011/images\047.American_Goldfinch/American_Goldfinch_0090_31893.jpg,500,460,047.American_Goldfinch,185,153,386,417,285,285,201,264
../../CUB_200_2011/images\047.American_Goldfinch/American_Goldfinch_0134_32409.jpg,500,301,047.American_Goldfinch,94,92,219,237,156,164,125,145
../../CUB_200_2011/images\047.American_Goldfinch/American_Goldfinch_0004_31903.jpg,500,342,047.American_Goldfinch,180,91,460,196,320,143,280,105
../../CUB_200_2011/images\047.American_Goldfinch/American_Goldfinch_0036_31910.jpg,332,500,047.American_Goldfinch,6,127,229,393,117,260,223,266
../../CUB_200_2011/images\047.American_Goldfinch/American_Goldfinch_0050_31913.jpg,500,380,047.American_Goldfinch,173,135,444,289,308,212,271,154
../../CUB_200_2011/images\047.American_Goldfinch/American_Goldfinch_0062_31921.jpg,500,333,047.American_Goldfinch,217,76,448,287,332,181,231,211
../../CUB_200_2011/images\047.American_Goldfinch/American_Goldfinch_0032_31922.jpg,459,500,047.American_Goldfinch,183,182,330,358,256,270,147,176
../../CUB_200_2011/images\047.American_Goldfinch/American_Goldfinch_0034_32371.jpg,500,333,047.American_Goldfinch,43,89,375,242,209,165,332,153
../../CUB_200_2011/images\047.American_Goldfinch/American_Goldfinch_0091_31938.jpg,500,436,047.American_Goldfinch,102,71,384,316,243,193,282,245
../../CUB_200_2011/images\047.American_Goldfinch/American_Goldfinch_0116_31943.jpg,333,500,047.American_Goldfinch,103,28,280,474,191,251,177,446
../../CUB_200_2011/images\047.American_Goldfinch/American_Goldfinch_0108_32974.jpg,500,333,047.American_Goldfinch,248,104,367,270,307,187,119,166
../../CUB_200_2011/images\047.American_Goldfinch/American_Goldfinch_0126_32480.jpg,500,375,047.American_Goldfinch,109,63,250,235,179,149,141,172
../../CUB_200_2011/images\047.American_Goldfinch/American_Goldfinch_0041_31969.jpg,500,321,047.American_Goldfinch,90,44,290,296,190,170,200,252
../../CUB_200_2011/images\047.American_Goldfinch/American_Goldfinch_0045_31974.jpg,500,375,047.American_Goldfinch,127,137,291,240,209,188,164,103
../../CUB_200_2011/images\047.American_Goldfinch/American_Goldfinch_0042_31979.jpg,357,500,047.American_Goldfinch,48,78,331,454,189,266,283,376
../../CUB_200_2011/images\047.American_Goldfinch/American_Goldfinch_0043_31993.jpg,500,386,047.American_Goldfinch,166,38,475,383,320,210,309,345
../../CUB_200_2011/images\047.American_Goldfinch/American_Goldfinch_0111_32022.jpg,500,333,047.American_Goldfinch,178,138,487,300,332,219,309,162
../../CUB_200_2011/images\047.American_Goldfinch/American_Goldfinch_0104_32540.jpg,500,342,047.American_Goldfinch,24,27,463,315,243,171,439,288
../../CUB_200_2011/images\047.American_Goldfinch/American_Goldfinch_0123_32505.jpg,500,375,047.American_Goldfinch,210,56,427,216,318,136,217,160
../../CUB_200_2011/images\047.American_Goldfinch/American_Goldfinch_0037_32071.jpg,500,363,047.American_Goldfinch,250,57,407,354,328,205,157,297
../../CUB_200_2011/images\047.American_Goldfinch/American_Goldfinch_0131_32911.jpg,500,375,047.American_Goldfinch,276,139,446,288,361,213,170,149
../../CUB_200_2011/images\047.American_Goldfinch/American_Goldfinch_0046_32105.jpg,373,500,047.American_Goldfinch,83,148,261,437,172,292,178,289
../../CUB_200_2011/images\047.American_Goldfinch/American_Goldfinch_0107_32618.jpg,358,500,047.American_Goldfinch,38,58,290,379,164,218,252,321
../../CUB_200_2011/images\047.American_Goldfinch/American_Goldfinch_0022_32111.jpg,333,500,047.American_Goldfinch,42,146,235,343,138,244,193,197
../../CUB_200_2011/images\047.American_Goldfinch/American_Goldfinch_0129_32625.jpg,500,333,047.American_Goldfinch,90,112,256,242,173,177,166,130
../../CUB_200_2011/images\047.American_Goldfinch/American_Goldfinch_0064_32142.jpg,500,333,047.American_Goldfinch,114,46,411,246,262,146,297,200
../../CUB_200_2011/images\047.American_Goldfinch/American_Goldfinch_0089_32152.jpg,500,399,047.American_Goldfinch,47,136,429,316,238,226,382,180
../../CUB_200_2011/images\047.American_Goldfinch/American_Goldfinch_0014_32154.jpg,358,500,047.American_Goldfinch,52,116,284,415,168,265,232,299
../../CUB_200_2011/images\047.American_Goldfinch/American_Goldfinch_0056_32169.jpg,458,500,047.American_Goldfinch,134,87,428,462,281,274,294,375
../../CUB_200_2011/images\047.American_Goldfinch/American_Goldfinch_0106_32182.jpg,500,488,047.American_Goldfinch,212,138,456,414,334,276,244,276
../../CUB_200_2011/images\047.American_Goldfinch/American_Goldfinch_0100_32183.jpg,333,500,047.American_Goldfinch,115,153,305,447,210,300,190,294
../../CUB_200_2011/images\047.American_Goldfinch/American_Goldfinch_0122_32186.jpg,500,335,047.American_Goldfinch,79,77,474,330,276,203,395,253
../../CUB_200_2011/images\047.American_Goldfinch/American_Goldfinch_0118_32210.jpg,500,336,047.American_Goldfinch,156,103,439,216,297,159,283,113
../../CUB_200_2011/images\047.American_Goldfinch/American_Goldfinch_0121_32725.jpg,500,349,047.American_Goldfinch,44,84,202,296,123,190,158,212
../../CUB_200_2011/images\047.American_Goldfinch/American_Goldfinch_0029_32218.jpg,500,470,047.American_Goldfinch,244,137,392,454,318,295,148,317
../../CUB_200_2011/images\047.American_Goldfinch/American_Goldfinch_0026_32222.jpg,500,345,047.American_Goldfinch,140,135,249,270,194,202,109,135
../../CUB_200_2011/images\047.American_Goldfinch/American_Goldfinch_0103_32225.jpg,384,500,047.American_Goldfinch,139,107,350,499,244,303,211,392
../../CUB_200_2011/images\047.American_Goldfinch/American_Goldfinch_0003_32236.jpg,500,395,047.American_Goldfinch,52,112,370,283,211,197,318,171
../../CUB_200_2011/images\047.American_Goldfinch/American_Goldfinch_0105_32238.jpg,342,500,047.American_Goldfinch,61,95,246,410,153,252,185,315
../../CUB_200_2011/images\048.European_Goldfinch/European_Goldfinch_0073_794633.jpg,500,347,048.European_Goldfinch,149,126,277,300,213,213,128,174
../../CUB_200_2011/images\048.European_Goldfinch/European_Goldfinch_0104_794634.jpg,400,247,048.European_Goldfinch,10,24,301,211,155,117,291,187
../../CUB_200_2011/images\048.European_Goldfinch/European_Goldfinch_0067_794637.jpg,333,500,048.European_Goldfinch,45,64,213,358,129,211,168,294
../../CUB_200_2011/images\048.European_Goldfinch/European_Goldfinch_0017_794638.jpg,500,365,048.European_Goldfinch,2,4,470,360,236,182,468,356
../../CUB_200_2011/images\048.European_Goldfinch/European_Goldfinch_0053_794639.jpg,400,297,048.European_Goldfinch,8,59,306,285,157,172,298,226
../../CUB_200_2011/images\048.European_Goldfinch/European_Goldfinch_0036_794642.jpg,500,500,048.European_Goldfinch,164,109,478,319,321,214,314,210
../../CUB_200_2011/images\048.European_Goldfinch/European_Goldfinch_0040_794643.jpg,500,399,048.European_Goldfinch,197,82,466,222,331,152,269,140
../../CUB_200_2011/images\048.European_Goldfinch/European_Goldfinch_0020_794644.jpg,349,500,048.European_Goldfinch,53,61,292,371,172,216,239,310
../../CUB_200_2011/images\048.European_Goldfinch/European_Goldfinch_0041_794645.jpg,500,363,048.European_Goldfinch,177,55,425,246,301,150,248,191
../../CUB_200_2011/images\048.European_Goldfinch/European_Goldfinch_0012_794646.jpg,300,317,048.European_Goldfinch,94,110,204,230,149,170,110,120
../../CUB_200_2011/images\048.European_Goldfinch/European_Goldfinch_0025_794647.jpg,500,375,048.European_Goldfinch,20,71,372,269,196,170,352,198
../../CUB_200_2011/images\048.European_Goldfinch/European_Goldfinch_0090_794648.jpg,480,320,048.European_Goldfinch,238,63,455,259,346,161,217,196
../../CUB_200_2011/images\048.European_Goldfinch/European_Goldfinch_0088_794651.jpg,375,500,048.European_Goldfinch,12,98,235,390,123,244,223,292
../../CUB_200_2011/images\048.European_Goldfinch/European_Goldfinch_0093_794653.jpg,357,500,048.European_Goldfinch,80,159,303,294,191,226,223,135
../../CUB_200_2011/images\048.European_Goldfinch/European_Goldfinch_0107_794655.jpg,376,500,048.European_Goldfinch,84,120,210,404,147,262,126,284
../../CUB_200_2011/images\048.European_Goldfinch/European_Goldfinch_0048_794656.jpg,180,240,048.European_Goldfinch,24,52,136,195,80,123,112,143
../../CUB_200_2011/images\048.European_Goldfinch/European_Goldfinch_0004_33313.jpg,370,500,048.European_Goldfinch,53,189,248,389,150,289,195,200
../../CUB_200_2011/images\048.European_Goldfinch/European_Goldfinch_0075_794660.jpg,270,360,048.European_Goldfinch,26,33,268,358,147,195,242,325
../../CUB_200_2011/images\048.European_Goldfinch/European_Goldfinch_0006_794661.jpg,500,334,048.European_Goldfinch,58,50,395,272,226,161,337,222
../../CUB_200_2011/images\048.European_Goldfinch/European_Goldfinch_0103_794664.jpg,500,435,048.European_Goldfinch,34,109,392,318,213,213,358,209
../../CUB_200_2011/images\048.European_Goldfinch/European_Goldfinch_0058_794665.jpg,288,288,048.European_Goldfinch,50,61,210,268,130,164,160,207
../../CUB_200_2011/images\048.European_Goldfinch/European_Goldfinch_0080_33322.jpg,500,333,048.European_Goldfinch,101,17,349,135,225,76,248,118
../../CUB_200_2011/images\048.European_Goldfinch/European_Goldfinch_0064_794670.jpg,500,334,048.European_Goldfinch,207,54,452,246,329,150,245,192
../../CUB_200_2011/images\048.European_Goldfinch/European_Goldfinch_0092_794671.jpg,348,500,048.European_Goldfinch,18,204,331,454,174,329,313,250
../../CUB_200_2011/images\048.European_Goldfinch/European_Goldfinch_0014_794672.jpg,500,375,048.European_Goldfinch,89,99,368,319,228,209,279,220
../../CUB_200_2011/images\048.European_Goldfinch/European_Goldfinch_0094_794673.jpg,300,265,048.European_Goldfinch,100,45,262,209,181,127,162,164
../../CUB_200_2011/images\048.European_Goldfinch/European_Goldfinch_0022_794674.jpg,500,341,048.European_Goldfinch,81,49,313,297,197,173,232,248
../../CUB_200_2011/images\048.European_Goldfinch/European_Goldfinch_0038_794675.jpg,500,375,048.European_Goldfinch,251,90,444,276,347,183,193,186
../../CUB_200_2011/images\048.European_Goldfinch/European_Goldfinch_0047_33332.jpg,500,500,048.European_Goldfinch,107,150,276,388,191,269,169,238
../../CUB_200_2011/images\048.European_Goldfinch/European_Goldfinch_0032_794679.jpg,300,400,048.European_Goldfinch,34,81,246,333,140,207,212,252
../../CUB_200_2011/images\048.European_Goldfinch/European_Goldfinch_0085_794682.jpg,314,239,048.European_Goldfinch,6,11,275,225,140,118,269,214
../../CUB_200_2011/images\048.European_Goldfinch/European_Goldfinch_0100_794685.jpg,500,381,048.European_Goldfinch,67,44,340,340,203,192,273,296
../../CUB_200_2011/images\048.European_Goldfinch/European_Goldfinch_0013_794687.jpg,340,268,048.European_Goldfinch,9,6,315,266,162,136,306,260
../../CUB_200_2011/images\048.European_Goldfinch/European_Goldfinch_0097_794688.jpg,500,375,048.European_Goldfinch,100,46,287,330,193,188,187,284
../../CUB_200_2011/images\048.European_Goldfinch/European_Goldfinch_0077_33346.jpg,500,324,048.European_Goldfinch,242,101,430,205,336,153,188,104
../../CUB_200_2011/images\048.European_Goldfinch/European_Goldfinch_0074_33348.jpg,500,334,048.European_Goldfinch,160,120,294,270,227,195,134,150
../../CUB_200_2011/images\048.European_Goldfinch/European_Goldfinch_0087_794693.jpg,395,500,048.European_Goldfinch,135,106,342,333,238,219,207,227
../../CUB_200_2011/images\048.European_Goldfinch/European_Goldfinch_0030_33357.jpg,500,333,048.European_Goldfinch,269,154,473,302,371,228,204,148
../../CUB_200_2011/images\048.European_Goldfinch/European_Goldfinch_0068_33359.jpg,500,302,048.European_Goldfinch,248,89,414,232,331,160,166,143
../../CUB_200_2011/images\048.European_Goldfinch/European_Goldfinch_0052_33082.jpg,500,375,048.European_Goldfinch,269,84,426,340,347,212,157,256
../../CUB_200_2011/images\048.European_Goldfinch/European_Goldfinch_0101_33127.jpg,375,500,048.European_Goldfinch,61,56,328,440,194,248,267,384
../../CUB_200_2011/images\048.European_Goldfinch/European_Goldfinch_0070_33084.jpg,500,335,048.European_Goldfinch,264,130,415,255,339,192,151,125
../../CUB_200_2011/images\048.European_Goldfinch/European_Goldfinch_0106_33298.jpg,378,500,048.European_Goldfinch,50,95,370,403,210,249,320,308
../../CUB_200_2011/images\048.European_Goldfinch/European_Goldfinch_0037_33149.jpg,500,313,048.European_Goldfinch,218,72,421,272,319,172,203,200
../../CUB_200_2011/images\048.European_Goldfinch/European_Goldfinch_0098_33152.jpg,340,500,048.European_Goldfinch,83,262,219,394,151,328,136,132
../../CUB_200_2011/images\048.European_Goldfinch/European_Goldfinch_0008_33153.jpg,500,352,048.European_Goldfinch,155,129,363,284,259,206,208,155
../../CUB_200_2011/images\048.European_Goldfinch/European_Goldfinch_0045_794690.jpg,360,260,048.European_Goldfinch,129,66,295,190,212,128,166,124
../../CUB_200_2011/images\048.European_Goldfinch/European_Goldfinch_0054_33169.jpg,500,336,048.European_Goldfinch,36,79,308,269,172,174,272,190
../../CUB_200_2011/images\048.European_Goldfinch/European_Goldfinch_0078_33170.jpg,500,349,048.European_Goldfinch,43,104,209,204,126,154,166,100
../../CUB_200_2011/images\048.European_Goldfinch/European_Goldfinch_0076_33173.jpg,357,500,048.European_Goldfinch,88,113,315,263,201,188,227,150
../../CUB_200_2011/images\048.European_Goldfinch/European_Goldfinch_0108_33176.jpg,500,375,048.European_Goldfinch,130,82,244,212,187,147,114,130
../../CUB_200_2011/images\048.European_Goldfinch/European_Goldfinch_0081_33259.jpg,500,375,048.European_Goldfinch,39,17,451,373,245,195,412,356
../../CUB_200_2011/images\048.European_Goldfinch/European_Goldfinch_0046_33307.jpg,500,333,048.European_Goldfinch,36,80,313,228,174,154,277,148
../../CUB_200_2011/images\048.European_Goldfinch/European_Goldfinch_0011_794676.jpg,500,338,048.European_Goldfinch,147,46,456,316,301,181,309,270
../../CUB_200_2011/images\048.European_Goldfinch/European_Goldfinch_0062_794657.jpg,500,334,048.European_Goldfinch,44,33,366,307,205,170,322,274
../../CUB_200_2011/images\048.European_Goldfinch/European_Goldfinch_0084_33147.jpg,500,379,048.European_Goldfinch,225,100,486,270,355,185,261,170
../../CUB_200_2011/images\048.European_Goldfinch/European_Goldfinch_0034_33256.jpg,500,332,048.European_Goldfinch,5,25,288,280,146,152,283,255
../../CUB_200_2011/images\048.European_Goldfinch/European_Goldfinch_0005_33263.jpg,500,375,048.European_Goldfinch,145,71,455,229,300,150,310,158
../../CUB_200_2011/images\048.European_Goldfinch/European_Goldfinch_0003_33066.jpg,500,375,048.European_Goldfinch,4,29,381,318,192,173,377,289
../../CUB_200_2011/images\048.European_Goldfinch/European_Goldfinch_0089_33279.jpg,500,407,048.European_Goldfinch,111,89,431,335,271,212,320,246
../../CUB_200_2011/images\049.Boat_tailed_Grackle/Boat_Tailed_Grackle_0096_33801.jpg,500,347,049.Boat_tailed_Grackle,190,98,346,202,268,150,156,104
../../CUB_200_2011/images\049.Boat_tailed_Grackle/Boat_Tailed_Grackle_0073_33723.jpg,500,340,049.Boat_tailed_Grackle,64,35,436,293,250,164,372,258
../../CUB_200_2011/images\049.Boat_tailed_Grackle/Boat_Tailed_Grackle_0089_33807.jpg,500,333,049.Boat_tailed_Grackle,153,48,331,315,242,181,178,267
../../CUB_200_2011/images\049.Boat_tailed_Grackle/Boat_Tailed_Grackle_0116_33808.jpg,328,500,049.Boat_tailed_Grackle,43,22,269,470,156,246,226,448
../../CUB_200_2011/images\049.Boat_tailed_Grackle/Boat_Tailed_Grackle_0066_33368.jpg,500,429,049.Boat_tailed_Grackle,101,111,479,357,290,234,378,246
../../CUB_200_2011/images\049.Boat_tailed_Grackle/Boat_Tailed_Grackle_0086_33818.jpg,500,357,049.Boat_tailed_Grackle,15,18,501,351,258,184,486,333
../../CUB_200_2011/images\049.Boat_tailed_Grackle/Boat_Tailed_Grackle_0095_33568.jpg,500,336,049.Boat_tailed_Grackle,89,63,320,309,204,186,231,246
../../CUB_200_2011/images\049.Boat_tailed_Grackle/Boat_Tailed_Grackle_0117_33576.jpg,500,333,049.Boat_tailed_Grackle,180,121,466,276,323,198,286,155
../../CUB_200_2011/images\049.Boat_tailed_Grackle/Boat_Tailed_Grackle_0075_33839.jpg,500,355,049.Boat_tailed_Grackle,56,92,406,318,231,205,350,226
../../CUB_200_2011/images\049.Boat_tailed_Grackle/Boat_Tailed_Grackle_0112_33841.jpg,500,333,049.Boat_tailed_Grackle,131,81,293,258,212,169,162,177
../../CUB_200_2011/images\049.Boat_tailed_Grackle/Boat_Tailed_Grackle_0060_33589.jpg,500,375,049.Boat_tailed_Grackle,272,107,440,339,356,223,168,232
../../CUB_200_2011/images\049.Boat_tailed_Grackle/Boat_Tailed_Grackle_0126_33593.jpg,500,371,049.Boat_tailed_Grackle,100,46,358,351,229,198,258,305
../../CUB_200_2011/images\049.Boat_tailed_Grackle/Boat_Tailed_Grackle_0051_33600.jpg,500,333,049.Boat_tailed_Grackle,162,27,485,318,323,172,323,291
../../CUB_200_2011/images\049.Boat_tailed_Grackle/Boat_Tailed_Grackle_0004_33858.jpg,401,500,049.Boat_tailed_Grackle,79,140,296,328,187,234,217,188
../../CUB_200_2011/images\049.Boat_tailed_Grackle/Boat_Tailed_Grackle_0083_33590.jpg,333,500,049.Boat_tailed_Grackle,78,158,292,401,185,279,214,243
../../CUB_200_2011/images\049.Boat_tailed_Grackle/Boat_Tailed_Grackle_0125_33867.jpg,500,354,049.Boat_tailed_Grackle,63,44,470,343,266,193,407,299
../../CUB_200_2011/images\049.Boat_tailed_Grackle/Boat_Tailed_Grackle_0070_33612.jpg,357,500,049.Boat_tailed_Grackle,64,90,264,451,164,270,200,361
../../CUB_200_2011/images\049.Boat_tailed_Grackle/Boat_Tailed_Grackle_0030_33615.jpg,500,364,049.Boat_tailed_Grackle,43,136,395,362,219,249,352,226
../../CUB_200_2011/images\049.Boat_tailed_Grackle/Boat_Tailed_Grackle_0028_33777.jpg,500,333,049.Boat_tailed_Grackle,39,103,379,226,209,164,340,123
../../CUB_200_2011/images\049.Boat_tailed_Grackle/Boat_Tailed_Grackle_0087_33369.jpg,500,332,049.Boat_tailed_Grackle,13,106,377,317,195,211,364,211
../../CUB_200_2011/images\049.Boat_tailed_Grackle/Boat_Tailed_Grackle_0009_33373.jpg,484,500,049.Boat_tailed_Grackle,82,59,437,462,259,260,355,403
../../CUB_200_2011/images\049.Boat_tailed_Grackle/Boat_Tailed_Grackle_0056_33649.jpg,500,334,049.Boat_tailed_Grackle,173,106,357,257,265,181,184,151
../../CUB_200_2011/images\049.Boat_tailed_Grackle/Boat_Tailed_Grackle_0054_33633.jpg,500,383,049.Boat_tailed_Grackle,151,37,435,361,293,199,284,324
../../CUB_200_2011/images\049.Boat_tailed_Grackle/Boat_Tailed_Grackle_0043_33595.jpg,500,375,049.Boat_tailed_Grackle,169,26,499,374,334,200,330,348
../../CUB_200_2011/images\049.Boat_tailed_Grackle/Boat_Tailed_Grackle_0085_33384.jpg,500,362,049.Boat_tailed_Grackle,111,53,350,289,230,171,239,236
../../CUB_200_2011/images\049.Boat_tailed_Grackle/Boat_Tailed_Grackle_0068_33387.jpg,358,500,049.Boat_tailed_Grackle,83,212,285,428,184,320,202,216
../../CUB_200_2011/images\049.Boat_tailed_Grackle/Boat_Tailed_Grackle_0024_33393.jpg,500,400,049.Boat_tailed_Grackle,65,80,456,400,260,240,391,320
../../CUB_200_2011/images\049.Boat_tailed_Grackle/Boat_Tailed_Grackle_0062_33650.jpg,435,500,049.Boat_tailed_Grackle,52,106,394,497,223,301,342,391
../../CUB_200_2011/images\049.Boat_tailed_Grackle/Boat_Tailed_Grackle_0041_33396.jpg,500,335,049.Boat_tailed_Grackle,244,83,421,277,332,180,177,194
../../CUB_200_2011/images\049.Boat_tailed_Grackle/Boat_Tailed_Grackle_0108_33398.jpg,500,405,049.Boat_tailed_Grackle,6,117,445,395,225,256,439,278
../../CUB_200_2011/images\049.Boat_tailed_Grackle/Boat_Tailed_Grackle_0040_33417.jpg,500,450,049.Boat_tailed_Grackle,139,95,359,389,249,242,220,294
../../CUB_200_2011/images\049.Boat_tailed_Grackle/Boat_Tailed_Grackle_0052_33676.jpg,500,372,049.Boat_tailed_Grackle,76,86,347,340,211,213,271,254
../../CUB_200_2011/images\049.Boat_tailed_Grackle/Boat_Tailed_Grackle_0049_33422.jpg,500,376,049.Boat_tailed_Grackle,119,45,438,359,278,202,319,314
../../CUB_200_2011/images\049.Boat_tailed_Grackle/Boat_Tailed_Grackle_0065_33423.jpg,500,333,049.Boat_tailed_Grackle,122,55,463,282,292,168,341,227
../../CUB_200_2011/images\049.Boat_tailed_Grackle/Boat_Tailed_Grackle_0069_33685.jpg,500,375,049.Boat_tailed_Grackle,150,117,499,321,324,219,349,204
../../CUB_200_2011/images\049.Boat_tailed_Grackle/Boat_Tailed_Grackle_0019_33687.jpg,400,500,049.Boat_tailed_Grackle,44,39,243,384,143,211,199,345
../../CUB_200_2011/images\049.Boat_tailed_Grackle/Boat_Tailed_Grackle_0088_33448.jpg,500,401,049.Boat_tailed_Grackle,145,70,439,369,292,219,294,299
../../CUB_200_2011/images\049.Boat_tailed_Grackle/Boat_Tailed_Grackle_0099_33455.jpg,403,500,049.Boat_tailed_Grackle,96,162,389,474,242,318,293,312
../../CUB_200_2011/images\049.Boat_tailed_Grackle/Boat_Tailed_Grackle_0123_33695.jpg,500,333,049.Boat_tailed_Grackle,194,117,358,245,276,181,164,128
../../CUB_200_2011/images\049.Boat_tailed_Grackle/Boat_Tailed_Grackle_0100_33985.jpg,500,375,049.Boat_tailed_Grackle,191,86,342,271,266,178,151,185
../../CUB_200_2011/images\049.Boat_tailed_Grackle/Boat_Tailed_Grackle_0101_33611.jpg,500,363,049.Boat_tailed_Grackle,20,37,402,359,211,198,382,322
../../CUB_200_2011/images\049.Boat_tailed_Grackle/Boat_Tailed_Grackle_0017_33480.jpg,500,332,049.Boat_tailed_Grackle,143,53,462,267,302,160,319,214
../../CUB_200_2011/images\049.Boat_tailed_Grackle/Boat_Tailed_Grackle_0014_33485.jpg,400,500,049.Boat_tailed_Grackle,101,132,275,451,188,291,174,319
../../CUB_200_2011/images\049.Boat_tailed_Grackle/Boat_Tailed_Grackle_0012_33998.jpg,500,290,049.Boat_tailed_Grackle,233,28,396,238,314,133,163,210
../../CUB_200_2011/images\049.Boat_tailed_Grackle/Boat_Tailed_Grackle_0027_33743.jpg,411,500,049.Boat_tailed_Grackle,13,69,389,414,201,241,376,345
../../CUB_200_2011/images\049.Boat_tailed_Grackle/Boat_Tailed_Grackle_0082_33488.jpg,411,500,049.Boat_tailed_Grackle,82,92,358,322,220,207,276,230
../../CUB_200_2011/images\049.Boat_tailed_Grackle/Boat_Tailed_Grackle_0113_33490.jpg,400,500,049.Boat_tailed_Grackle,76,158,215,349,145,253,139,191
../../CUB_200_2011/images\049.Boat_tailed_Grackle/Boat_Tailed_Grackle_0063_33492.jpg,500,299,049.Boat_tailed_Grackle,75,63,378,242,226,152,303,179
../../CUB_200_2011/images\049.Boat_tailed_Grackle/Boat_Tailed_Grackle_0035_33750.jpg,500,333,049.Boat_tailed_Grackle,10,56,323,332,166,194,313,276
../../CUB_200_2011/images\049.Boat_tailed_Grackle/Boat_Tailed_Grackle_0047_33500.jpg,500,334,049.Boat_tailed_Grackle,153,65,476,284,314,174,323,219
../../CUB_200_2011/images\049.Boat_tailed_Grackle/Boat_Tailed_Grackle_0050_33501.jpg,500,338,049.Boat_tailed_Grackle,62,59,397,269,229,164,335,210
../../CUB_200_2011/images\049.Boat_tailed_Grackle/Boat_Tailed_Grackle_0097_33759.jpg,500,350,049.Boat_tailed_Grackle,58,44,447,287,252,165,389,243
../../CUB_200_2011/images\049.Boat_tailed_Grackle/Boat_Tailed_Grackle_0091_33504.jpg,500,335,049.Boat_tailed_Grackle,103,64,342,312,222,188,239,248
../../CUB_200_2011/images\049.Boat_tailed_Grackle/Boat_Tailed_Grackle_0011_34020.jpg,500,243,049.Boat_tailed_Grackle,98,71,440,193,269,132,342,122
../../CUB_200_2011/images\049.Boat_tailed_Grackle/Boat_Tailed_Grackle_0122_34023.jpg,400,309,049.Boat_tailed_Grackle,30,44,325,293,177,168,295,249
../../CUB_200_2011/images\049.Boat_tailed_Grackle/Boat_Tailed_Grackle_0016_33770.jpg,500,334,049.Boat_tailed_Grackle,127,56,404,333,265,194,277,277
../../CUB_200_2011/images\049.Boat_tailed_Grackle/Boat_Tailed_Grackle_0055_33774.jpg,500,375,049.Boat_tailed_Grackle,32,50,456,361,244,205,424,311
../../CUB_200_2011/images\049.Boat_tailed_Grackle/Boat_Tailed_Grackle_0067_34032.jpg,500,343,049.Boat_tailed_Grackle,39,27,474,249,256,138,435,222
../../CUB_200_2011/images\049.Boat_tailed_Grackle/Boat_Tailed_Grackle_0033_33524.jpg,358,500,049.Boat_tailed_Grackle,14,192,343,461,178,326,329,269
../../CUB_200_2011/images\049.Boat_tailed_Grackle/Boat_Tailed_Grackle_0105_33663.jpg,500,356,049.Boat_tailed_Grackle,32,47,389,348,210,197,357,301
../../CUB_200_2011/images\050.Eared_Grebe/Eared_Grebe_0036_34048.jpg,500,333,050.Eared_Grebe,201,57,452,184,326,120,251,127
../../CUB_200_2011/images\050.Eared_Grebe/Eared_Grebe_0065_34049.jpg,500,415,050.Eared_Grebe,128,127,378,252,253,189,250,125
../../CUB_200_2011/images\050.Eared_Grebe/Eared_Grebe_0068_34052.jpg,500,375,050.Eared_Grebe,274,49,415,189,344,119,141,140
../../CUB_200_2011/images\050.Eared_Grebe/Eared_Grebe_0023_34309.jpg,500,332,050.Eared_Grebe,140,60,381,241,260,150,241,181
../../CUB_200_2011/images\050.Eared_Grebe/Eared_Grebe_0063_34054.jpg,500,337,050.Eared_Grebe,190,141,372,250,281,195,182,109
../../CUB_200_2011/images\050.Eared_Grebe/Eared_Grebe_0071_34311.jpg,500,387,050.Eared_Grebe,98,124,290,241,194,182,192,117
../../CUB_200_2011/images\050.Eared_Grebe/Eared_Grebe_0085_34063.jpg,500,375,050.Eared_Grebe,128,134,303,246,215,190,175,112
../../CUB_200_2011/images\050.Eared_Grebe/Eared_Grebe_0086_34064.jpg,500,324,050.Eared_Grebe,35,67,261,182,148,124,226,115
../../CUB_200_2011/images\050.Eared_Grebe/Eared_Grebe_0038_34321.jpg,500,336,050.Eared_Grebe,111,50,393,219,252,134,282,169
../../CUB_200_2011/images\050.Eared_Grebe/Eared_Grebe_0032_34078.jpg,500,353,050.Eared_Grebe,153,77,432,322,292,199,279,245
../../CUB_200_2011/images\050.Eared_Grebe/Eared_Grebe_0053_34084.jpg,500,399,050.Eared_Grebe,206,62,454,210,330,136,248,148
../../CUB_200_2011/images\050.Eared_Grebe/Eared_Grebe_0027_34341.jpg,500,294,050.Eared_Grebe,157,76,427,215,292,145,270,139
../../CUB_200_2011/images\050.Eared_Grebe/Eared_Grebe_0079_34342.jpg,480,319,050.Eared_Grebe,221,91,417,204,319,147,196,113
../../CUB_200_2011/images\050.Eared_Grebe/Eared_Grebe_0006_34347.jpg,500,333,050.Eared_Grebe,135,117,278,222,206,169,143,105
../../CUB_200_2011/images\050.Eared_Grebe/Eared_Grebe_0056_34098.jpg,500,333,050.Eared_Grebe,68,29,432,265,250,147,364,236
../../CUB_200_2011/images\050.Eared_Grebe/Eared_Grebe_0049_34100.jpg,500,357,050.Eared_Grebe,108,120,395,263,251,191,287,143
../../CUB_200_2011/images\050.Eared_Grebe/Eared_Grebe_0018_34357.jpg,500,375,050.Eared_Grebe,86,0,482,334,284,167,396,334
../../CUB_200_2011/images\050.Eared_Grebe/Eared_Grebe_0084_34364.jpg,500,333,050.Eared_Grebe,44,127,374,233,209,180,330,106
../../CUB_200_2011/images\050.Eared_Grebe/Eared_Grebe_0075_34115.jpg,450,500,050.Eared_Grebe,82,83,337,270,209,176,255,187
../../CUB_200_2011/images\050.Eared_Grebe/Eared_Grebe_0026_34383.jpg,412,336,050.Eared_Grebe,105,74,307,288,206,181,202,214
../../CUB_200_2011/images\050.Eared_Grebe/Eared_Grebe_0020_34131.jpg,500,376,050.Eared_Grebe,88,54,420,293,254,173,332,239
../../CUB_200_2011/images\050.Eared_Grebe/Eared_Grebe_0042_34132.jpg,500,335,050.Eared_Grebe,89,68,236,187,162,127,147,119
../../CUB_200_2011/images\050.Eared_Grebe/Eared_Grebe_0060_34133.jpg,500,333,050.Eared_Grebe,150,44,362,223,256,133,212,179
../../CUB_200_2011/images\050.Eared_Grebe/Eared_Grebe_0035_34137.jpg,500,400,050.Eared_Grebe,26,65,418,317,222,191,392,252
../../CUB_200_2011/images\050.Eared_Grebe/Eared_Grebe_0017_34139.jpg,500,375,050.Eared_Grebe,145,107,395,261,270,184,250,154
../../CUB_200_2011/images\050.Eared_Grebe/Eared_Grebe_0034_34142.jpg,500,400,050.Eared_Grebe,40,70,335,227,187,148,295,157
../../CUB_200_2011/images\050.Eared_Grebe/Eared_Grebe_0013_34150.jpg,500,349,050.Eared_Grebe,216,133,474,281,345,207,258,148
../../CUB_200_2011/images\050.Eared_Grebe/Eared_Grebe_0061_34407.jpg,500,484,050.Eared_Grebe,163,86,382,250,272,168,219,164
../../CUB_200_2011/images\050.Eared_Grebe/Eared_Grebe_0081_34153.jpg,333,500,050.Eared_Grebe,48,127,316,342,182,234,268,215
../../CUB_200_2011/images\050.Eared_Grebe/Eared_Grebe_0010_34151.jpg,500,333,050.Eared_Grebe,69,33,410,251,239,142,341,218
../../CUB_200_2011/images\050.Eared_Grebe/Eared_Grebe_0041_34157.jpg,500,352,050.Eared_Grebe,94,83,434,250,264,166,340,167
../../CUB_200_2011/images\050.Eared_Grebe/Eared_Grebe_0067_34416.jpg,500,337,050.Eared_Grebe,161,116,485,262,323,189,324,146
../../CUB_200_2011/images\050.Eared_Grebe/Eared_Grebe_0037_34169.jpg,500,443,050.Eared_Grebe,105,85,350,207,227,146,245,122
../../CUB_200_2011/images\050.Eared_Grebe/Eared_Grebe_0043_34427.jpg,500,333,050.Eared_Grebe,61,88,415,221,238,154,354,133
../../CUB_200_2011/images\050.Eared_Grebe/Eared_Grebe_0073_34172.jpg,500,333,050.Eared_Grebe,166,73,308,220,237,146,142,147
../../CUB_200_2011/images\050.Eared_Grebe/Eared_Grebe_0058_34174.jpg,500,340,050.Eared_Grebe,196,93,448,233,322,163,252,140
../../CUB_200_2011/images\050.Eared_Grebe/Eared_Grebe_0048_34175.jpg,500,333,050.Eared_Grebe,174,67,464,280,319,173,290,213
../../CUB_200_2011/images\050.Eared_Grebe/Eared_Grebe_0001_34433.jpg,500,333,050.Eared_Grebe,125,39,373,298,249,168,248,259
../../CUB_200_2011/images\050.Eared_Grebe/Eared_Grebe_0069_34199.jpg,500,409,050.Eared_Grebe,61,93,402,261,231,177,341,168
../../CUB_200_2011/images\050.Eared_Grebe/Eared_Grebe_0047_34204.jpg,500,459,050.Eared_Grebe,218,186,413,295,315,240,195,109
../../CUB_200_2011/images\050.Eared_Grebe/Eared_Grebe_0052_34205.jpg,500,329,050.Eared_Grebe,63,49,399,214,231,131,336,165
../../CUB_200_2011/images\050.Eared_Grebe/Eared_Grebe_0051_34209.jpg,500,356,050.Eared_Grebe,101,84,313,219,207,151,212,135
../../CUB_200_2011/images\050.Eared_Grebe/Eared_Grebe_0045_34212.jpg,500,386,050.Eared_Grebe,32,69,366,295,199,182,334,226
../../CUB_200_2011/images\050.Eared_Grebe/Eared_Grebe_0054_34289.jpg,500,333,050.Eared_Grebe,14,37,395,241,204,139,381,204
../../CUB_200_2011/images\050.Eared_Grebe/Eared_Grebe_0080_34223.jpg,500,333,050.Eared_Grebe,133,59,470,198,301,128,337,139
../../CUB_200_2011/images\050.Eared_Grebe/Eared_Grebe_0082_34227.jpg,500,421,050.Eared_Grebe,4,17,365,299,184,158,361,282
../../CUB_200_2011/images\050.Eared_Grebe/Eared_Grebe_0016_34334.jpg,500,426,050.Eared_Grebe,113,72,391,234,252,153,278,162
../../CUB_200_2011/images\050.Eared_Grebe/Eared_Grebe_0015_34231.jpg,500,284,050.Eared_Grebe,163,91,390,199,276,145,227,108
../../CUB_200_2011/images\050.Eared_Grebe/Eared_Grebe_0007_34236.jpg,500,356,050.Eared_Grebe,116,82,438,243,277,162,322,161
../../CUB_200_2011/images\050.Eared_Grebe/Eared_Grebe_0074_34238.jpg,500,386,050.Eared_Grebe,195,135,409,244,302,189,214,109
../../CUB_200_2011/images\050.Eared_Grebe/Eared_Grebe_0009_34244.jpg,500,403,050.Eared_Grebe,28,27,399,343,213,185,371,316
../../CUB_200_2011/images\050.Eared_Grebe/Eared_Grebe_0062_34249.jpg,500,332,050.Eared_Grebe,106,48,437,287,271,167,331,239
../../CUB_200_2011/images\050.Eared_Grebe/Eared_Grebe_0064_34251.jpg,453,500,050.Eared_Grebe,79,71,329,231,204,151,250,160
../../CUB_200_2011/images\050.Eared_Grebe/Eared_Grebe_0039_34257.jpg,500,326,050.Eared_Grebe,134,85,330,217,232,151,196,132
../../CUB_200_2011/images\050.Eared_Grebe/Eared_Grebe_0029_34258.jpg,500,325,050.Eared_Grebe,161,94,446,254,303,174,285,160
../../CUB_200_2011/images\050.Eared_Grebe/Eared_Grebe_0031_34262.jpg,500,317,050.Eared_Grebe,109,95,354,195,231,145,245,100
../../CUB_200_2011/images\050.Eared_Grebe/Eared_Grebe_0040_34340.jpg,500,333,050.Eared_Grebe,263,137,385,266,324,201,122,129
../../CUB_200_2011/images\050.Eared_Grebe/Eared_Grebe_0057_34274.jpg,500,333,050.Eared_Grebe,93,35,300,252,196,143,207,217
../../CUB_200_2011/images\050.Eared_Grebe/Eared_Grebe_0004_34277.jpg,500,333,050.Eared_Grebe,24,7,336,181,180,94,312,174
../../CUB_200_2011/images\050.Eared_Grebe/Eared_Grebe_0025_34344.jpg,500,364,050.Eared_Grebe,155,80,349,197,252,138,194,117
../../CUB_200_2011/images\051.Horned_Grebe/Horned_Grebe_0017_35073.jpg,500,334,051.Horned_Grebe,87,87,336,207,211,147,249,120
../../CUB_200_2011/images\051.Horned_Grebe/Horned_Grebe_0103_34822.jpg,500,333,051.Horned_Grebe,30,105,460,276,245,190,430,171
../../CUB_200_2011/images\051.Horned_Grebe/Horned_Grebe_0050_34561.jpg,500,333,051.Horned_Grebe,227,127,358,228,292,177,131,101
../../CUB_200_2011/images\051.Horned_Grebe/Horned_Grebe_0058_34568.jpg,500,333,051.Horned_Grebe,160,111,335,221,247,166,175,110
../../CUB_200_2011/images\051.Horned_Grebe/Horned_Grebe_0055_35104.jpg,500,353,051.Horned_Grebe,64,82,339,250,201,166,275,168
../../CUB_200_2011/images\051.Horned_Grebe/Horned_Grebe_0002_34577.jpg,500,412,051.Horned_Grebe,82,58,440,242,261,150,358,184
../../CUB_200_2011/images\051.Horned_Grebe/Horned_Grebe_0076_34841.jpg,373,500,051.Horned_Grebe,9,80,343,390,176,235,334,310
../../CUB_200_2011/images\051.Horned_Grebe/Horned_Grebe_0077_34587.jpg,500,334,051.Horned_Grebe,67,34,382,235,224,134,315,201
../../CUB_200_2011/images\051.Horned_Grebe/Horned_Grebe_0057_34590.jpg,500,332,051.Horned_Grebe,135,66,406,245,270,155,271,179
../../CUB_200_2011/images\051.Horned_Grebe/Horned_Grebe_0039_34848.jpg,500,333,051.Horned_Grebe,166,81,437,321,301,201,271,240
../../CUB_200_2011/images\051.Horned_Grebe/Horned_Grebe_0071_35078.jpg,450,312,051.Horned_Grebe,59,44,345,175,202,109,286,131
../../CUB_200_2011/images\051.Horned_Grebe/Horned_Grebe_0106_35112.jpg,500,333,051.Horned_Grebe,112,57,396,199,254,128,284,142
../../CUB_200_2011/images\051.Horned_Grebe/Horned_Grebe_0045_34859.jpg,500,326,051.Horned_Grebe,118,53,340,206,229,129,222,153
../../CUB_200_2011/images\051.Horned_Grebe/Horned_Grebe_0112_34864.jpg,500,386,051.Horned_Grebe,30,119,301,274,165,196,271,155
../../CUB_200_2011/images\051.Horned_Grebe/Horned_Grebe_0061_34613.jpg,500,333,051.Horned_Grebe,43,57,312,175,177,116,269,118
../../CUB_200_2011/images\051.Horned_Grebe/Horned_Grebe_0031_34626.jpg,500,333,051.Horned_Grebe,163,91,432,220,297,155,269,129
../../CUB_200_2011/images\051.Horned_Grebe/Horned_Grebe_0051_35143.jpg,500,417,051.Horned_Grebe,140,116,470,329,305,222,330,213
../../CUB_200_2011/images\051.Horned_Grebe/Horned_Grebe_0090_34640.jpg,500,333,051.Horned_Grebe,71,48,368,232,219,140,297,184
../../CUB_200_2011/images\051.Horned_Grebe/Horned_Grebe_0067_34654.jpg,500,458,051.Horned_Grebe,25,75,476,280,250,177,451,205
../../CUB_200_2011/images\051.Horned_Grebe/Horned_Grebe_0005_34657.jpg,500,394,051.Horned_Grebe,114,112,385,254,249,183,271,142
../../CUB_200_2011/images\051.Horned_Grebe/Horned_Grebe_0098_34662.jpg,500,354,051.Horned_Grebe,126,70,358,249,242,159,232,179
../../CUB_200_2011/images\051.Horned_Grebe/Horned_Grebe_0046_34926.jpg,500,393,051.Horned_Grebe,66,70,403,277,234,173,337,207
../../CUB_200_2011/images\051.Horned_Grebe/Horned_Grebe_0086_34749.jpg,500,358,051.Horned_Grebe,111,109,311,256,211,182,200,147
../../CUB_200_2011/images\051.Horned_Grebe/Horned_Grebe_0084_34936.jpg,500,358,051.Horned_Grebe,136,109,394,236,265,172,258,127
../../CUB_200_2011/images\051.Horned_Grebe/Horned_Grebe_0072_34497.jpg,500,388,051.Horned_Grebe,116,78,359,266,237,172,243,188
../../CUB_200_2011/images\051.Horned_Grebe/Horned_Grebe_0009_34952.jpg,500,375,051.Horned_Grebe,228,118,354,245,291,181,126,127
../../CUB_200_2011/images\051.Horned_Grebe/Horned_Grebe_0102_34448.jpg,500,375,051.Horned_Grebe,86,30,343,228,214,129,257,198
../../CUB_200_2011/images\051.Horned_Grebe/Horned_Grebe_0096_34452.jpg,500,400,051.Horned_Grebe,80,47,469,375,274,211,389,328
../../CUB_200_2011/images\051.Horned_Grebe/Horned_Grebe_0063_34966.jpg,500,351,051.Horned_Grebe,97,65,382,269,239,167,285,204
../../CUB_200_2011/images\051.Horned_Grebe/Horned_Grebe_0014_34968.jpg,500,387,051.Horned_Grebe,16,101,413,256,214,178,397,155
../../CUB_200_2011/images\051.Horned_Grebe/Horned_Grebe_0085_34713.jpg,500,334,051.Horned_Grebe,69,57,392,237,230,147,323,180
../../CUB_200_2011/images\051.Horned_Grebe/Horned_Grebe_0100_34462.jpg,500,376,051.Horned_Grebe,219,71,396,210,307,140,177,139
../../CUB_200_2011/images\051.Horned_Grebe/Horned_Grebe_0093_34720.jpg,500,333,051.Horned_Grebe,124,67,417,280,270,173,293,213
../../CUB_200_2011/images\051.Horned_Grebe/Horned_Grebe_0001_34723.jpg,500,346,051.Horned_Grebe,105,92,383,268,244,180,278,176
../../CUB_200_2011/images\051.Horned_Grebe/Horned_Grebe_0082_34725.jpg,500,400,051.Horned_Grebe,35,55,408,263,221,159,373,208
../../CUB_200_2011/images\051.Horned_Grebe/Horned_Grebe_0003_34983.jpg,500,400,051.Horned_Grebe,117,72,464,244,290,158,347,172
../../CUB_200_2011/images\051.Horned_Grebe/Horned_Grebe_0010_34716.jpg,500,375,051.Horned_Grebe,150,113,319,216,234,164,169,103
../../CUB_200_2011/images\051.Horned_Grebe/Horned_Grebe_0101_35203.jpg,500,333,051.Horned_Grebe,117,104,301,267,209,185,184,163
../../CUB_200_2011/images\051.Horned_Grebe/Horned_Grebe_0099_34989.jpg,500,345,051.Horned_Grebe,66,92,340,234,203,163,274,142
../../CUB_200_2011/images\051.Horned_Grebe/Horned_Grebe_0069_34990.jpg,500,332,051.Horned_Grebe,170,12,410,198,290,105,240,186
../../CUB_200_2011/images\051.Horned_Grebe/Horned_Grebe_0019_34811.jpg,500,386,051.Horned_Grebe,48,57,413,262,230,159,365,205
../../CUB_200_2011/images\051.Horned_Grebe/Horned_Grebe_0033_34736.jpg,500,375,051.Horned_Grebe,121,144,287,247,204,195,166,103
../../CUB_200_2011/images\051.Horned_Grebe/Horned_Grebe_0066_34738.jpg,500,359,051.Horned_Grebe,183,134,385,259,284,196,202,125
../../CUB_200_2011/images\051.Horned_Grebe/Horned_Grebe_0006_34718.jpg,500,332,051.Horned_Grebe,120,68,361,232,240,150,241,164
../../CUB_200_2011/images\051.Horned_Grebe/Horned_Grebe_0095_34491.jpg,500,334,051.Horned_Grebe,28,22,454,198,241,110,426,176
../../CUB_200_2011/images\051.Horned_Grebe/Horned_Grebe_0110_35012.jpg,500,399,051.Horned_Grebe,102,59,439,258,270,158,337,199
../../CUB_200_2011/images\051.Horned_Grebe/Horned_Grebe_0064_35015.jpg,500,354,051.Horned_Grebe,39,53,225,170,132,111,186,117
../../CUB_200_2011/images\051.Horned_Grebe/Horned_Grebe_0088_35023.jpg,500,373,051.Horned_Grebe,126,96,350,252,238,174,224,156
../../CUB_200_2011/images\051.Horned_Grebe/Horned_Grebe_0053_34512.jpg,500,313,051.Horned_Grebe,31,69,334,270,182,169,303,201
../../CUB_200_2011/images\051.Horned_Grebe/Horned_Grebe_0070_34514.jpg,500,319,051.Horned_Grebe,155,66,421,234,288,150,266,168
../../CUB_200_2011/images\051.Horned_Grebe/Horned_Grebe_0008_34515.jpg,338,500,051.Horned_Grebe,70,184,272,346,171,265,202,162
../../CUB_200_2011/images\051.Horned_Grebe/Horned_Grebe_0114_34517.jpg,500,324,051.Horned_Grebe,102,67,340,197,221,132,238,130
../../CUB_200_2011/images\051.Horned_Grebe/Horned_Grebe_0062_34523.jpg,500,333,051.Horned_Grebe,75,21,451,286,263,153,376,265
../../CUB_200_2011/images\051.Horned_Grebe/Horned_Grebe_0041_34535.jpg,500,333,051.Horned_Grebe,156,110,345,216,250,163,189,106
../../CUB_200_2011/images\051.Horned_Grebe/Horned_Grebe_0068_35111.jpg,500,330,051.Horned_Grebe,74,66,328,200,201,133,254,134
../../CUB_200_2011/images\051.Horned_Grebe/Horned_Grebe_0049_34779.jpg,500,333,051.Horned_Grebe,47,48,392,266,219,157,345,218
../../CUB_200_2011/images\051.Horned_Grebe/Horned_Grebe_0078_34799.jpg,500,357,051.Horned_Grebe,133,68,366,337,249,202,233,269
../../CUB_200_2011/images\051.Horned_Grebe/Horned_Grebe_0040_34548.jpg,500,444,051.Horned_Grebe,50,81,429,269,239,175,379,188
../../CUB_200_2011/images\051.Horned_Grebe/Horned_Grebe_0011_34687.jpg,500,300,051.Horned_Grebe,128,63,332,179,230,121,204,116
../../CUB_200_2011/images\051.Horned_Grebe/Horned_Grebe_0029_34557.jpg,500,333,051.Horned_Grebe,97,68,482,225,289,146,385,157
../../CUB_200_2011/images\052.Pied_billed_Grebe/Pied_Billed_Grebe_0064_35843.jpg,500,350,052.Pied_billed_Grebe,187,34,368,193,277,113,181,159
../../CUB_200_2011/images\052.Pied_billed_Grebe/Pied_Billed_Grebe_0038_35798.jpg,500,333,052.Pied_billed_Grebe,56,41,466,284,261,162,410,243
../../CUB_200_2011/images\052.Pied_billed_Grebe/Pied_Billed_Grebe_0037_35598.jpg,500,431,052.Pied_billed_Grebe,105,96,361,242,233,169,256,146
../../CUB_200_2011/images\052.Pied_billed_Grebe/Pied_Billed_Grebe_0082_35356.jpg,500,353,052.Pied_billed_Grebe,120,52,461,297,290,174,341,245
../../CUB_200_2011/images\052.Pied_billed_Grebe/Pied_Billed_Grebe_0099_35872.jpg,500,358,052.Pied_billed_Grebe,84,97,362,296,223,196,278,199
../../CUB_200_2011/images\052.Pied_billed_Grebe/Pied_Billed_Grebe_0115_35362.jpg,500,467,052.Pied_billed_Grebe,158,78,327,263,242,170,169,185
../../CUB_200_2011/images\052.Pied_billed_Grebe/Pied_Billed_Grebe_0119_35377.jpg,500,401,052.Pied_billed_Grebe,34,83,318,257,176,170,284,174
../../CUB_200_2011/images\052.Pied_billed_Grebe/Pied_Billed_Grebe_0013_35882.jpg,500,284,052.Pied_billed_Grebe,118,63,390,210,254,136,272,147
../../CUB_200_2011/images\052.Pied_billed_Grebe/Pied_Billed_Grebe_0033_35379.jpg,500,329,052.Pied_billed_Grebe,78,59,258,179,168,119,180,120
../../CUB_200_2011/images\052.Pied_billed_Grebe/Pied_Billed_Grebe_0071_35386.jpg,500,332,052.Pied_billed_Grebe,222,124,439,245,330,184,217,121
../../CUB_200_2011/images\052.Pied_billed_Grebe/Pied_Billed_Grebe_0007_35399.jpg,500,348,052.Pied_billed_Grebe,125,36,391,222,258,129,266,186
../../CUB_200_2011/images\052.Pied_billed_Grebe/Pied_Billed_Grebe_0040_35981.jpg,500,333,052.Pied_billed_Grebe,117,88,334,232,225,160,217,144
../../CUB_200_2011/images\052.Pied_billed_Grebe/Pied_Billed_Grebe_0081_35409.jpg,500,478,052.Pied_billed_Grebe,151,98,480,292,315,195,329,194
../../CUB_200_2011/images\052.Pied_billed_Grebe/Pied_Billed_Grebe_0078_35410.jpg,500,375,052.Pied_billed_Grebe,68,143,255,259,161,201,187,116
../../CUB_200_2011/images\052.Pied_billed_Grebe/Pied_Billed_Grebe_0048_35670.jpg,500,389,052.Pied_billed_Grebe,68,40,477,282,272,161,409,242
../../CUB_200_2011/images\052.Pied_billed_Grebe/Pied_Billed_Grebe_0106_35418.jpg,500,400,052.Pied_billed_Grebe,193,128,443,261,318,194,250,133
../../CUB_200_2011/images\052.Pied_billed_Grebe/Pied_Billed_Grebe_0032_35931.jpg,500,340,052.Pied_billed_Grebe,62,46,243,235,152,140,181,189
../../CUB_200_2011/images\052.Pied_billed_Grebe/Pied_Billed_Grebe_0004_35808.jpg,500,333,052.Pied_billed_Grebe,163,110,426,269,294,189,263,159
../../CUB_200_2011/images\052.Pied_billed_Grebe/Pied_Billed_Grebe_0014_35424.jpg,500,369,052.Pied_billed_Grebe,180,40,421,219,300,129,241,179
../../CUB_200_2011/images\052.Pied_billed_Grebe/Pied_Billed_Grebe_0044_35425.jpg,500,359,052.Pied_billed_Grebe,106,112,374,264,240,188,268,152
../../CUB_200_2011/images\052.Pied_billed_Grebe/Pied_Billed_Grebe_0072_35939.jpg,500,400,052.Pied_billed_Grebe,160,36,453,251,306,143,293,215
../../CUB_200_2011/images\052.Pied_billed_Grebe/Pied_Billed_Grebe_0023_35687.jpg,500,333,052.Pied_billed_Grebe,207,80,465,215,336,147,258,135
../../CUB_200_2011/images\052.Pied_billed_Grebe/Pied_Billed_Grebe_0076_35432.jpg,423,500,052.Pied_billed_Grebe,110,167,315,330,212,248,205,163
../../CUB_200_2011/images\052.Pied_billed_Grebe/Pied_Billed_Grebe_0005_35437.jpg,467,500,052.Pied_billed_Grebe,84,103,361,273,222,188,277,170
../../CUB_200_2011/images\052.Pied_billed_Grebe/Pied_Billed_Grebe_0053_35262.jpg,496,500,052.Pied_billed_Grebe,42,20,371,233,206,126,329,213
../../CUB_200_2011/images\052.Pied_billed_Grebe/Pied_Billed_Grebe_0020_35958.jpg,500,341,052.Pied_billed_Grebe,71,63,348,197,209,130,277,134
../../CUB_200_2011/images\052.Pied_billed_Grebe/Pied_Billed_Grebe_0113_35703.jpg,500,392,052.Pied_billed_Grebe,83,22,356,338,219,180,273,316
../../CUB_200_2011/images\052.Pied_billed_Grebe/Pied_Billed_Grebe_0045_35962.jpg,500,334,052.Pied_billed_Grebe,68,56,240,178,154,117,172,122
../../CUB_200_2011/images\052.Pied_billed_Grebe/Pied_Billed_Grebe_0068_35963.jpg,500,377,052.Pied_billed_Grebe,100,69,380,265,240,167,280,196
../../CUB_200_2011/images\052.Pied_billed_Grebe/Pied_Billed_Grebe_0065_35713.jpg,500,375,052.Pied_billed_Grebe,162,85,321,212,241,148,159,127
../../CUB_200_2011/images\052.Pied_billed_Grebe/Pied_Billed_Grebe_0122_35970.jpg,500,333,052.Pied_billed_Grebe,172,39,373,192,272,115,201,153
../../CUB_200_2011/images\052.Pied_billed_Grebe/Pied_Billed_Grebe_0101_35464.jpg,500,422,052.Pied_billed_Grebe,91,94,378,285,234,189,287,191
../../CUB_200_2011/images\052.Pied_billed_Grebe/Pied_Billed_Grebe_0067_35465.jpg,500,375,052.Pied_billed_Grebe,57,49,268,203,162,126,211,154
../../CUB_200_2011/images\052.Pied_billed_Grebe/Pied_Billed_Grebe_0084_35863.jpg,500,333,052.Pied_billed_Grebe,129,75,453,257,291,166,324,182
../../CUB_200_2011/images\052.Pied_billed_Grebe/Pied_Billed_Grebe_0049_35980.jpg,500,368,052.Pied_billed_Grebe,109,111,360,242,234,176,251,131
../../CUB_200_2011/images\052.Pied_billed_Grebe/Pied_Billed_Grebe_0123_35469.jpg,500,326,052.Pied_billed_Grebe,134,51,323,191,228,121,189,140
../../CUB_200_2011/images\052.Pied_billed_Grebe/Pied_Billed_Grebe_0024_35949.jpg,500,379,052.Pied_billed_Grebe,92,117,308,237,200,177,216,120
../../CUB_200_2011/images\052.Pied_billed_Grebe/Pied_Billed_Grebe_0070_35472.jpg,500,320,052.Pied_billed_Grebe,75,48,343,176,209,112,268,128
../../CUB_200_2011/images\052.Pied_billed_Grebe/Pied_Billed_Grebe_0041_35224.jpg,500,400,052.Pied_billed_Grebe,90,77,462,361,276,219,372,284
../../CUB_200_2011/images\052.Pied_billed_Grebe/Pied_Billed_Grebe_0086_35483.jpg,500,344,052.Pied_billed_Grebe,121,58,378,224,249,141,257,166
../../CUB_200_2011/images\052.Pied_billed_Grebe/Pied_Billed_Grebe_0114_35493.jpg,500,333,052.Pied_billed_Grebe,92,40,344,191,218,115,252,151
../../CUB_200_2011/images\052.Pied_billed_Grebe/Pied_Billed_Grebe_0095_35496.jpg,488,500,052.Pied_billed_Grebe,137,109,393,277,265,193,256,168
../../CUB_200_2011/images\052.Pied_billed_Grebe/Pied_Billed_Grebe_0030_35498.jpg,500,332,052.Pied_billed_Grebe,178,17,445,192,311,104,267,175
../../CUB_200_2011/images\052.Pied_billed_Grebe/Pied_Billed_Grebe_0055_35502.jpg,500,375,052.Pied_billed_Grebe,188,106,396,243,292,174,208,137
../../CUB_200_2011/images\052.Pied_billed_Grebe/Pied_Billed_Grebe_0058_35503.jpg,500,414,052.Pied_billed_Grebe,121,77,397,237,259,157,276,160
../../CUB_200_2011/images\052.Pied_billed_Grebe/Pied_Billed_Grebe_0059_35507.jpg,500,356,052.Pied_billed_Grebe,240,149,422,252,331,200,182,103
../../CUB_200_2011/images\052.Pied_billed_Grebe/Pied_Billed_Grebe_0120_35764.jpg,500,354,052.Pied_billed_Grebe,57,42,413,196,235,119,356,154
../../CUB_200_2011/images\052.Pied_billed_Grebe/Pied_Billed_Grebe_0035_35518.jpg,500,359,052.Pied_billed_Grebe,61,92,276,193,168,142,215,101
../../CUB_200_2011/images\052.Pied_billed_Grebe/Pied_Billed_Grebe_0052_35937.jpg,500,366,052.Pied_billed_Grebe,134,110,414,249,274,179,280,139
../../CUB_200_2011/images\052.Pied_billed_Grebe/Pied_Billed_Grebe_0063_35529.jpg,500,339,052.Pied_billed_Grebe,186,95,412,231,299,163,226,136
../../CUB_200_2011/images\052.Pied_billed_Grebe/Pied_Billed_Grebe_0050_35530.jpg,500,335,052.Pied_billed_Grebe,213,63,415,188,314,125,202,125
../../CUB_200_2011/images\052.Pied_billed_Grebe/Pied_Billed_Grebe_0091_35276.jpg,500,470,052.Pied_billed_Grebe,136,88,339,252,237,170,203,164
../../CUB_200_2011/images\052.Pied_billed_Grebe/Pied_Billed_Grebe_0015_35289.jpg,500,317,052.Pied_billed_Grebe,121,50,337,179,229,114,216,129
../../CUB_200_2011/images\052.Pied_billed_Grebe/Pied_Billed_Grebe_0125_35322.jpg,500,352,052.Pied_billed_Grebe,129,48,368,176,248,112,239,128
../../CUB_200_2011/images\052.Pied_billed_Grebe/Pied_Billed_Grebe_0029_35551.jpg,500,319,052.Pied_billed_Grebe,37,78,281,251,159,164,244,173
../../CUB_200_2011/images\052.Pied_billed_Grebe/Pied_Billed_Grebe_0073_35553.jpg,500,332,052.Pied_billed_Grebe,102,79,354,252,228,165,252,173
../../CUB_200_2011/images\052.Pied_billed_Grebe/Pied_Billed_Grebe_0062_35955.jpg,500,334,052.Pied_billed_Grebe,221,61,480,234,350,147,259,173
../../CUB_200_2011/images\052.Pied_billed_Grebe/Pied_Billed_Grebe_0056_35623.jpg,500,375,052.Pied_billed_Grebe,110,160,361,292,235,226,251,132
../../CUB_200_2011/images\052.Pied_billed_Grebe/Pied_Billed_Grebe_0100_35310.jpg,500,457,052.Pied_billed_Grebe,82,67,326,234,204,150,244,167
../../CUB_200_2011/images\052.Pied_billed_Grebe/Pied_Billed_Grebe_0096_35579.jpg,500,382,052.Pied_billed_Grebe,89,106,279,237,184,171,190,131
../../CUB_200_2011/images\053.Western_Grebe/Western_Grebe_0067_36610.jpg,500,375,053.Western_Grebe,62,111,338,246,200,178,276,135
../../CUB_200_2011/images\053.Western_Grebe/Western_Grebe_0077_36355.jpg,500,400,053.Western_Grebe,161,117,377,229,269,173,216,112
../../CUB_200_2011/images\053.Western_Grebe/Western_Grebe_0064_36613.jpg,500,336,053.Western_Grebe,101,104,326,220,213,162,225,116
../../CUB_200_2011/images\053.Western_Grebe/Western_Grebe_0038_36363.jpg,500,333,053.Western_Grebe,173,109,329,218,251,163,156,109
../../CUB_200_2011/images\053.Western_Grebe/Western_Grebe_0099_36112.jpg,500,357,053.Western_Grebe,99,42,384,194,241,118,285,152
../../CUB_200_2011/images\053.Western_Grebe/Western_Grebe_0102_36116.jpg,500,362,053.Western_Grebe,122,71,330,242,226,156,208,171
../../CUB_200_2011/images\053.Western_Grebe/Western_Grebe_0046_36118.jpg,500,469,053.Western_Grebe,167,68,405,312,286,190,238,244
../../CUB_200_2011/images\053.Western_Grebe/Western_Grebe_0092_36121.jpg,500,375,053.Western_Grebe,26,7,396,266,211,136,370,259
../../CUB_200_2011/images\053.Western_Grebe/Western_Grebe_0029_36379.jpg,500,375,053.Western_Grebe,21,138,467,272,244,205,446,134
../../CUB_200_2011/images\053.Western_Grebe/Western_Grebe_0013_36383.jpg,500,333,053.Western_Grebe,222,91,437,199,329,145,215,108
../../CUB_200_2011/images\053.Western_Grebe/Western_Grebe_0004_36130.jpg,500,400,053.Western_Grebe,155,159,463,282,309,220,308,123
../../CUB_200_2011/images\053.Western_Grebe/Western_Grebe_0033_36395.jpg,500,414,053.Western_Grebe,121,55,466,236,293,145,345,181
../../CUB_200_2011/images\053.Western_Grebe/Western_Grebe_0048_36399.jpg,500,333,053.Western_Grebe,187,85,397,232,292,158,210,147
../../CUB_200_2011/images\053.Western_Grebe/Western_Grebe_0058_36403.jpg,500,319,053.Western_Grebe,131,73,363,202,247,137,232,129
../../CUB_200_2011/images\053.Western_Grebe/Western_Grebe_0022_36148.jpg,500,416,053.Western_Grebe,115,51,288,282,201,166,173,231
../../CUB_200_2011/images\053.Western_Grebe/Western_Grebe_0089_36154.jpg,500,313,053.Western_Grebe,164,78,396,251,280,164,232,173
../../CUB_200_2011/images\053.Western_Grebe/Western_Grebe_0057_36157.jpg,500,326,053.Western_Grebe,153,89,429,211,291,150,276,122
../../CUB_200_2011/images\053.Western_Grebe/Western_Grebe_0034_36149.jpg,500,332,053.Western_Grebe,119,60,278,271,198,165,159,211
../../CUB_200_2011/images\053.Western_Grebe/Western_Grebe_0070_36162.jpg,500,351,053.Western_Grebe,65,97,376,252,220,174,311,155
../../CUB_200_2011/images\053.Western_Grebe/Western_Grebe_0104_36164.jpg,500,333,053.Western_Grebe,139,99,370,221,254,160,231,122
../../CUB_200_2011/images\053.Western_Grebe/Western_Grebe_0045_36425.jpg,500,333,053.Western_Grebe,10,45,460,211,235,128,450,166
../../CUB_200_2011/images\053.Western_Grebe/Western_Grebe_0088_36428.jpg,500,408,053.Western_Grebe,81,31,385,218,233,124,304,187
../../CUB_200_2011/images\053.Western_Grebe/Western_Grebe_0081_36578.jpg,500,333,053.Western_Grebe,39,110,346,270,192,190,307,160
../../CUB_200_2011/images\053.Western_Grebe/Western_Grebe_0075_36435.jpg,500,333,053.Western_Grebe,141,74,390,207,265,140,249,133
../../CUB_200_2011/images\053.Western_Grebe/Western_Grebe_0090_36182.jpg,500,333,053.Western_Grebe,148,82,353,192,250,137,205,110
../../CUB_200_2011/images\053.Western_Grebe/Western_Grebe_0032_36439.jpg,500,333,053.Western_Grebe,113,105,368,261,240,183,255,156
../../CUB_200_2011/images\053.Western_Grebe/Western_Grebe_0014_36185.jpg,500,421,053.Western_Grebe,98,78,410,251,254,164,312,173
../../CUB_200_2011/images\053.Western_Grebe/Western_Grebe_0044_36188.jpg,500,326,053.Western_Grebe,36,102,422,306,229,204,386,204
../../CUB_200_2011/images\053.Western_Grebe/Western_Grebe_0093_36193.jpg,500,365,053.Western_Grebe,203,72,451,212,327,142,248,140
../../CUB_200_2011/images\053.Western_Grebe/Western_Grebe_0091_36194.jpg,500,340,053.Western_Grebe,139,97,438,273,288,185,299,176
../../CUB_200_2011/images\053.Western_Grebe/Western_Grebe_0028_36196.jpg,500,295,053.Western_Grebe,113,64,415,208,264,136,302,144
../../CUB_200_2011/images\053.Western_Grebe/Western_Grebe_0047_36203.jpg,500,333,053.Western_Grebe,122,90,343,198,232,144,221,108
../../CUB_200_2011/images\053.Western_Grebe/Western_Grebe_0037_36469.jpg,500,395,053.Western_Grebe,108,137,447,315,277,226,339,178
../../CUB_200_2011/images\053.Western_Grebe/Western_Grebe_0056_36216.jpg,500,375,053.Western_Grebe,94,103,416,245,255,174,322,142
../../CUB_200_2011/images\053.Western_Grebe/Western_Grebe_0017_36218.jpg,500,333,053.Western_Grebe,227,108,430,232,328,170,203,124
../../CUB_200_2011/images\053.Western_Grebe/Western_Grebe_0009_36477.jpg,500,363,053.Western_Grebe,98,56,445,269,271,162,347,213
../../CUB_200_2011/images\053.Western_Grebe/Western_Grebe_0086_36478.jpg,500,225,053.Western_Grebe,100,9,422,146,261,77,322,137
../../CUB_200_2011/images\053.Western_Grebe/Western_Grebe_0085_36224.jpg,500,443,053.Western_Grebe,211,62,426,275,318,168,215,213
../../CUB_200_2011/images\053.Western_Grebe/Western_Grebe_0001_36481.jpg,500,333,053.Western_Grebe,31,86,410,229,220,157,379,143
../../CUB_200_2011/images\053.Western_Grebe/Western_Grebe_0069_36486.jpg,500,375,053.Western_Grebe,109,125,340,278,224,201,231,153
../../CUB_200_2011/images\053.Western_Grebe/Western_Grebe_0083_36033.jpg,500,334,053.Western_Grebe,90,114,461,288,275,201,371,174
../../CUB_200_2011/images\053.Western_Grebe/Western_Grebe_0020_36241.jpg,500,335,053.Western_Grebe,103,111,266,222,184,166,163,111
../../CUB_200_2011/images\053.Western_Grebe/Western_Grebe_0050_36163.jpg,339,500,053.Western_Grebe,26,44,338,315,182,179,312,271
../../CUB_200_2011/images\053.Western_Grebe/Western_Grebe_0051_36249.jpg,500,311,053.Western_Grebe,86,85,446,210,266,147,360,125
../../CUB_200_2011/images\053.Western_Grebe/Western_Grebe_0025_36251.jpg,357,500,053.Western_Grebe,32,73,337,346,184,209,305,273
../../CUB_200_2011/images\053.Western_Grebe/Western_Grebe_0106_36509.jpg,500,326,053.Western_Grebe,164,95,346,219,255,157,182,124
../../CUB_200_2011/images\053.Western_Grebe/Western_Grebe_0043_36183.jpg,500,334,053.Western_Grebe,36,52,277,201,156,126,241,149
../../CUB_200_2011/images\053.Western_Grebe/Western_Grebe_0103_36515.jpg,500,363,053.Western_Grebe,112,47,449,323,280,185,337,276
../../CUB_200_2011/images\053.Western_Grebe/Western_Grebe_0002_36518.jpg,500,371,053.Western_Grebe,57,119,385,265,221,192,328,146
../../CUB_200_2011/images\053.Western_Grebe/Western_Grebe_0036_36521.jpg,500,391,053.Western_Grebe,114,114,315,237,214,175,201,123
../../CUB_200_2011/images\053.Western_Grebe/Western_Grebe_0011_36522.jpg,500,375,053.Western_Grebe,57,166,239,280,148,223,182,114
../../CUB_200_2011/images\053.Western_Grebe/Western_Grebe_0071_36536.jpg,500,374,053.Western_Grebe,91,67,413,277,252,172,322,210
../../CUB_200_2011/images\053.Western_Grebe/Western_Grebe_0021_36282.jpg,500,332,053.Western_Grebe,33,94,376,289,204,191,343,195
../../CUB_200_2011/images\053.Western_Grebe/Western_Grebe_0105_36542.jpg,500,333,053.Western_Grebe,65,68,486,247,275,157,421,179
../../CUB_200_2011/images\053.Western_Grebe/Western_Grebe_0042_36035.jpg,500,358,053.Western_Grebe,135,113,388,219,261,166,253,106
../../CUB_200_2011/images\053.Western_Grebe/Western_Grebe_0080_36310.jpg,500,343,053.Western_Grebe,78,117,347,244,212,180,269,127
../../CUB_200_2011/images\053.Western_Grebe/Western_Grebe_0087_36570.jpg,500,333,053.Western_Grebe,60,31,383,227,221,129,323,196
../../CUB_200_2011/images\053.Western_Grebe/Western_Grebe_0049_36219.jpg,500,333,053.Western_Grebe,80,45,365,211,222,128,285,166
../../CUB_200_2011/images\053.Western_Grebe/Western_Grebe_0007_36074.jpg,500,375,053.Western_Grebe,28,35,462,300,245,167,434,265
../../CUB_200_2011/images\053.Western_Grebe/Western_Grebe_0061_36181.jpg,500,333,053.Western_Grebe,29,33,361,242,195,137,332,209
../../CUB_200_2011/images\054.Blue_Grosbeak/Blue_Grosbeak_0066_36632.jpg,500,454,054.Blue_Grosbeak,52,93,369,408,210,250,317,315
../../CUB_200_2011/images\054.Blue_Grosbeak/Blue_Grosbeak_0061_36633.jpg,500,400,054.Blue_Grosbeak,182,105,350,354,266,229,168,249
../../CUB_200_2011/images\054.Blue_Grosbeak/Blue_Grosbeak_0078_36655.jpg,500,386,054.Blue_Grosbeak,177,46,349,336,263,191,172,290
../../CUB_200_2011/images\054.Blue_Grosbeak/Blue_Grosbeak_0073_37148.jpg,500,375,054.Blue_Grosbeak,70,138,219,249,144,193,149,111
../../CUB_200_2011/images\054.Blue_Grosbeak/Blue_Grosbeak_0074_37155.jpg,500,349,054.Blue_Grosbeak,217,103,361,265,289,184,144,162
../../CUB_200_2011/images\054.Blue_Grosbeak/Blue_Grosbeak_0042_36742.jpg,500,339,054.Blue_Grosbeak,148,69,418,296,283,182,270,227
../../CUB_200_2011/images\054.Blue_Grosbeak/Blue_Grosbeak_0025_36646.jpg,420,500,054.Blue_Grosbeak,85,110,238,389,161,249,153,279
../../CUB_200_2011/images\054.Blue_Grosbeak/Blue_Grosbeak_0079_36656.jpg,428,500,054.Blue_Grosbeak,141,62,315,396,228,229,174,334
../../CUB_200_2011/images\054.Blue_Grosbeak/Blue_Grosbeak_0109_36914.jpg,500,400,054.Blue_Grosbeak,193,105,457,342,325,223,264,237
../../CUB_200_2011/images\054.Blue_Grosbeak/Blue_Grosbeak_0031_37173.jpg,400,500,054.Blue_Grosbeak,146,237,302,380,224,308,156,143
../../CUB_200_2011/images\054.Blue_Grosbeak/Blue_Grosbeak_0041_37174.jpg,465,403,054.Blue_Grosbeak,90,121,322,299,206,210,232,178
../../CUB_200_2011/images\054.Blue_Grosbeak/Blue_Grosbeak_0049_37180.jpg,500,355,054.Blue_Grosbeak,68,95,337,298,202,196,269,203
../../CUB_200_2011/images\054.Blue_Grosbeak/Blue_Grosbeak_0103_36673.jpg,500,445,054.Blue_Grosbeak,56,100,447,378,251,239,391,278
../../CUB_200_2011/images\054.Blue_Grosbeak/Blue_Grosbeak_0112_36679.jpg,500,423,054.Blue_Grosbeak,100,104,286,320,193,212,186,216
../../CUB_200_2011/images\054.Blue_Grosbeak/Blue_Grosbeak_0024_36680.jpg,500,399,054.Blue_Grosbeak,96,102,361,338,228,220,265,236
../../CUB_200_2011/images\054.Blue_Grosbeak/Blue_Grosbeak_0029_37197.jpg,500,322,054.Blue_Grosbeak,133,52,370,260,251,156,237,208
../../CUB_200_2011/images\054.Blue_Grosbeak/Blue_Grosbeak_0043_37200.jpg,500,338,054.Blue_Grosbeak,79,108,344,258,211,183,265,150
../../CUB_200_2011/images\054.Blue_Grosbeak/Blue_Grosbeak_0071_36948.jpg,343,500,054.Blue_Grosbeak,123,111,265,422,194,266,142,311
../../CUB_200_2011/images\054.Blue_Grosbeak/Blue_Grosbeak_0053_36709.jpg,399,500,054.Blue_Grosbeak,33,233,206,416,119,324,173,183
../../CUB_200_2011/images\054.Blue_Grosbeak/Blue_Grosbeak_0107_36696.jpg,500,333,054.Blue_Grosbeak,35,36,356,300,195,168,321,264
../../CUB_200_2011/images\054.Blue_Grosbeak/Blue_Grosbeak_0075_36963.jpg,500,333,054.Blue_Grosbeak,196,108,352,260,274,184,156,152
../../CUB_200_2011/images\054.Blue_Grosbeak/Blue_Grosbeak_0014_36708.jpg,500,400,054.Blue_Grosbeak,89,66,429,338,259,202,340,272
../../CUB_200_2011/images\054.Blue_Grosbeak/Blue_Grosbeak_0067_36965.jpg,500,311,054.Blue_Grosbeak,158,102,297,282,227,192,139,180
../../CUB_200_2011/images\054.Blue_Grosbeak/Blue_Grosbeak_0020_36967.jpg,432,346,054.Blue_Grosbeak,23,73,419,256,221,164,396,183
../../CUB_200_2011/images\054.Blue_Grosbeak/Blue_Grosbeak_0092_36711.jpg,500,333,054.Blue_Grosbeak,194,116,407,242,300,179,213,126
../../CUB_200_2011/images\054.Blue_Grosbeak/Blue_Grosbeak_0101_36719.jpg,500,405,054.Blue_Grosbeak,126,139,311,320,218,229,185,181
../../CUB_200_2011/images\054.Blue_Grosbeak/Blue_Grosbeak_0033_36980.jpg,500,333,054.Blue_Grosbeak,42,45,254,308,148,176,212,263
../../CUB_200_2011/images\054.Blue_Grosbeak/Blue_Grosbeak_0104_36984.jpg,500,315,054.Blue_Grosbeak,98,61,453,281,275,171,355,220
../../CUB_200_2011/images\054.Blue_Grosbeak/Blue_Grosbeak_0015_36985.jpg,500,333,054.Blue_Grosbeak,260,88,388,312,324,200,128,224
../../CUB_200_2011/images\054.Blue_Grosbeak/Blue_Grosbeak_0106_36986.jpg,500,390,054.Blue_Grosbeak,186,80,383,371,284,225,197,291
../../CUB_200_2011/images\054.Blue_Grosbeak/Blue_Grosbeak_0085_36990.jpg,336,500,054.Blue_Grosbeak,30,127,193,458,111,292,163,331
../../CUB_200_2011/images\054.Blue_Grosbeak/Blue_Grosbeak_0082_36991.jpg,488,500,054.Blue_Grosbeak,136,159,319,384,227,271,183,225
../../CUB_200_2011/images\054.Blue_Grosbeak/Blue_Grosbeak_0009_36992.jpg,462,500,054.Blue_Grosbeak,91,122,344,426,217,274,253,304
../../CUB_200_2011/images\054.Blue_Grosbeak/Blue_Grosbeak_0045_36672.jpg,336,500,054.Blue_Grosbeak,39,92,253,465,146,278,214,373
../../CUB_200_2011/images\054.Blue_Grosbeak/Blue_Grosbeak_0094_36995.jpg,500,414,054.Blue_Grosbeak,128,92,447,391,287,241,319,299
../../CUB_200_2011/images\054.Blue_Grosbeak/Blue_Grosbeak_0019_37205.jpg,500,346,054.Blue_Grosbeak,291,35,445,269,368,152,154,234
../../CUB_200_2011/images\054.Blue_Grosbeak/Blue_Grosbeak_0004_14988.jpg,421,500,054.Blue_Grosbeak,151,100,323,457,237,278,172,357
../../CUB_200_2011/images\054.Blue_Grosbeak/Blue_Grosbeak_0095_37007.jpg,500,333,054.Blue_Grosbeak,208,105,344,227,276,166,136,122
../../CUB_200_2011/images\054.Blue_Grosbeak/Blue_Grosbeak_0027_36703.jpg,500,375,054.Blue_Grosbeak,86,81,329,365,207,223,243,284
../../CUB_200_2011/images\054.Blue_Grosbeak/Blue_Grosbeak_0072_36774.jpg,500,343,054.Blue_Grosbeak,224,76,460,285,342,180,236,209
../../CUB_200_2011/images\054.Blue_Grosbeak/Blue_Grosbeak_0081_37034.jpg,500,359,054.Blue_Grosbeak,185,66,485,305,335,185,300,239
../../CUB_200_2011/images\054.Blue_Grosbeak/Blue_Grosbeak_0087_36780.jpg,500,320,054.Blue_Grosbeak,44,113,348,257,196,185,304,144
../../CUB_200_2011/images\054.Blue_Grosbeak/Blue_Grosbeak_0048_36809.jpg,500,375,054.Blue_Grosbeak,94,92,442,373,268,232,348,281
../../CUB_200_2011/images\054.Blue_Grosbeak/Blue_Grosbeak_0036_37048.jpg,500,400,054.Blue_Grosbeak,135,49,263,355,199,202,128,306
../../CUB_200_2011/images\054.Blue_Grosbeak/Blue_Grosbeak_0037_36794.jpg,482,500,054.Blue_Grosbeak,132,112,388,406,260,259,256,294
../../CUB_200_2011/images\054.Blue_Grosbeak/Blue_Grosbeak_0051_37065.jpg,500,333,054.Blue_Grosbeak,240,122,372,254,306,188,132,132
../../CUB_200_2011/images\054.Blue_Grosbeak/Blue_Grosbeak_0097_37067.jpg,437,500,054.Blue_Grosbeak,112,172,287,395,199,283,175,223
../../CUB_200_2011/images\054.Blue_Grosbeak/Blue_Grosbeak_0023_37069.jpg,500,375,054.Blue_Grosbeak,134,120,468,359,301,239,334,239
../../CUB_200_2011/images\054.Blue_Grosbeak/Blue_Grosbeak_0022_37082.jpg,500,375,054.Blue_Grosbeak,145,170,254,309,199,239,109,139
../../CUB_200_2011/images\054.Blue_Grosbeak/Blue_Grosbeak_0099_36828.jpg,500,375,054.Blue_Grosbeak,134,98,426,291,280,194,292,193
../../CUB_200_2011/images\054.Blue_Grosbeak/Blue_Grosbeak_0038_37095.jpg,500,335,054.Blue_Grosbeak,150,78,285,308,217,193,135,230
../../CUB_200_2011/images\054.Blue_Grosbeak/Blue_Grosbeak_0111_36841.jpg,398,500,054.Blue_Grosbeak,17,152,276,412,146,282,259,260
../../CUB_200_2011/images\054.Blue_Grosbeak/Blue_Grosbeak_0086_36818.jpg,500,333,054.Blue_Grosbeak,128,74,284,290,206,182,156,216
../../CUB_200_2011/images\054.Blue_Grosbeak/Blue_Grosbeak_0065_36847.jpg,500,364,054.Blue_Grosbeak,161,28,381,351,271,189,220,323
../../CUB_200_2011/images\054.Blue_Grosbeak/Blue_Grosbeak_0002_36648.jpg,375,500,054.Blue_Grosbeak,142,107,287,413,214,260,145,306
../../CUB_200_2011/images\054.Blue_Grosbeak/Blue_Grosbeak_0093_37107.jpg,500,375,054.Blue_Grosbeak,244,46,362,220,303,133,118,174
../../CUB_200_2011/images\054.Blue_Grosbeak/Blue_Grosbeak_0010_37108.jpg,358,268,054.Blue_Grosbeak,160,107,299,234,229,170,139,127
../../CUB_200_2011/images\054.Blue_Grosbeak/Blue_Grosbeak_0057_37116.jpg,500,357,054.Blue_Grosbeak,136,63,400,302,268,182,264,239
../../CUB_200_2011/images\054.Blue_Grosbeak/Blue_Grosbeak_0016_36862.jpg,500,333,054.Blue_Grosbeak,215,134,331,272,273,203,116,138
../../CUB_200_2011/images\054.Blue_Grosbeak/Blue_Grosbeak_0046_37119.jpg,500,332,054.Blue_Grosbeak,161,55,346,307,253,181,185,252
../../CUB_200_2011/images\055.Evening_Grosbeak/Evening_Grosbeak_0120_37378.jpg,400,500,055.Evening_Grosbeak,126,234,377,443,251,338,251,209
../../CUB_200_2011/images\055.Evening_Grosbeak/Evening_Grosbeak_0017_37379.jpg,500,375,055.Evening_Grosbeak,33,66,473,290,253,178,440,224
../../CUB_200_2011/images\055.Evening_Grosbeak/Evening_Grosbeak_0057_37392.jpg,500,334,055.Evening_Grosbeak,148,19,460,330,304,174,312,311
../../CUB_200_2011/images\055.Evening_Grosbeak/Evening_Grosbeak_0141_37398.jpg,500,400,055.Evening_Grosbeak,237,169,497,283,367,226,260,114
../../CUB_200_2011/images\055.Evening_Grosbeak/Evening_Grosbeak_0011_37913.jpg,500,333,055.Evening_Grosbeak,122,54,331,312,226,183,209,258
../../CUB_200_2011/images\055.Evening_Grosbeak/Evening_Grosbeak_0024_37404.jpg,500,333,055.Evening_Grosbeak,9,39,443,316,226,177,434,277
../../CUB_200_2011/images\055.Evening_Grosbeak/Evening_Grosbeak_0063_37409.jpg,500,333,055.Evening_Grosbeak,17,54,338,229,177,141,321,175
../../CUB_200_2011/images\055.Evening_Grosbeak/Evening_Grosbeak_0028_37410.jpg,500,365,055.Evening_Grosbeak,117,111,480,300,298,205,363,189
../../CUB_200_2011/images\055.Evening_Grosbeak/Evening_Grosbeak_0114_37416.jpg,500,369,055.Evening_Grosbeak,156,57,426,317,291,187,270,260
../../CUB_200_2011/images\055.Evening_Grosbeak/Evening_Grosbeak_0044_37938.jpg,333,500,055.Evening_Grosbeak,42,147,325,364,183,255,283,217
../../CUB_200_2011/images\055.Evening_Grosbeak/Evening_Grosbeak_0040_37429.jpg,500,395,055.Evening_Grosbeak,168,152,335,298,251,225,167,146
../../CUB_200_2011/images\055.Evening_Grosbeak/Evening_Grosbeak_0001_37437.jpg,422,500,055.Evening_Grosbeak,106,112,401,356,253,234,295,244
../../CUB_200_2011/images\055.Evening_Grosbeak/Evening_Grosbeak_0072_37301.jpg,500,436,055.Evening_Grosbeak,51,96,414,372,232,234,363,276
../../CUB_200_2011/images\055.Evening_Grosbeak/Evening_Grosbeak_0051_37954.jpg,500,356,055.Evening_Grosbeak,144,148,371,268,257,208,227,120
../../CUB_200_2011/images\055.Evening_Grosbeak/Evening_Grosbeak_0004_37960.jpg,500,375,055.Evening_Grosbeak,148,91,463,317,305,204,315,226
../../CUB_200_2011/images\055.Evening_Grosbeak/Evening_Grosbeak_0133_37976.jpg,500,318,055.Evening_Grosbeak,168,90,362,276,265,183,194,186
../../CUB_200_2011/images\055.Evening_Grosbeak/Evening_Grosbeak_0036_37978.jpg,500,363,055.Evening_Grosbeak,66,70,499,361,282,215,433,291
../../CUB_200_2011/images\055.Evening_Grosbeak/Evening_Grosbeak_0079_37979.jpg,500,356,055.Evening_Grosbeak,91,70,293,336,192,203,202,266
../../CUB_200_2011/images\055.Evening_Grosbeak/Evening_Grosbeak_0085_37487.jpg,500,345,055.Evening_Grosbeak,68,52,364,342,216,197,296,290
../../CUB_200_2011/images\055.Evening_Grosbeak/Evening_Grosbeak_0115_37490.jpg,500,500,055.Evening_Grosbeak,148,71,382,302,265,186,234,231
../../CUB_200_2011/images\055.Evening_Grosbeak/Evening_Grosbeak_0053_38005.jpg,500,357,055.Evening_Grosbeak,32,113,393,335,212,224,361,222
../../CUB_200_2011/images\055.Evening_Grosbeak/Evening_Grosbeak_0007_37312.jpg,500,334,055.Evening_Grosbeak,192,71,457,270,324,170,265,199
../../CUB_200_2011/images\055.Evening_Grosbeak/Evening_Grosbeak_0132_38025.jpg,500,375,055.Evening_Grosbeak,127,115,298,309,212,212,171,194
../../CUB_200_2011/images\055.Evening_Grosbeak/Evening_Grosbeak_0061_38026.jpg,500,333,055.Evening_Grosbeak,77,62,320,324,198,193,243,262
../../CUB_200_2011/images\055.Evening_Grosbeak/Evening_Grosbeak_0098_37532.jpg,500,333,055.Evening_Grosbeak,266,30,478,271,372,150,212,241
../../CUB_200_2011/images\055.Evening_Grosbeak/Evening_Grosbeak_0086_38048.jpg,500,337,055.Evening_Grosbeak,69,39,363,331,216,185,294,292
../../CUB_200_2011/images\055.Evening_Grosbeak/Evening_Grosbeak_0078_38051.jpg,500,332,055.Evening_Grosbeak,250,108,414,279,332,193,164,171
../../CUB_200_2011/images\055.Evening_Grosbeak/Evening_Grosbeak_0112_37922.jpg,334,500,055.Evening_Grosbeak,35,99,273,443,154,271,238,344
../../CUB_200_2011/images\055.Evening_Grosbeak/Evening_Grosbeak_0093_37608.jpg,400,499,055.Evening_Grosbeak,87,150,378,377,232,263,291,227
../../CUB_200_2011/images\055.Evening_Grosbeak/Evening_Grosbeak_0102_37927.jpg,500,457,055.Evening_Grosbeak,39,108,309,411,174,259,270,303
../../CUB_200_2011/images\055.Evening_Grosbeak/Evening_Grosbeak_0041_37928.jpg,500,334,055.Evening_Grosbeak,165,153,423,273,294,213,258,120
../../CUB_200_2011/images\055.Evening_Grosbeak/Evening_Grosbeak_0107_37933.jpg,500,400,055.Evening_Grosbeak,109,78,271,303,190,190,162,225
../../CUB_200_2011/images\055.Evening_Grosbeak/Evening_Grosbeak_0077_38160.jpg,500,333,055.Evening_Grosbeak,38,40,429,260,233,150,391,220
../../CUB_200_2011/images\055.Evening_Grosbeak/Evening_Grosbeak_0104_37661.jpg,500,400,055.Evening_Grosbeak,160,111,396,345,278,228,236,234
../../CUB_200_2011/images\055.Evening_Grosbeak/Evening_Grosbeak_0069_37684.jpg,500,324,055.Evening_Grosbeak,159,47,446,293,302,170,287,246
../../CUB_200_2011/images\055.Evening_Grosbeak/Evening_Grosbeak_0101_37697.jpg,500,357,055.Evening_Grosbeak,92,174,323,320,207,247,231,146
../../CUB_200_2011/images\055.Evening_Grosbeak/Evening_Grosbeak_0003_37698.jpg,400,500,055.Evening_Grosbeak,14,75,294,482,154,278,280,407
../../CUB_200_2011/images\055.Evening_Grosbeak/Evening_Grosbeak_0033_37707.jpg,500,357,055.Evening_Grosbeak,170,80,355,304,262,192,185,224
../../CUB_200_2011/images\055.Evening_Grosbeak/Evening_Grosbeak_0090_37225.jpg,500,358,055.Evening_Grosbeak,162,33,472,306,317,169,310,273
../../CUB_200_2011/images\055.Evening_Grosbeak/Evening_Grosbeak_0038_37228.jpg,399,500,055.Evening_Grosbeak,86,40,343,431,214,235,257,391
../../CUB_200_2011/images\055.Evening_Grosbeak/Evening_Grosbeak_0025_37230.jpg,496,500,055.Evening_Grosbeak,51,152,388,369,219,260,337,217
../../CUB_200_2011/images\055.Evening_Grosbeak/Evening_Grosbeak_0015_37238.jpg,500,333,055.Evening_Grosbeak,82,102,354,257,218,179,272,155
../../CUB_200_2011/images\055.Evening_Grosbeak/Evening_Grosbeak_0031_37239.jpg,500,381,055.Evening_Grosbeak,57,129,284,332,170,230,227,203
../../CUB_200_2011/images\055.Evening_Grosbeak/Evening_Grosbeak_0022_37761.jpg,500,410,055.Evening_Grosbeak,166,45,485,376,325,210,319,331
../../CUB_200_2011/images\055.Evening_Grosbeak/Evening_Grosbeak_0070_37767.jpg,500,426,055.Evening_Grosbeak,25,17,460,370,242,193,435,353
../../CUB_200_2011/images\055.Evening_Grosbeak/Evening_Grosbeak_0016_37613.jpg,500,357,055.Evening_Grosbeak,210,76,454,294,332,185,244,218
../../CUB_200_2011/images\055.Evening_Grosbeak/Evening_Grosbeak_0021_37789.jpg,500,400,055.Evening_Grosbeak,30,59,420,344,225,201,390,285
../../CUB_200_2011/images\055.Evening_Grosbeak/Evening_Grosbeak_0046_37280.jpg,500,336,055.Evening_Grosbeak,192,31,498,255,345,143,306,224
../../CUB_200_2011/images\055.Evening_Grosbeak/Evening_Grosbeak_0065_37296.jpg,500,340,055.Evening_Grosbeak,127,63,465,294,296,178,338,231
../../CUB_200_2011/images\055.Evening_Grosbeak/Evening_Grosbeak_0118_37299.jpg,400,500,055.Evening_Grosbeak,55,65,394,463,224,264,339,398
../../CUB_200_2011/images\055.Evening_Grosbeak/Evening_Grosbeak_0130_37813.jpg,500,338,055.Evening_Grosbeak,60,33,354,322,207,177,294,289
../../CUB_200_2011/images\055.Evening_Grosbeak/Evening_Grosbeak_0075_37302.jpg,500,420,055.Evening_Grosbeak,128,151,437,358,282,254,309,207
../../CUB_200_2011/images\055.Evening_Grosbeak/Evening_Grosbeak_0076_37818.jpg,500,343,055.Evening_Grosbeak,99,16,457,333,278,174,358,317
../../CUB_200_2011/images\055.Evening_Grosbeak/Evening_Grosbeak_0027_37824.jpg,500,333,055.Evening_Grosbeak,111,40,482,288,296,164,371,248
../../CUB_200_2011/images\055.Evening_Grosbeak/Evening_Grosbeak_0129_37831.jpg,500,334,055.Evening_Grosbeak,41,89,453,333,247,211,412,244
../../CUB_200_2011/images\055.Evening_Grosbeak/Evening_Grosbeak_0005_37331.jpg,333,500,055.Evening_Grosbeak,41,145,250,400,145,272,209,255
../../CUB_200_2011/images\055.Evening_Grosbeak/Evening_Grosbeak_0050_37336.jpg,500,370,055.Evening_Grosbeak,289,86,482,280,385,183,193,194
../../CUB_200_2011/images\055.Evening_Grosbeak/Evening_Grosbeak_0034_37349.jpg,500,369,055.Evening_Grosbeak,140,104,447,335,293,219,307,231
../../CUB_200_2011/images\055.Evening_Grosbeak/Evening_Grosbeak_0100_37863.jpg,500,491,055.Evening_Grosbeak,135,96,389,392,262,244,254,296
../../CUB_200_2011/images\055.Evening_Grosbeak/Evening_Grosbeak_0122_37864.jpg,411,500,055.Evening_Grosbeak,86,9,396,383,241,196,310,374
../../CUB_200_2011/images\056.Pine_Grosbeak/Pine_Grosbeak_0039_38400.jpg,413,500,056.Pine_Grosbeak,19,104,375,454,197,279,356,350
../../CUB_200_2011/images\056.Pine_Grosbeak/Pine_Grosbeak_0094_38912.jpg,500,348,056.Pine_Grosbeak,170,97,284,269,227,183,114,172
../../CUB_200_2011/images\056.Pine_Grosbeak/Pine_Grosbeak_0024_38403.jpg,500,457,056.Pine_Grosbeak,109,109,284,356,196,232,175,247
../../CUB_200_2011/images\056.Pine_Grosbeak/Pine_Grosbeak_0077_38929.jpg,500,345,056.Pine_Grosbeak,108,34,374,329,241,181,266,295
../../CUB_200_2011/images\056.Pine_Grosbeak/Pine_Grosbeak_0006_38421.jpg,500,334,056.Pine_Grosbeak,249,42,357,296,303,169,108,254
../../CUB_200_2011/images\056.Pine_Grosbeak/Pine_Grosbeak_0056_38940.jpg,500,355,056.Pine_Grosbeak,73,83,355,274,214,178,282,191
../../CUB_200_2011/images\056.Pine_Grosbeak/Pine_Grosbeak_0104_38362.jpg,500,375,056.Pine_Grosbeak,36,71,356,328,196,199,320,257
../../CUB_200_2011/images\056.Pine_Grosbeak/Pine_Grosbeak_0058_38431.jpg,500,333,056.Pine_Grosbeak,186,63,392,289,289,176,206,226
../../CUB_200_2011/images\056.Pine_Grosbeak/Pine_Grosbeak_0042_38432.jpg,500,375,056.Pine_Grosbeak,152,75,317,299,234,187,165,224
../../CUB_200_2011/images\056.Pine_Grosbeak/Pine_Grosbeak_0048_38434.jpg,313,500,056.Pine_Grosbeak,55,93,272,373,163,233,217,280
../../CUB_200_2011/images\056.Pine_Grosbeak/Pine_Grosbeak_0003_38437.jpg,500,375,056.Pine_Grosbeak,23,65,271,361,147,213,248,296
../../CUB_200_2011/images\056.Pine_Grosbeak/Pine_Grosbeak_0096_38441.jpg,500,333,056.Pine_Grosbeak,166,16,469,328,317,172,303,312
../../CUB_200_2011/images\056.Pine_Grosbeak/Pine_Grosbeak_0025_38443.jpg,434,434,056.Pine_Grosbeak,86,83,302,248,194,165,216,165
../../CUB_200_2011/images\056.Pine_Grosbeak/Pine_Grosbeak_0038_38956.jpg,500,375,056.Pine_Grosbeak,169,46,399,361,284,203,230,315
../../CUB_200_2011/images\056.Pine_Grosbeak/Pine_Grosbeak_0109_38451.jpg,354,500,056.Pine_Grosbeak,109,47,306,430,207,238,197,383
../../CUB_200_2011/images\056.Pine_Grosbeak/Pine_Grosbeak_0036_38968.jpg,353,500,056.Pine_Grosbeak,106,197,319,496,212,346,213,299
../../CUB_200_2011/images\056.Pine_Grosbeak/Pine_Grosbeak_0071_38207.jpg,500,413,056.Pine_Grosbeak,119,88,478,368,298,228,359,280
../../CUB_200_2011/images\056.Pine_Grosbeak/Pine_Grosbeak_0012_38466.jpg,453,500,056.Pine_Grosbeak,96,182,412,426,254,304,316,244
../../CUB_200_2011/images\056.Pine_Grosbeak/Pine_Grosbeak_0068_38981.jpg,500,374,056.Pine_Grosbeak,59,81,392,321,225,201,333,240
../../CUB_200_2011/images\056.Pine_Grosbeak/Pine_Grosbeak_0002_38214.jpg,500,366,056.Pine_Grosbeak,122,89,361,317,241,203,239,228
../../CUB_200_2011/images\056.Pine_Grosbeak/Pine_Grosbeak_0102_38216.jpg,383,500,056.Pine_Grosbeak,22,76,226,369,124,222,204,293
../../CUB_200_2011/images\056.Pine_Grosbeak/Pine_Grosbeak_0032_38473.jpg,500,500,056.Pine_Grosbeak,250,234,382,392,316,313,132,158
../../CUB_200_2011/images\056.Pine_Grosbeak/Pine_Grosbeak_0050_38475.jpg,500,321,056.Pine_Grosbeak,111,38,487,265,299,151,376,227
../../CUB_200_2011/images\056.Pine_Grosbeak/Pine_Grosbeak_0100_38988.jpg,500,388,056.Pine_Grosbeak,17,97,430,292,223,194,413,195
../../CUB_200_2011/images\056.Pine_Grosbeak/Pine_Grosbeak_0097_38735.jpg,333,500,056.Pine_Grosbeak,87,204,332,433,209,318,245,229
../../CUB_200_2011/images\056.Pine_Grosbeak/Pine_Grosbeak_0043_38992.jpg,408,500,056.Pine_Grosbeak,46,49,405,467,225,258,359,418
../../CUB_200_2011/images\056.Pine_Grosbeak/Pine_Grosbeak_0029_38995.jpg,444,500,056.Pine_Grosbeak,15,151,409,465,212,308,394,314
../../CUB_200_2011/images\056.Pine_Grosbeak/Pine_Grosbeak_0111_38741.jpg,500,408,056.Pine_Grosbeak,23,127,280,370,151,248,257,243
../../CUB_200_2011/images\056.Pine_Grosbeak/Pine_Grosbeak_0008_38486.jpg,500,333,056.Pine_Grosbeak,82,42,296,284,189,163,214,242
../../CUB_200_2011/images\056.Pine_Grosbeak/Pine_Grosbeak_0016_38743.jpg,363,500,056.Pine_Grosbeak,28,103,279,461,153,282,251,358
../../CUB_200_2011/images\056.Pine_Grosbeak/Pine_Grosbeak_0106_38218.jpg,467,500,056.Pine_Grosbeak,160,88,360,441,260,264,200,353
../../CUB_200_2011/images\056.Pine_Grosbeak/Pine_Grosbeak_0078_38242.jpg,500,333,056.Pine_Grosbeak,119,17,410,332,264,174,291,315
../../CUB_200_2011/images\056.Pine_Grosbeak/Pine_Grosbeak_0083_38508.jpg,379,500,056.Pine_Grosbeak,174,101,321,421,247,261,147,320
../../CUB_200_2011/images\056.Pine_Grosbeak/Pine_Grosbeak_0044_38766.jpg,500,298,056.Pine_Grosbeak,49,75,313,230,181,152,264,155
../../CUB_200_2011/images\056.Pine_Grosbeak/Pine_Grosbeak_0114_38259.jpg,500,375,056.Pine_Grosbeak,40,43,350,374,195,208,310,331
../../CUB_200_2011/images\056.Pine_Grosbeak/Pine_Grosbeak_0067_38524.jpg,500,334,056.Pine_Grosbeak,11,165,213,292,112,228,202,127
../../CUB_200_2011/images\056.Pine_Grosbeak/Pine_Grosbeak_0055_38730.jpg,500,341,056.Pine_Grosbeak,267,52,388,288,327,170,121,236
../../CUB_200_2011/images\056.Pine_Grosbeak/Pine_Grosbeak_0046_38275.jpg,500,375,056.Pine_Grosbeak,166,74,369,299,267,186,203,225
../../CUB_200_2011/images\056.Pine_Grosbeak/Pine_Grosbeak_0108_38281.jpg,500,371,056.Pine_Grosbeak,102,110,365,312,233,211,263,202
../../CUB_200_2011/images\056.Pine_Grosbeak/Pine_Grosbeak_0105_38210.jpg,500,353,056.Pine_Grosbeak,62,23,437,258,249,140,375,235
../../CUB_200_2011/images\056.Pine_Grosbeak/Pine_Grosbeak_0052_38804.jpg,500,346,056.Pine_Grosbeak,127,60,261,234,194,147,134,174
../../CUB_200_2011/images\056.Pine_Grosbeak/Pine_Grosbeak_0053_38805.jpg,500,357,056.Pine_Grosbeak,110,45,495,300,302,172,385,255
../../CUB_200_2011/images\056.Pine_Grosbeak/Pine_Grosbeak_0082_38552.jpg,500,333,056.Pine_Grosbeak,189,54,463,276,326,165,274,222
../../CUB_200_2011/images\056.Pine_Grosbeak/Pine_Grosbeak_0091_38811.jpg,500,333,056.Pine_Grosbeak,25,79,380,285,202,182,355,206
../../CUB_200_2011/images\056.Pine_Grosbeak/Pine_Grosbeak_0088_38830.jpg,500,382,056.Pine_Grosbeak,62,104,224,349,143,226,162,245
../../CUB_200_2011/images\056.Pine_Grosbeak/Pine_Grosbeak_0059_38581.jpg,354,342,056.Pine_Grosbeak,68,79,289,298,178,188,221,219
../../CUB_200_2011/images\056.Pine_Grosbeak/Pine_Grosbeak_0035_38729.jpg,500,333,056.Pine_Grosbeak,43,54,367,315,205,184,324,261
../../CUB_200_2011/images\056.Pine_Grosbeak/Pine_Grosbeak_0115_38330.jpg,500,321,056.Pine_Grosbeak,141,99,337,231,239,165,196,132
../../CUB_200_2011/images\056.Pine_Grosbeak/Pine_Grosbeak_0019_38845.jpg,500,375,056.Pine_Grosbeak,83,13,362,355,222,184,279,342
../../CUB_200_2011/images\056.Pine_Grosbeak/Pine_Grosbeak_0034_38987.jpg,456,500,056.Pine_Grosbeak,60,197,435,413,247,305,375,216
../../CUB_200_2011/images\056.Pine_Grosbeak/Pine_Grosbeak_0033_38945.jpg,500,428,056.Pine_Grosbeak,113,116,309,279,211,197,196,163
../../CUB_200_2011/images\056.Pine_Grosbeak/Pine_Grosbeak_0107_38351.jpg,500,375,056.Pine_Grosbeak,160,44,447,292,303,168,287,248
../../CUB_200_2011/images\056.Pine_Grosbeak/Pine_Grosbeak_0009_38609.jpg,500,428,056.Pine_Grosbeak,73,32,360,401,216,216,287,369
../../CUB_200_2011/images\056.Pine_Grosbeak/Pine_Grosbeak_0075_38619.jpg,500,420,056.Pine_Grosbeak,163,114,368,330,265,222,205,216
../../CUB_200_2011/images\056.Pine_Grosbeak/Pine_Grosbeak_0018_38374.jpg,333,500,056.Pine_Grosbeak,18,65,258,480,138,272,240,415
../../CUB_200_2011/images\056.Pine_Grosbeak/Pine_Grosbeak_0049_38380.jpg,500,388,056.Pine_Grosbeak,54,40,319,372,186,206,265,332
../../CUB_200_2011/images\056.Pine_Grosbeak/Pine_Grosbeak_0021_38382.jpg,500,370,056.Pine_Grosbeak,14,79,344,368,179,223,330,289
../../CUB_200_2011/images\056.Pine_Grosbeak/Pine_Grosbeak_0014_38398.jpg,400,500,056.Pine_Grosbeak,133,115,396,455,264,285,263,340
../../CUB_200_2011/images\056.Pine_Grosbeak/Pine_Grosbeak_0054_38953.jpg,500,333,056.Pine_Grosbeak,216,76,423,200,319,138,207,124
../../CUB_200_2011/images\056.Pine_Grosbeak/Pine_Grosbeak_0004_38396.jpg,500,333,056.Pine_Grosbeak,98,86,493,311,295,198,395,225
../../CUB_200_2011/images\057.Rose_breasted_Grosbeak/Rose_Breasted_Grosbeak_0029_39434.jpg,500,375,057.Rose_breasted_Grosbeak,16,34,430,348,223,191,414,314
../../CUB_200_2011/images\057.Rose_breasted_Grosbeak/Rose_Breasted_Grosbeak_0008_39481.jpg,500,333,057.Rose_breasted_Grosbeak,99,59,340,315,219,187,241,256
../../CUB_200_2011/images\057.Rose_breasted_Grosbeak/Rose_Breasted_Grosbeak_0045_39489.jpg,500,376,057.Rose_breasted_Grosbeak,116,89,416,281,266,185,300,192
../../CUB_200_2011/images\057.Rose_breasted_Grosbeak/Rose_Breasted_Grosbeak_0101_39495.jpg,375,500,057.Rose_breasted_Grosbeak,77,160,297,329,187,244,220,169
../../CUB_200_2011/images\057.Rose_breasted_Grosbeak/Rose_Breasted_Grosbeak_0108_39000.jpg,500,333,057.Rose_breasted_Grosbeak,73,72,259,307,166,189,186,235
../../CUB_200_2011/images\057.Rose_breasted_Grosbeak/Rose_Breasted_Grosbeak_0097_39514.jpg,337,242,057.Rose_breasted_Grosbeak,97,72,202,187,149,129,105,115
../../CUB_200_2011/images\057.Rose_breasted_Grosbeak/Rose_Breasted_Grosbeak_0088_39035.jpg,500,349,057.Rose_breasted_Grosbeak,64,68,352,303,208,185,288,235
../../CUB_200_2011/images\057.Rose_breasted_Grosbeak/Rose_Breasted_Grosbeak_0014_39037.jpg,500,375,057.Rose_breasted_Grosbeak,61,76,342,302,201,189,281,226
../../CUB_200_2011/images\057.Rose_breasted_Grosbeak/Rose_Breasted_Grosbeak_0052_39044.jpg,500,372,057.Rose_breasted_Grosbeak,120,194,249,311,184,252,129,117
../../CUB_200_2011/images\057.Rose_breasted_Grosbeak/Rose_Breasted_Grosbeak_0059_39045.jpg,500,375,057.Rose_breasted_Grosbeak,5,41,463,300,234,170,458,259
../../CUB_200_2011/images\057.Rose_breasted_Grosbeak/Rose_Breasted_Grosbeak_0084_39053.jpg,500,433,057.Rose_breasted_Grosbeak,7,26,480,424,243,225,473,398
../../CUB_200_2011/images\057.Rose_breasted_Grosbeak/Rose_Breasted_Grosbeak_0103_39580.jpg,500,364,057.Rose_breasted_Grosbeak,24,65,274,276,149,170,250,211
../../CUB_200_2011/images\057.Rose_breasted_Grosbeak/Rose_Breasted_Grosbeak_0067_39592.jpg,500,390,057.Rose_breasted_Grosbeak,70,112,327,368,198,240,257,256
../../CUB_200_2011/images\057.Rose_breasted_Grosbeak/Rose_Breasted_Grosbeak_0125_39597.jpg,500,333,057.Rose_breasted_Grosbeak,45,14,349,332,197,173,304,318
../../CUB_200_2011/images\057.Rose_breasted_Grosbeak/Rose_Breasted_Grosbeak_0117_39601.jpg,500,333,057.Rose_breasted_Grosbeak,14,20,447,321,230,170,433,301
../../CUB_200_2011/images\057.Rose_breasted_Grosbeak/Rose_Breasted_Grosbeak_0068_39094.jpg,400,500,057.Rose_breasted_Grosbeak,53,94,227,338,140,216,174,244
../../CUB_200_2011/images\057.Rose_breasted_Grosbeak/Rose_Breasted_Grosbeak_0077_39613.jpg,500,427,057.Rose_breasted_Grosbeak,4,101,434,364,219,232,430,263
../../CUB_200_2011/images\057.Rose_breasted_Grosbeak/Rose_Breasted_Grosbeak_0033_39290.jpg,500,343,057.Rose_breasted_Grosbeak,281,115,408,298,344,206,127,183
../../CUB_200_2011/images\057.Rose_breasted_Grosbeak/Rose_Breasted_Grosbeak_0081_39136.jpg,333,500,057.Rose_breasted_Grosbeak,47,124,332,444,189,284,285,320
../../CUB_200_2011/images\057.Rose_breasted_Grosbeak/Rose_Breasted_Grosbeak_0004_39143.jpg,469,500,057.Rose_breasted_Grosbeak,130,187,281,463,205,325,151,276
../../CUB_200_2011/images\057.Rose_breasted_Grosbeak/Rose_Breasted_Grosbeak_0086_39658.jpg,500,333,057.Rose_breasted_Grosbeak,26,39,375,303,200,171,349,264
../../CUB_200_2011/images\057.Rose_breasted_Grosbeak/Rose_Breasted_Grosbeak_0012_39149.jpg,357,500,057.Rose_breasted_Grosbeak,99,104,332,410,215,257,233,306
../../CUB_200_2011/images\057.Rose_breasted_Grosbeak/Rose_Breasted_Grosbeak_0020_39152.jpg,412,500,057.Rose_breasted_Grosbeak,63,85,328,380,195,232,265,295
../../CUB_200_2011/images\057.Rose_breasted_Grosbeak/Rose_Breasted_Grosbeak_0055_39154.jpg,500,333,057.Rose_breasted_Grosbeak,44,23,378,305,211,164,334,282
../../CUB_200_2011/images\057.Rose_breasted_Grosbeak/Rose_Breasted_Grosbeak_0042_39158.jpg,438,500,057.Rose_breasted_Grosbeak,105,68,367,466,236,267,262,398
../../CUB_200_2011/images\057.Rose_breasted_Grosbeak/Rose_Breasted_Grosbeak_0017_39161.jpg,500,366,057.Rose_breasted_Grosbeak,17,17,467,317,242,167,450,300
../../CUB_200_2011/images\057.Rose_breasted_Grosbeak/Rose_Breasted_Grosbeak_0040_39689.jpg,500,377,057.Rose_breasted_Grosbeak,244,100,372,257,308,178,128,157
../../CUB_200_2011/images\057.Rose_breasted_Grosbeak/Rose_Breasted_Grosbeak_0095_39178.jpg,500,398,057.Rose_breasted_Grosbeak,92,117,354,343,223,230,262,226
../../CUB_200_2011/images\057.Rose_breasted_Grosbeak/Rose_Breasted_Grosbeak_0050_39695.jpg,400,500,057.Rose_breasted_Grosbeak,25,125,316,368,170,246,291,243
../../CUB_200_2011/images\057.Rose_breasted_Grosbeak/Rose_Breasted_Grosbeak_0104_39189.jpg,500,385,057.Rose_breasted_Grosbeak,142,49,338,375,240,212,196,326
../../CUB_200_2011/images\057.Rose_breasted_Grosbeak/Rose_Breasted_Grosbeak_0026_39191.jpg,500,333,057.Rose_breasted_Grosbeak,131,126,282,233,206,179,151,107
../../CUB_200_2011/images\057.Rose_breasted_Grosbeak/Rose_Breasted_Grosbeak_0106_39714.jpg,500,369,057.Rose_breasted_Grosbeak,30,73,397,299,213,186,367,226
../../CUB_200_2011/images\057.Rose_breasted_Grosbeak/Rose_Breasted_Grosbeak_0128_39204.jpg,500,351,057.Rose_breasted_Grosbeak,135,62,350,313,242,187,215,251
../../CUB_200_2011/images\057.Rose_breasted_Grosbeak/Rose_Breasted_Grosbeak_0011_39207.jpg,500,500,057.Rose_breasted_Grosbeak,146,74,363,410,254,242,217,336
../../CUB_200_2011/images\057.Rose_breasted_Grosbeak/Rose_Breasted_Grosbeak_0089_39211.jpg,500,333,057.Rose_breasted_Grosbeak,114,106,305,219,209,162,191,113
../../CUB_200_2011/images\057.Rose_breasted_Grosbeak/Rose_Breasted_Grosbeak_0018_39731.jpg,500,417,057.Rose_breasted_Grosbeak,114,92,407,322,260,207,293,230
../../CUB_200_2011/images\057.Rose_breasted_Grosbeak/Rose_Breasted_Grosbeak_0080_39734.jpg,333,500,057.Rose_breasted_Grosbeak,65,94,327,380,196,237,262,286
../../CUB_200_2011/images\057.Rose_breasted_Grosbeak/Rose_Breasted_Grosbeak_0003_39223.jpg,398,500,057.Rose_breasted_Grosbeak,97,170,264,288,180,229,167,118
../../CUB_200_2011/images\057.Rose_breasted_Grosbeak/Rose_Breasted_Grosbeak_0135_39227.jpg,500,364,057.Rose_breasted_Grosbeak,246,94,368,250,307,172,122,156
../../CUB_200_2011/images\057.Rose_breasted_Grosbeak/Rose_Breasted_Grosbeak_0062_39234.jpg,500,394,057.Rose_breasted_Grosbeak,20,119,325,346,172,232,305,227
../../CUB_200_2011/images\057.Rose_breasted_Grosbeak/Rose_Breasted_Grosbeak_0010_39238.jpg,500,333,057.Rose_breasted_Grosbeak,56,98,374,281,215,189,318,183
../../CUB_200_2011/images\057.Rose_breasted_Grosbeak/Rose_Breasted_Grosbeak_0025_39252.jpg,500,333,057.Rose_breasted_Grosbeak,22,136,381,308,201,222,359,172
../../CUB_200_2011/images\057.Rose_breasted_Grosbeak/Rose_Breasted_Grosbeak_0069_39254.jpg,500,319,057.Rose_breasted_Grosbeak,170,135,346,268,258,201,176,133
../../CUB_200_2011/images\057.Rose_breasted_Grosbeak/Rose_Breasted_Grosbeak_0114_39770.jpg,500,333,057.Rose_breasted_Grosbeak,153,36,487,320,320,178,334,284
../../CUB_200_2011/images\057.Rose_breasted_Grosbeak/Rose_Breasted_Grosbeak_0032_39772.jpg,500,375,057.Rose_breasted_Grosbeak,277,160,380,342,328,251,103,182
../../CUB_200_2011/images\057.Rose_breasted_Grosbeak/Rose_Breasted_Grosbeak_0016_39265.jpg,400,500,057.Rose_breasted_Grosbeak,130,115,338,488,234,301,208,373
../../CUB_200_2011/images\057.Rose_breasted_Grosbeak/Rose_Breasted_Grosbeak_0028_39271.jpg,500,500,057.Rose_breasted_Grosbeak,57,153,321,324,189,238,264,171
../../CUB_200_2011/images\057.Rose_breasted_Grosbeak/Rose_Breasted_Grosbeak_0019_39274.jpg,500,333,057.Rose_breasted_Grosbeak,7,45,335,324,171,184,328,279
../../CUB_200_2011/images\057.Rose_breasted_Grosbeak/Rose_Breasted_Grosbeak_0060_39279.jpg,500,375,057.Rose_breasted_Grosbeak,166,150,329,316,247,233,163,166
../../CUB_200_2011/images\057.Rose_breasted_Grosbeak/Rose_Breasted_Grosbeak_0087_39280.jpg,500,382,057.Rose_breasted_Grosbeak,163,128,326,317,244,222,163,189
../../CUB_200_2011/images\057.Rose_breasted_Grosbeak/Rose_Breasted_Grosbeak_0075_39795.jpg,400,500,057.Rose_breasted_Grosbeak,52,82,283,488,167,285,231,406
../../CUB_200_2011/images\057.Rose_breasted_Grosbeak/Rose_Breasted_Grosbeak_0122_39284.jpg,500,500,057.Rose_breasted_Grosbeak,288,132,395,336,341,234,107,204
../../CUB_200_2011/images\057.Rose_breasted_Grosbeak/Rose_Breasted_Grosbeak_0051_39798.jpg,500,333,057.Rose_breasted_Grosbeak,166,123,310,255,238,189,144,132
../../CUB_200_2011/images\057.Rose_breasted_Grosbeak/Rose_Breasted_Grosbeak_0001_39801.jpg,500,333,057.Rose_breasted_Grosbeak,242,120,363,245,302,182,121,125
../../CUB_200_2011/images\057.Rose_breasted_Grosbeak/Rose_Breasted_Grosbeak_0063_39802.jpg,500,392,057.Rose_breasted_Grosbeak,169,93,309,321,239,207,140,228
../../CUB_200_2011/images\057.Rose_breasted_Grosbeak/Rose_Breasted_Grosbeak_0126_39361.jpg,500,333,057.Rose_breasted_Grosbeak,82,80,197,242,139,161,115,162
../../CUB_200_2011/images\057.Rose_breasted_Grosbeak/Rose_Breasted_Grosbeak_0092_39367.jpg,500,386,057.Rose_breasted_Grosbeak,118,118,409,300,263,209,291,182
../../CUB_200_2011/images\057.Rose_breasted_Grosbeak/Rose_Breasted_Grosbeak_0110_39373.jpg,365,500,057.Rose_breasted_Grosbeak,108,180,249,313,178,246,141,133
../../CUB_200_2011/images\057.Rose_breasted_Grosbeak/Rose_Breasted_Grosbeak_0024_39398.jpg,333,500,057.Rose_breasted_Grosbeak,35,94,300,417,167,255,265,323
../../CUB_200_2011/images\057.Rose_breasted_Grosbeak/Rose_Breasted_Grosbeak_0047_39407.jpg,500,494,057.Rose_breasted_Grosbeak,132,116,386,287,259,201,254,171
../../CUB_200_2011/images\058.Pigeon_Guillemot/Pigeon_Guillemot_0018_40195.jpg,500,333,058.Pigeon_Guillemot,6,60,478,269,242,164,472,209
../../CUB_200_2011/images\058.Pigeon_Guillemot/Pigeon_Guillemot_0069_40278.jpg,500,435,058.Pigeon_Guillemot,110,73,316,354,213,213,206,281
../../CUB_200_2011/images\058.Pigeon_Guillemot/Pigeon_Guillemot_0012_40236.jpg,500,334,058.Pigeon_Guillemot,87,99,393,287,240,193,306,188
../../CUB_200_2011/images\058.Pigeon_Guillemot/Pigeon_Guillemot_0062_39853.jpg,500,400,058.Pigeon_Guillemot,155,118,394,275,274,196,239,157
../../CUB_200_2011/images\058.Pigeon_Guillemot/Pigeon_Guillemot_0073_40209.jpg,500,254,058.Pigeon_Guillemot,238,71,458,171,348,121,220,100
../../CUB_200_2011/images\058.Pigeon_Guillemot/Pigeon_Guillemot_0071_40216.jpg,500,272,058.Pigeon_Guillemot,103,42,376,233,239,137,273,191
../../CUB_200_2011/images\058.Pigeon_Guillemot/Pigeon_Guillemot_0084_40217.jpg,500,336,058.Pigeon_Guillemot,138,56,411,327,274,191,273,271
../../CUB_200_2011/images\058.Pigeon_Guillemot/Pigeon_Guillemot_0009_40218.jpg,500,375,058.Pigeon_Guillemot,0,78,405,250,202,164,405,172
../../CUB_200_2011/images\058.Pigeon_Guillemot/Pigeon_Guillemot_0015_40232.jpg,500,399,058.Pigeon_Guillemot,106,99,367,313,236,206,261,214
../../CUB_200_2011/images\058.Pigeon_Guillemot/Pigeon_Guillemot_0108_40235.jpg,500,334,058.Pigeon_Guillemot,158,68,362,281,260,174,204,213
../../CUB_200_2011/images\058.Pigeon_Guillemot/Pigeon_Guillemot_0083_39980.jpg,500,404,058.Pigeon_Guillemot,88,82,434,354,261,218,346,272
../../CUB_200_2011/images\058.Pigeon_Guillemot/Pigeon_Guillemot_0003_39986.jpg,500,350,058.Pigeon_Guillemot,145,85,357,278,251,181,212,193
../../CUB_200_2011/images\058.Pigeon_Guillemot/Pigeon_Guillemot_0096_39995.jpg,500,375,058.Pigeon_Guillemot,73,58,384,372,228,215,311,314
../../CUB_200_2011/images\058.Pigeon_Guillemot/Pigeon_Guillemot_0013_40253.jpg,500,217,058.Pigeon_Guillemot,140,40,335,142,237,91,195,102
../../CUB_200_2011/images\058.Pigeon_Guillemot/Pigeon_Guillemot_0025_40511.jpg,500,367,058.Pigeon_Guillemot,132,69,304,327,218,198,172,258
../../CUB_200_2011/images\058.Pigeon_Guillemot/Pigeon_Guillemot_0019_40515.jpg,500,334,058.Pigeon_Guillemot,158,31,297,295,227,163,139,264
../../CUB_200_2011/images\058.Pigeon_Guillemot/Pigeon_Guillemot_0089_40008.jpg,500,400,058.Pigeon_Guillemot,77,27,405,332,241,179,328,305
../../CUB_200_2011/images\058.Pigeon_Guillemot/Pigeon_Guillemot_0040_40270.jpg,500,333,058.Pigeon_Guillemot,206,111,358,243,282,177,152,132
../../CUB_200_2011/images\058.Pigeon_Guillemot/Pigeon_Guillemot_0023_39829.jpg,500,333,058.Pigeon_Guillemot,168,75,435,201,301,138,267,126
../../CUB_200_2011/images\058.Pigeon_Guillemot/Pigeon_Guillemot_0042_40281.jpg,500,375,058.Pigeon_Guillemot,159,135,314,352,236,243,155,217
../../CUB_200_2011/images\058.Pigeon_Guillemot/Pigeon_Guillemot_0082_40290.jpg,500,368,058.Pigeon_Guillemot,188,77,324,273,256,175,136,196
../../CUB_200_2011/images\058.Pigeon_Guillemot/Pigeon_Guillemot_0038_40035.jpg,500,440,058.Pigeon_Guillemot,108,56,477,344,292,200,369,288
../../CUB_200_2011/images\058.Pigeon_Guillemot/Pigeon_Guillemot_0068_40039.jpg,500,340,058.Pigeon_Guillemot,147,117,413,231,280,174,266,114
../../CUB_200_2011/images\058.Pigeon_Guillemot/Pigeon_Guillemot_0014_40040.jpg,500,375,058.Pigeon_Guillemot,176,120,451,345,313,232,275,225
../../CUB_200_2011/images\058.Pigeon_Guillemot/Pigeon_Guillemot_0064_40044.jpg,500,335,058.Pigeon_Guillemot,213,77,394,226,303,151,181,149
../../CUB_200_2011/images\058.Pigeon_Guillemot/Pigeon_Guillemot_0028_40046.jpg,500,356,058.Pigeon_Guillemot,57,91,452,270,254,180,395,179
../../CUB_200_2011/images\058.Pigeon_Guillemot/Pigeon_Guillemot_0041_39807.jpg,500,314,058.Pigeon_Guillemot,46,44,382,262,214,153,336,218
../../CUB_200_2011/images\058.Pigeon_Guillemot/Pigeon_Guillemot_0024_39814.jpg,500,335,058.Pigeon_Guillemot,116,35,334,313,225,174,218,278
../../CUB_200_2011/images\058.Pigeon_Guillemot/Pigeon_Guillemot_0034_40074.jpg,450,300,058.Pigeon_Guillemot,165,92,308,204,236,148,143,112
../../CUB_200_2011/images\058.Pigeon_Guillemot/Pigeon_Guillemot_0105_40078.jpg,500,333,058.Pigeon_Guillemot,129,26,468,296,298,161,339,270
../../CUB_200_2011/images\058.Pigeon_Guillemot/Pigeon_Guillemot_0081_40339.jpg,500,333,058.Pigeon_Guillemot,4,61,473,269,238,165,469,208
../../CUB_200_2011/images\058.Pigeon_Guillemot/Pigeon_Guillemot_0020_40088.jpg,500,375,058.Pigeon_Guillemot,132,128,362,251,247,189,230,123
../../CUB_200_2011/images\058.Pigeon_Guillemot/Pigeon_Guillemot_0030_40089.jpg,500,335,058.Pigeon_Guillemot,156,148,292,291,224,219,136,143
../../CUB_200_2011/images\058.Pigeon_Guillemot/Pigeon_Guillemot_0090_40090.jpg,404,500,058.Pigeon_Guillemot,140,150,337,410,238,280,197,260
../../CUB_200_2011/images\058.Pigeon_Guillemot/Pigeon_Guillemot_0043_39861.jpg,500,386,058.Pigeon_Guillemot,75,61,319,339,197,200,244,278
../../CUB_200_2011/images\058.Pigeon_Guillemot/Pigeon_Guillemot_0005_40375.jpg,500,333,058.Pigeon_Guillemot,172,94,298,250,235,172,126,156
../../CUB_200_2011/images\058.Pigeon_Guillemot/Pigeon_Guillemot_0092_39864.jpg,500,333,058.Pigeon_Guillemot,20,62,499,330,259,196,479,268
../../CUB_200_2011/images\058.Pigeon_Guillemot/Pigeon_Guillemot_0095_39867.jpg,500,375,058.Pigeon_Guillemot,149,142,304,248,226,195,155,106
../../CUB_200_2011/images\058.Pigeon_Guillemot/Pigeon_Guillemot_0103_39882.jpg,500,333,058.Pigeon_Guillemot,149,80,389,249,269,164,240,169
../../CUB_200_2011/images\058.Pigeon_Guillemot/Pigeon_Guillemot_0026_40126.jpg,401,500,058.Pigeon_Guillemot,125,115,314,451,219,283,189,336
../../CUB_200_2011/images\058.Pigeon_Guillemot/Pigeon_Guillemot_0109_39872.jpg,500,334,058.Pigeon_Guillemot,71,15,210,196,140,105,139,181
../../CUB_200_2011/images\058.Pigeon_Guillemot/Pigeon_Guillemot_0057_40130.jpg,500,316,058.Pigeon_Guillemot,162,75,474,218,318,146,312,143
../../CUB_200_2011/images\058.Pigeon_Guillemot/Pigeon_Guillemot_0053_39876.jpg,500,384,058.Pigeon_Guillemot,145,86,340,328,242,207,195,242
../../CUB_200_2011/images\058.Pigeon_Guillemot/Pigeon_Guillemot_0079_40389.jpg,500,375,058.Pigeon_Guillemot,28,85,408,270,218,177,380,185
../../CUB_200_2011/images\058.Pigeon_Guillemot/Pigeon_Guillemot_0052_40137.jpg,500,333,058.Pigeon_Guillemot,219,99,410,226,314,162,191,127
../../CUB_200_2011/images\058.Pigeon_Guillemot/Pigeon_Guillemot_0077_39885.jpg,500,334,058.Pigeon_Guillemot,57,74,483,233,270,153,426,159
../../CUB_200_2011/images\058.Pigeon_Guillemot/Pigeon_Guillemot_0029_39889.jpg,500,345,058.Pigeon_Guillemot,162,94,355,263,258,178,193,169
../../CUB_200_2011/images\058.Pigeon_Guillemot/Pigeon_Guillemot_0037_40149.jpg,500,333,058.Pigeon_Guillemot,157,116,314,220,235,168,157,104
../../CUB_200_2011/images\058.Pigeon_Guillemot/Pigeon_Guillemot_0007_40313.jpg,500,428,058.Pigeon_Guillemot,153,189,317,328,235,258,164,139
../../CUB_200_2011/images\058.Pigeon_Guillemot/Pigeon_Guillemot_0087_39897.jpg,500,375,058.Pigeon_Guillemot,149,89,382,301,265,195,233,212
../../CUB_200_2011/images\058.Pigeon_Guillemot/Pigeon_Guillemot_0098_39902.jpg,500,333,058.Pigeon_Guillemot,184,116,398,248,291,182,214,132
../../CUB_200_2011/images\058.Pigeon_Guillemot/Pigeon_Guillemot_0075_40159.jpg,500,375,058.Pigeon_Guillemot,156,30,361,324,258,177,205,294
../../CUB_200_2011/images\058.Pigeon_Guillemot/Pigeon_Guillemot_0072_39905.jpg,400,500,058.Pigeon_Guillemot,38,40,335,293,186,166,297,253
../../CUB_200_2011/images\058.Pigeon_Guillemot/Pigeon_Guillemot_0055_40171.jpg,500,346,058.Pigeon_Guillemot,132,90,344,306,238,198,212,216
../../CUB_200_2011/images\058.Pigeon_Guillemot/Pigeon_Guillemot_0100_40179.jpg,500,400,058.Pigeon_Guillemot,52,132,432,318,242,225,380,186
../../CUB_200_2011/images\058.Pigeon_Guillemot/Pigeon_Guillemot_0058_40184.jpg,500,375,058.Pigeon_Guillemot,10,20,475,307,242,163,465,287
../../CUB_200_2011/images\058.Pigeon_Guillemot/Pigeon_Guillemot_0059_39929.jpg,500,333,058.Pigeon_Guillemot,136,117,385,250,260,183,249,133
../../CUB_200_2011/images\058.Pigeon_Guillemot/Pigeon_Guillemot_0011_39935.jpg,500,500,058.Pigeon_Guillemot,108,159,439,375,273,267,331,216
../../CUB_200_2011/images\059.California_Gull/California_Gull_0131_40963.jpg,304,268,059.California_Gull,43,52,278,239,160,145,235,187
../../CUB_200_2011/images\059.California_Gull/California_Gull_0025_41479.jpg,500,333,059.California_Gull,82,73,402,203,242,138,320,130
../../CUB_200_2011/images\059.California_Gull/California_Gull_0067_40973.jpg,500,333,059.California_Gull,77,57,275,235,176,146,198,178
../../CUB_200_2011/images\059.California_Gull/California_Gull_0096_40978.jpg,500,454,059.California_Gull,106,175,388,294,247,234,282,119
../../CUB_200_2011/images\059.California_Gull/California_Gull_0102_40986.jpg,500,372,059.California_Gull,89,78,317,234,203,156,228,156
../../CUB_200_2011/images\059.California_Gull/California_Gull_0029_41506.jpg,500,471,059.California_Gull,108,151,365,314,236,232,257,163
../../CUB_200_2011/images\059.California_Gull/California_Gull_0053_41011.jpg,500,332,059.California_Gull,31,13,204,235,117,124,173,222
../../CUB_200_2011/images\059.California_Gull/California_Gull_0111_41033.jpg,500,332,059.California_Gull,227,74,499,277,363,175,272,203
../../CUB_200_2011/images\059.California_Gull/California_Gull_0039_41034.jpg,500,333,059.California_Gull,294,65,444,166,369,115,150,101
../../CUB_200_2011/images\059.California_Gull/California_Gull_0034_41548.jpg,500,375,059.California_Gull,125,108,296,294,210,201,171,186
../../CUB_200_2011/images\059.California_Gull/California_Gull_0078_41550.jpg,500,333,059.California_Gull,232,100,447,302,339,201,215,202
../../CUB_200_2011/images\059.California_Gull/California_Gull_0086_41040.jpg,500,333,059.California_Gull,58,45,463,333,260,189,405,288
../../CUB_200_2011/images\059.California_Gull/California_Gull_0103_41044.jpg,500,337,059.California_Gull,208,49,490,306,349,177,282,257
../../CUB_200_2011/images\059.California_Gull/California_Gull_0052_41047.jpg,500,406,059.California_Gull,71,96,313,318,192,207,242,222
../../CUB_200_2011/images\059.California_Gull/California_Gull_0064_41562.jpg,500,375,059.California_Gull,187,56,462,318,324,187,275,262
../../CUB_200_2011/images\059.California_Gull/California_Gull_0110_41063.jpg,500,375,059.California_Gull,153,92,390,359,271,225,237,267
../../CUB_200_2011/images\059.California_Gull/California_Gull_0037_41066.jpg,500,383,059.California_Gull,127,40,455,331,291,185,328,291
../../CUB_200_2011/images\059.California_Gull/California_Gull_0006_41079.jpg,500,336,059.California_Gull,181,51,426,334,303,192,245,283
../../CUB_200_2011/images\059.California_Gull/California_Gull_0027_41083.jpg,500,375,059.California_Gull,41,51,380,315,210,183,339,264
../../CUB_200_2011/images\059.California_Gull/California_Gull_0100_41088.jpg,500,375,059.California_Gull,86,85,442,370,264,227,356,285
../../CUB_200_2011/images\059.California_Gull/California_Gull_0093_41111.jpg,500,375,059.California_Gull,116,8,400,342,258,175,284,334
../../CUB_200_2011/images\059.California_Gull/California_Gull_0105_41116.jpg,500,311,059.California_Gull,67,68,292,180,179,124,225,112
../../CUB_200_2011/images\059.California_Gull/California_Gull_0048_41121.jpg,500,500,059.California_Gull,102,133,406,379,254,256,304,246
../../CUB_200_2011/images\059.California_Gull/California_Gull_0101_41140.jpg,500,375,059.California_Gull,122,99,342,353,232,226,220,254
../../CUB_200_2011/images\059.California_Gull/California_Gull_0009_40662.jpg,500,375,059.California_Gull,99,99,351,263,225,181,252,164
../../CUB_200_2011/images\059.California_Gull/California_Gull_0028_40666.jpg,333,500,059.California_Gull,54,88,316,257,185,172,262,169
../../CUB_200_2011/images\059.California_Gull/California_Gull_0066_41188.jpg,500,375,059.California_Gull,131,163,312,274,221,218,181,111
../../CUB_200_2011/images\059.California_Gull/California_Gull_0092_41300.jpg,500,375,059.California_Gull,55,92,347,275,201,183,292,183
../../CUB_200_2011/images\059.California_Gull/California_Gull_0121_41196.jpg,500,333,059.California_Gull,125,30,439,299,282,164,314,269
../../CUB_200_2011/images\059.California_Gull/California_Gull_0046_41209.jpg,500,480,059.California_Gull,38,57,474,464,256,260,436,407
../../CUB_200_2011/images\059.California_Gull/California_Gull_0055_41218.jpg,500,333,059.California_Gull,10,95,487,250,248,172,477,155
../../CUB_200_2011/images\059.California_Gull/California_Gull_0089_40716.jpg,500,333,059.California_Gull,42,23,412,292,227,157,370,269
../../CUB_200_2011/images\059.California_Gull/California_Gull_0010_40735.jpg,500,435,059.California_Gull,55,48,388,347,221,197,333,299
../../CUB_200_2011/images\059.California_Gull/California_Gull_0114_41267.jpg,500,434,059.California_Gull,39,62,380,377,209,219,341,315
../../CUB_200_2011/images\059.California_Gull/California_Gull_0059_40764.jpg,476,500,059.California_Gull,72,28,444,471,258,249,372,443
../../CUB_200_2011/images\059.California_Gull/California_Gull_0117_41292.jpg,333,500,059.California_Gull,13,115,277,331,145,223,264,216
../../CUB_200_2011/images\059.California_Gull/California_Gull_0088_41296.jpg,500,333,059.California_Gull,336,103,445,316,390,209,109,213
../../CUB_200_2011/images\059.California_Gull/California_Gull_0012_41272.jpg,500,375,059.California_Gull,83,74,283,239,183,156,200,165
../../CUB_200_2011/images\059.California_Gull/California_Gull_0001_40786.jpg,500,333,059.California_Gull,175,100,378,291,276,195,203,191
../../CUB_200_2011/images\059.California_Gull/California_Gull_0076_40788.jpg,500,333,059.California_Gull,219,6,479,237,349,121,260,231
../../CUB_200_2011/images\059.California_Gull/California_Gull_0081_41318.jpg,500,334,059.California_Gull,183,92,391,284,287,188,208,192
../../CUB_200_2011/images\059.California_Gull/California_Gull_0091_41276.jpg,500,359,059.California_Gull,85,55,455,354,270,204,370,299
../../CUB_200_2011/images\059.California_Gull/California_Gull_0043_41326.jpg,500,400,059.California_Gull,37,56,348,331,192,193,311,275
../../CUB_200_2011/images\059.California_Gull/California_Gull_0123_41330.jpg,500,332,059.California_Gull,61,81,337,273,199,177,276,192
../../CUB_200_2011/images\059.California_Gull/California_Gull_0032_41335.jpg,500,375,059.California_Gull,204,120,499,377,351,248,295,257
../../CUB_200_2011/images\059.California_Gull/California_Gull_0132_40836.jpg,500,298,059.California_Gull,13,81,465,187,239,134,452,106
../../CUB_200_2011/images\059.California_Gull/California_Gull_0030_41354.jpg,500,358,059.California_Gull,129,5,461,303,295,154,332,298
../../CUB_200_2011/images\059.California_Gull/California_Gull_0074_41358.jpg,500,332,059.California_Gull,161,109,411,278,286,193,250,169
../../CUB_200_2011/images\059.California_Gull/California_Gull_0058_40858.jpg,500,333,059.California_Gull,18,101,291,297,154,199,273,196
../../CUB_200_2011/images\059.California_Gull/California_Gull_0038_40865.jpg,500,333,059.California_Gull,3,31,378,331,190,181,375,300
../../CUB_200_2011/images\059.California_Gull/California_Gull_0054_40871.jpg,500,375,059.California_Gull,229,145,402,278,315,211,173,133
../../CUB_200_2011/images\059.California_Gull/California_Gull_0026_41386.jpg,500,334,059.California_Gull,91,84,330,243,210,163,239,159
../../CUB_200_2011/images\059.California_Gull/California_Gull_0014_40880.jpg,500,406,059.California_Gull,120,101,391,288,255,194,271,187
../../CUB_200_2011/images\059.California_Gull/California_Gull_0087_40909.jpg,500,398,059.California_Gull,107,76,462,333,284,204,355,257
../../CUB_200_2011/images\059.California_Gull/California_Gull_0135_41383.jpg,500,362,059.California_Gull,88,72,331,272,209,172,243,200
../../CUB_200_2011/images\059.California_Gull/California_Gull_0008_40942.jpg,500,333,059.California_Gull,174,58,339,256,256,157,165,198
../../CUB_200_2011/images\059.California_Gull/California_Gull_0019_41377.jpg,500,346,059.California_Gull,30,26,437,303,233,164,407,277
../../CUB_200_2011/images\059.California_Gull/California_Gull_0109_41465.jpg,334,500,059.California_Gull,181,294,323,418,252,356,142,124
../../CUB_200_2011/images\059.California_Gull/California_Gull_0031_41469.jpg,500,375,059.California_Gull,120,47,288,218,204,132,168,171
../../CUB_200_2011/images\059.California_Gull/California_Gull_0021_41471.jpg,500,346,059.California_Gull,36,76,380,291,208,183,344,215
../../CUB_200_2011/images\060.Glaucous_winged_Gull/Glaucous_Winged_Gull_0136_45059.jpg,500,394,060.Glaucous_winged_Gull,28,83,363,360,195,221,335,277
../../CUB_200_2011/images\060.Glaucous_winged_Gull/Glaucous_Winged_Gull_0087_44550.jpg,500,400,060.Glaucous_winged_Gull,43,92,313,350,178,221,270,258
../../CUB_200_2011/images\060.Glaucous_winged_Gull/Glaucous_Winged_Gull_0049_45065.jpg,500,375,060.Glaucous_winged_Gull,119,60,442,327,280,193,323,267
../../CUB_200_2011/images\060.Glaucous_winged_Gull/Glaucous_Winged_Gull_0078_44461.jpg,500,357,060.Glaucous_winged_Gull,97,115,345,294,221,204,248,179
../../CUB_200_2011/images\060.Glaucous_winged_Gull/Glaucous_Winged_Gull_0007_44575.jpg,500,375,060.Glaucous_winged_Gull,1,62,379,309,190,185,378,247
../../CUB_200_2011/images\060.Glaucous_winged_Gull/Glaucous_Winged_Gull_0035_44576.jpg,500,432,060.Glaucous_winged_Gull,7,1,445,333,226,167,438,332
../../CUB_200_2011/images\060.Glaucous_winged_Gull/Glaucous_Winged_Gull_0118_2081.jpg,500,500,060.Glaucous_winged_Gull,160,219,395,352,277,285,235,133
../../CUB_200_2011/images\060.Glaucous_winged_Gull/Glaucous_Winged_Gull_0023_45090.jpg,500,356,060.Glaucous_winged_Gull,182,28,442,243,312,135,260,215
../../CUB_200_2011/images\060.Glaucous_winged_Gull/Glaucous_Winged_Gull_0102_44579.jpg,500,338,060.Glaucous_winged_Gull,47,84,300,239,173,161,253,155
../../CUB_200_2011/images\060.Glaucous_winged_Gull/Glaucous_Winged_Gull_0032_44594.jpg,500,407,060.Glaucous_winged_Gull,8,14,461,392,234,203,453,378
../../CUB_200_2011/images\060.Glaucous_winged_Gull/Glaucous_Winged_Gull_0093_44724.jpg,500,395,060.Glaucous_winged_Gull,192,133,384,276,288,204,192,143
../../CUB_200_2011/images\060.Glaucous_winged_Gull/Glaucous_Winged_Gull_0002_44612.jpg,500,333,060.Glaucous_winged_Gull,77,30,434,313,255,171,357,283
../../CUB_200_2011/images\060.Glaucous_winged_Gull/Glaucous_Winged_Gull_0034_44625.jpg,474,480,060.Glaucous_winged_Gull,85,198,312,479,198,338,227,281
../../CUB_200_2011/images\060.Glaucous_winged_Gull/Glaucous_Winged_Gull_0028_44628.jpg,500,332,060.Glaucous_winged_Gull,67,88,390,296,228,192,323,208
../../CUB_200_2011/images\060.Glaucous_winged_Gull/Glaucous_Winged_Gull_0112_44731.jpg,500,375,060.Glaucous_winged_Gull,120,32,469,355,294,193,349,323
../../CUB_200_2011/images\060.Glaucous_winged_Gull/Glaucous_Winged_Gull_0067_45156.jpg,500,331,060.Glaucous_winged_Gull,144,50,451,303,297,176,307,253
../../CUB_200_2011/images\060.Glaucous_winged_Gull/Glaucous_Winged_Gull_0056_44658.jpg,500,400,060.Glaucous_winged_Gull,96,41,453,375,274,208,357,334
../../CUB_200_2011/images\060.Glaucous_winged_Gull/Glaucous_Winged_Gull_0124_44663.jpg,338,500,060.Glaucous_winged_Gull,61,134,335,434,198,284,274,300
../../CUB_200_2011/images\060.Glaucous_winged_Gull/Glaucous_Winged_Gull_0066_44669.jpg,500,332,060.Glaucous_winged_Gull,217,137,334,265,275,201,117,128
../../CUB_200_2011/images\060.Glaucous_winged_Gull/Glaucous_Winged_Gull_0138_44694.jpg,500,430,060.Glaucous_winged_Gull,8,36,418,406,213,221,410,370
../../CUB_200_2011/images\060.Glaucous_winged_Gull/Glaucous_Winged_Gull_0094_44696.jpg,420,280,060.Glaucous_winged_Gull,48,14,314,269,181,141,266,255
../../CUB_200_2011/images\060.Glaucous_winged_Gull/Glaucous_Winged_Gull_0130_45210.jpg,500,475,060.Glaucous_winged_Gull,50,100,428,438,239,269,378,338
../../CUB_200_2011/images\060.Glaucous_winged_Gull/Glaucous_Winged_Gull_0015_44198.jpg,500,333,060.Glaucous_winged_Gull,151,84,394,283,272,183,243,199
../../CUB_200_2011/images\060.Glaucous_winged_Gull/Glaucous_Winged_Gull_0081_45223.jpg,500,356,060.Glaucous_winged_Gull,121,73,388,338,254,205,267,265
../../CUB_200_2011/images\060.Glaucous_winged_Gull/Glaucous_Winged_Gull_0017_45224.jpg,500,396,060.Glaucous_winged_Gull,82,92,354,350,218,221,272,258
../../CUB_200_2011/images\060.Glaucous_winged_Gull/Glaucous_Winged_Gull_0101_44718.jpg,500,333,060.Glaucous_winged_Gull,31,9,326,309,178,159,295,300
../../CUB_200_2011/images\060.Glaucous_winged_Gull/Glaucous_Winged_Gull_0038_44719.jpg,430,500,060.Glaucous_winged_Gull,40,108,322,409,181,258,282,301
../../CUB_200_2011/images\060.Glaucous_winged_Gull/Glaucous_Winged_Gull_0116_45236.jpg,500,352,060.Glaucous_winged_Gull,99,66,281,212,190,139,182,146
../../CUB_200_2011/images\060.Glaucous_winged_Gull/Glaucous_Winged_Gull_0060_44215.jpg,390,500,060.Glaucous_winged_Gull,113,71,378,390,245,230,265,319
../../CUB_200_2011/images\060.Glaucous_winged_Gull/Glaucous_Winged_Gull_0022_44733.jpg,500,333,060.Glaucous_winged_Gull,99,43,488,325,293,184,389,282
../../CUB_200_2011/images\060.Glaucous_winged_Gull/Glaucous_Winged_Gull_0133_44738.jpg,333,500,060.Glaucous_winged_Gull,62,282,263,454,162,368,201,172
../../CUB_200_2011/images\060.Glaucous_winged_Gull/Glaucous_Winged_Gull_0129_44742.jpg,500,400,060.Glaucous_winged_Gull,56,38,460,346,258,192,404,308
../../CUB_200_2011/images\060.Glaucous_winged_Gull/Glaucous_Winged_Gull_0134_44743.jpg,500,375,060.Glaucous_winged_Gull,201,128,316,262,258,195,115,134
../../CUB_200_2011/images\060.Glaucous_winged_Gull/Glaucous_Winged_Gull_0076_44744.jpg,500,375,060.Glaucous_winged_Gull,37,32,272,356,154,194,235,324
../../CUB_200_2011/images\060.Glaucous_winged_Gull/Glaucous_Winged_Gull_0126_44761.jpg,500,376,060.Glaucous_winged_Gull,115,111,378,302,246,206,263,191
../../CUB_200_2011/images\060.Glaucous_winged_Gull/Glaucous_Winged_Gull_0073_44253.jpg,500,333,060.Glaucous_winged_Gull,52,18,425,301,238,159,373,283
../../CUB_200_2011/images\060.Glaucous_winged_Gull/Glaucous_Winged_Gull_0127_44258.jpg,500,333,060.Glaucous_winged_Gull,160,49,324,294,242,171,164,245
../../CUB_200_2011/images\060.Glaucous_winged_Gull/Glaucous_Winged_Gull_0084_44775.jpg,500,334,060.Glaucous_winged_Gull,37,36,497,330,267,183,460,294
../../CUB_200_2011/images\060.Glaucous_winged_Gull/Glaucous_Winged_Gull_0012_44264.jpg,500,500,060.Glaucous_winged_Gull,22,112,424,497,223,304,402,385
../../CUB_200_2011/images\060.Glaucous_winged_Gull/Glaucous_Winged_Gull_0086_44268.jpg,500,333,060.Glaucous_winged_Gull,98,43,358,302,228,172,260,259
../../CUB_200_2011/images\060.Glaucous_winged_Gull/Glaucous_Winged_Gull_0057_44807.jpg,330,220,060.Glaucous_winged_Gull,88,29,284,203,186,116,196,174
../../CUB_200_2011/images\060.Glaucous_winged_Gull/Glaucous_Winged_Gull_0117_44298.jpg,500,383,060.Glaucous_winged_Gull,62,30,461,344,261,187,399,314
../../CUB_200_2011/images\060.Glaucous_winged_Gull/Glaucous_Winged_Gull_0011_44827.jpg,500,333,060.Glaucous_winged_Gull,64,105,307,309,185,207,243,204
../../CUB_200_2011/images\060.Glaucous_winged_Gull/Glaucous_Winged_Gull_0014_44832.jpg,500,440,060.Glaucous_winged_Gull,41,79,422,308,231,193,381,229
../../CUB_200_2011/images\060.Glaucous_winged_Gull/Glaucous_Winged_Gull_0090_44836.jpg,435,500,060.Glaucous_winged_Gull,14,140,368,400,191,270,354,260
../../CUB_200_2011/images\060.Glaucous_winged_Gull/Glaucous_Winged_Gull_0091_44848.jpg,500,375,060.Glaucous_winged_Gull,98,72,495,326,296,199,397,254
../../CUB_200_2011/images\060.Glaucous_winged_Gull/Glaucous_Winged_Gull_0061_44852.jpg,500,333,060.Glaucous_winged_Gull,173,83,382,263,277,173,209,180
../../CUB_200_2011/images\060.Glaucous_winged_Gull/Glaucous_Winged_Gull_0111_44856.jpg,500,375,060.Glaucous_winged_Gull,86,27,488,374,287,200,402,347
../../CUB_200_2011/images\060.Glaucous_winged_Gull/Glaucous_Winged_Gull_0005_44860.jpg,500,336,060.Glaucous_winged_Gull,159,78,450,327,304,202,291,249
../../CUB_200_2011/images\060.Glaucous_winged_Gull/Glaucous_Winged_Gull_0004_44361.jpg,500,375,060.Glaucous_winged_Gull,137,111,379,303,258,207,242,192
../../CUB_200_2011/images\060.Glaucous_winged_Gull/Glaucous_Winged_Gull_0053_44881.jpg,500,333,060.Glaucous_winged_Gull,146,34,460,323,303,178,314,289
../../CUB_200_2011/images\060.Glaucous_winged_Gull/Glaucous_Winged_Gull_0110_44377.jpg,500,375,060.Glaucous_winged_Gull,3,37,439,372,221,204,436,335
../../CUB_200_2011/images\060.Glaucous_winged_Gull/Glaucous_Winged_Gull_0013_44381.jpg,500,333,060.Glaucous_winged_Gull,186,130,393,302,289,216,207,172
../../CUB_200_2011/images\060.Glaucous_winged_Gull/Glaucous_Winged_Gull_0045_44906.jpg,500,335,060.Glaucous_winged_Gull,76,18,435,319,255,168,359,301
../../CUB_200_2011/images\060.Glaucous_winged_Gull/Glaucous_Winged_Gull_0132_44435.jpg,500,406,060.Glaucous_winged_Gull,7,47,473,389,240,218,466,342
../../CUB_200_2011/images\060.Glaucous_winged_Gull/Glaucous_Winged_Gull_0075_44455.jpg,500,375,060.Glaucous_winged_Gull,121,52,391,354,256,203,270,302
../../CUB_200_2011/images\060.Glaucous_winged_Gull/Glaucous_Winged_Gull_0096_45012.jpg,500,375,060.Glaucous_winged_Gull,60,51,366,312,213,181,306,261
../../CUB_200_2011/images\060.Glaucous_winged_Gull/Glaucous_Winged_Gull_0082_44528.jpg,375,500,060.Glaucous_winged_Gull,106,188,365,399,235,293,259,211
../../CUB_200_2011/images\060.Glaucous_winged_Gull/Glaucous_Winged_Gull_0051_44543.jpg,500,373,060.Glaucous_winged_Gull,59,39,376,373,217,206,317,334
../../CUB_200_2011/images\061.Heermann_Gull/Heermann_Gull_0093_45576.jpg,500,435,061.Heermann_Gull,90,54,443,340,266,197,353,286
../../CUB_200_2011/images\061.Heermann_Gull/Heermann_Gull_0076_45597.jpg,500,332,061.Heermann_Gull,136,66,449,272,292,169,313,206
../../CUB_200_2011/images\061.Heermann_Gull/Heermann_Gull_0018_45608.jpg,500,375,061.Heermann_Gull,192,111,384,290,288,200,192,179
../../CUB_200_2011/images\061.Heermann_Gull/Heermann_Gull_0109_45619.jpg,500,333,061.Heermann_Gull,154,69,378,275,266,172,224,206
../../CUB_200_2011/images\061.Heermann_Gull/Heermann_Gull_0051_45622.jpg,500,379,061.Heermann_Gull,65,44,501,378,283,211,436,334
../../CUB_200_2011/images\061.Heermann_Gull/Heermann_Gull_0118_45626.jpg,500,375,061.Heermann_Gull,151,69,422,271,286,170,271,202
../../CUB_200_2011/images\061.Heermann_Gull/Heermann_Gull_0122_45627.jpg,435,330,061.Heermann_Gull,27,32,350,315,188,173,323,283
../../CUB_200_2011/images\061.Heermann_Gull/Heermann_Gull_0059_45642.jpg,500,403,061.Heermann_Gull,49,89,376,391,212,240,327,302
../../CUB_200_2011/images\061.Heermann_Gull/Heermann_Gull_0111_45652.jpg,500,375,061.Heermann_Gull,136,100,450,336,293,218,314,236
../../CUB_200_2011/images\061.Heermann_Gull/Heermann_Gull_0087_45658.jpg,500,375,061.Heermann_Gull,128,63,454,314,291,188,326,251
../../CUB_200_2011/images\061.Heermann_Gull/Heermann_Gull_0128_45663.jpg,500,359,061.Heermann_Gull,11,21,352,353,181,187,341,332
../../CUB_200_2011/images\061.Heermann_Gull/Heermann_Gull_0089_45679.jpg,500,334,061.Heermann_Gull,124,39,431,281,277,160,307,242
../../CUB_200_2011/images\061.Heermann_Gull/Heermann_Gull_0023_45686.jpg,375,500,061.Heermann_Gull,166,138,374,355,270,246,208,217
../../CUB_200_2011/images\061.Heermann_Gull/Heermann_Gull_0034_45693.jpg,500,333,061.Heermann_Gull,28,83,460,238,244,160,432,155
../../CUB_200_2011/images\061.Heermann_Gull/Heermann_Gull_0130_45700.jpg,420,280,061.Heermann_Gull,126,21,401,243,263,132,275,222
../../CUB_200_2011/images\061.Heermann_Gull/Heermann_Gull_0044_45705.jpg,500,386,061.Heermann_Gull,67,110,330,350,198,230,263,240
../../CUB_200_2011/images\061.Heermann_Gull/Heermann_Gull_0077_45711.jpg,500,333,061.Heermann_Gull,112,44,458,252,285,148,346,208
../../CUB_200_2011/images\061.Heermann_Gull/Heermann_Gull_0073_45714.jpg,500,375,061.Heermann_Gull,171,88,429,370,300,229,258,282
../../CUB_200_2011/images\061.Heermann_Gull/Heermann_Gull_0071_45735.jpg,500,334,061.Heermann_Gull,166,64,456,326,311,195,290,262
../../CUB_200_2011/images\061.Heermann_Gull/Heermann_Gull_0112_45748.jpg,500,333,061.Heermann_Gull,158,20,415,309,286,164,257,289
../../CUB_200_2011/images\061.Heermann_Gull/Heermann_Gull_0139_45749.jpg,500,456,061.Heermann_Gull,69,68,384,396,226,232,315,328
../../CUB_200_2011/images\061.Heermann_Gull/Heermann_Gull_0056_45751.jpg,500,357,061.Heermann_Gull,13,31,393,329,203,180,380,298
../../CUB_200_2011/images\061.Heermann_Gull/Heermann_Gull_0098_45753.jpg,500,335,061.Heermann_Gull,180,34,403,297,291,165,223,263
../../CUB_200_2011/images\061.Heermann_Gull/Heermann_Gull_0035_45754.jpg,500,375,061.Heermann_Gull,6,15,422,318,214,166,416,303
../../CUB_200_2011/images\061.Heermann_Gull/Heermann_Gull_0013_45771.jpg,500,333,061.Heermann_Gull,207,67,465,249,336,158,258,182
../../CUB_200_2011/images\061.Heermann_Gull/Heermann_Gull_0032_45774.jpg,500,333,061.Heermann_Gull,41,37,341,306,191,171,300,269
../../CUB_200_2011/images\061.Heermann_Gull/Heermann_Gull_0138_45269.jpg,500,355,061.Heermann_Gull,101,37,452,311,276,174,351,274
../../CUB_200_2011/images\061.Heermann_Gull/Heermann_Gull_0097_45783.jpg,500,333,061.Heermann_Gull,51,65,424,315,237,190,373,250
../../CUB_200_2011/images\061.Heermann_Gull/Heermann_Gull_0033_45792.jpg,500,332,061.Heermann_Gull,41,44,337,297,189,170,296,253
../../CUB_200_2011/images\061.Heermann_Gull/Heermann_Gull_0135_45283.jpg,500,333,061.Heermann_Gull,141,93,416,316,278,204,275,223
../../CUB_200_2011/images\061.Heermann_Gull/Heermann_Gull_0115_45797.jpg,500,375,061.Heermann_Gull,220,104,377,239,298,171,157,135
../../CUB_200_2011/images\061.Heermann_Gull/Heermann_Gull_0142_45798.jpg,500,333,061.Heermann_Gull,106,54,457,303,281,178,351,249
../../CUB_200_2011/images\061.Heermann_Gull/Heermann_Gull_0075_45295.jpg,500,333,061.Heermann_Gull,121,33,464,271,292,152,343,238
../../CUB_200_2011/images\061.Heermann_Gull/Heermann_Gull_0086_45304.jpg,500,365,061.Heermann_Gull,90,80,499,350,294,215,409,270
../../CUB_200_2011/images\061.Heermann_Gull/Heermann_Gull_0031_45822.jpg,500,334,061.Heermann_Gull,219,68,400,277,309,172,181,209
../../CUB_200_2011/images\061.Heermann_Gull/Heermann_Gull_0090_45834.jpg,500,334,061.Heermann_Gull,222,56,399,280,310,168,177,224
../../CUB_200_2011/images\061.Heermann_Gull/Heermann_Gull_0008_45839.jpg,500,333,061.Heermann_Gull,60,90,386,323,223,206,326,233
../../CUB_200_2011/images\061.Heermann_Gull/Heermann_Gull_0053_45854.jpg,500,333,061.Heermann_Gull,43,55,285,277,164,166,242,222
../../CUB_200_2011/images\061.Heermann_Gull/Heermann_Gull_0074_45351.jpg,500,375,061.Heermann_Gull,50,109,360,295,205,202,310,186
../../CUB_200_2011/images\061.Heermann_Gull/Heermann_Gull_0027_45864.jpg,500,333,061.Heermann_Gull,49,56,431,297,240,176,382,241
../../CUB_200_2011/images\061.Heermann_Gull/Heermann_Gull_0091_45363.jpg,500,375,061.Heermann_Gull,72,46,298,320,185,183,226,274
../../CUB_200_2011/images\061.Heermann_Gull/Heermann_Gull_0083_45879.jpg,500,333,061.Heermann_Gull,34,71,340,318,187,194,306,247
../../CUB_200_2011/images\061.Heermann_Gull/Heermann_Gull_0121_45375.jpg,500,333,061.Heermann_Gull,4,47,392,283,198,165,388,236
../../CUB_200_2011/images\061.Heermann_Gull/Heermann_Gull_0046_45888.jpg,400,500,061.Heermann_Gull,95,102,341,386,218,244,246,284
../../CUB_200_2011/images\061.Heermann_Gull/Heermann_Gull_0055_45901.jpg,333,500,061.Heermann_Gull,94,62,298,436,196,249,204,374
../../CUB_200_2011/images\061.Heermann_Gull/Heermann_Gull_0141_45391.jpg,500,333,061.Heermann_Gull,109,30,489,314,299,172,380,284
../../CUB_200_2011/images\061.Heermann_Gull/Heermann_Gull_0102_45904.jpg,375,500,061.Heermann_Gull,0,1,371,492,185,246,371,491
../../CUB_200_2011/images\061.Heermann_Gull/Heermann_Gull_0009_45905.jpg,500,416,061.Heermann_Gull,231,60,448,278,339,169,217,218
../../CUB_200_2011/images\061.Heermann_Gull/Heermann_Gull_0020_45409.jpg,500,353,061.Heermann_Gull,138,18,476,339,307,178,338,321
../../CUB_200_2011/images\061.Heermann_Gull/Heermann_Gull_0133_45415.jpg,500,456,061.Heermann_Gull,9,106,473,391,241,248,464,285
../../CUB_200_2011/images\061.Heermann_Gull/Heermann_Gull_0136_45416.jpg,500,375,061.Heermann_Gull,45,24,466,339,255,181,421,315
../../CUB_200_2011/images\061.Heermann_Gull/Heermann_Gull_0004_45936.jpg,500,333,061.Heermann_Gull,245,34,481,301,363,167,236,267
../../CUB_200_2011/images\061.Heermann_Gull/Heermann_Gull_0043_45939.jpg,500,333,061.Heermann_Gull,7,25,377,321,192,173,370,296
../../CUB_200_2011/images\061.Heermann_Gull/Heermann_Gull_0100_45440.jpg,500,333,061.Heermann_Gull,197,49,468,267,332,158,271,218
../../CUB_200_2011/images\061.Heermann_Gull/Heermann_Gull_0110_45968.jpg,500,375,061.Heermann_Gull,62,15,491,372,276,193,429,357
../../CUB_200_2011/images\061.Heermann_Gull/Heermann_Gull_0079_45468.jpg,500,333,061.Heermann_Gull,101,100,301,291,201,195,200,191
../../CUB_200_2011/images\061.Heermann_Gull/Heermann_Gull_0001_45472.jpg,500,333,061.Heermann_Gull,179,86,390,266,284,176,211,180
../../CUB_200_2011/images\061.Heermann_Gull/Heermann_Gull_0024_45486.jpg,500,333,061.Heermann_Gull,161,43,399,253,280,148,238,210
../../CUB_200_2011/images\061.Heermann_Gull/Heermann_Gull_0015_41392.jpg,500,375,061.Heermann_Gull,16,57,402,374,209,215,386,317
../../CUB_200_2011/images\061.Heermann_Gull/Heermann_Gull_0131_45548.jpg,500,389,061.Heermann_Gull,54,46,385,287,219,166,331,241
../../CUB_200_2011/images\062.Herring_Gull/Herring_Gull_0049_46508.jpg,500,393,062.Herring_Gull,172,95,445,314,308,204,273,219
../../CUB_200_2011/images\062.Herring_Gull/Herring_Gull_0037_48655.jpg,490,500,062.Herring_Gull,67,39,440,406,253,222,373,367
../../CUB_200_2011/images\062.Herring_Gull/Herring_Gull_0115_47123.jpg,500,333,062.Herring_Gull,24,31,356,316,190,173,332,285
../../CUB_200_2011/images\062.Herring_Gull/Herring_Gull_0070_46615.jpg,500,375,062.Herring_Gull,157,52,397,288,277,170,240,236
../../CUB_200_2011/images\062.Herring_Gull/Herring_Gull_0105_46113.jpg,500,333,062.Herring_Gull,13,78,261,296,137,187,248,218
../../CUB_200_2011/images\062.Herring_Gull/Herring_Gull_0083_48674.jpg,500,334,062.Herring_Gull,124,91,280,264,202,177,156,173
../../CUB_200_2011/images\062.Herring_Gull/Herring_Gull_0042_46637.jpg,500,333,062.Herring_Gull,93,24,472,333,282,178,379,309
../../CUB_200_2011/images\062.Herring_Gull/Herring_Gull_0012_46654.jpg,500,375,062.Herring_Gull,7,48,371,344,189,196,364,296
../../CUB_200_2011/images\062.Herring_Gull/Herring_Gull_0094_47172.jpg,500,336,062.Herring_Gull,20,112,498,291,259,201,478,179
../../CUB_200_2011/images\062.Herring_Gull/Herring_Gull_0001_48205.jpg,500,286,062.Herring_Gull,176,27,432,238,304,132,256,211
../../CUB_200_2011/images\062.Herring_Gull/Herring_Gull_0078_48718.jpg,500,500,062.Herring_Gull,22,46,499,435,260,240,477,389
../../CUB_200_2011/images\062.Herring_Gull/Herring_Gull_0141_47184.jpg,500,394,062.Herring_Gull,14,35,421,386,217,210,407,351
../../CUB_200_2011/images\062.Herring_Gull/Herring_Gull_0130_46675.jpg,500,375,062.Herring_Gull,246,82,455,342,350,212,209,260
../../CUB_200_2011/images\062.Herring_Gull/Herring_Gull_0054_46164.jpg,500,333,062.Herring_Gull,30,40,423,280,226,160,393,240
../../CUB_200_2011/images\062.Herring_Gull/Herring_Gull_0100_46677.jpg,500,368,062.Herring_Gull,83,64,433,293,258,178,350,229
../../CUB_200_2011/images\062.Herring_Gull/Herring_Gull_0071_48751.jpg,375,500,062.Herring_Gull,90,180,343,392,216,286,253,212
../../CUB_200_2011/images\062.Herring_Gull/Herring_Gull_0129_46708.jpg,500,438,062.Herring_Gull,15,22,472,370,243,196,457,348
../../CUB_200_2011/images\062.Herring_Gull/Herring_Gull_0116_47222.jpg,500,400,062.Herring_Gull,175,25,490,297,332,161,315,272
../../CUB_200_2011/images\062.Herring_Gull/Herring_Gull_0047_46218.jpg,500,375,062.Herring_Gull,39,67,420,271,229,169,381,204
../../CUB_200_2011/images\062.Herring_Gull/Herring_Gull_0145_46220.jpg,500,375,062.Herring_Gull,70,93,368,374,219,233,298,281
../../CUB_200_2011/images\062.Herring_Gull/Herring_Gull_0024_48309.jpg,500,333,062.Herring_Gull,157,81,413,331,285,206,256,250
../../CUB_200_2011/images\062.Herring_Gull/Herring_Gull_0120_48822.jpg,500,333,062.Herring_Gull,0,2,498,332,249,167,498,330
../../CUB_200_2011/images\062.Herring_Gull/Herring_Gull_0034_48824.jpg,500,375,062.Herring_Gull,163,129,469,343,316,236,306,214
../../CUB_200_2011/images\062.Herring_Gull/Herring_Gull_0056_46783.jpg,500,333,062.Herring_Gull,66,92,365,298,215,195,299,206
../../CUB_200_2011/images\062.Herring_Gull/Herring_Gull_0051_46276.jpg,500,345,062.Herring_Gull,61,60,378,271,219,165,317,211
../../CUB_200_2011/images\062.Herring_Gull/Herring_Gull_0014_47814.jpg,500,333,062.Herring_Gull,26,101,321,263,173,182,295,162
../../CUB_200_2011/images\062.Herring_Gull/Herring_Gull_0080_46806.jpg,500,375,062.Herring_Gull,153,86,328,294,240,190,175,208
../../CUB_200_2011/images\062.Herring_Gull/Herring_Gull_0064_47832.jpg,500,333,062.Herring_Gull,141,62,420,240,280,151,279,178
../../CUB_200_2011/images\062.Herring_Gull/Herring_Gull_0052_46810.jpg,500,376,062.Herring_Gull,131,64,432,287,281,175,301,223
../../CUB_200_2011/images\062.Herring_Gull/Herring_Gull_0087_47841.jpg,500,348,062.Herring_Gull,50,47,380,313,215,180,330,266
../../CUB_200_2011/images\062.Herring_Gull/Herring_Gull_0098_46971.jpg,340,227,062.Herring_Gull,76,22,299,165,187,93,223,143
../../CUB_200_2011/images\062.Herring_Gull/Herring_Gull_0143_46461.jpg,455,500,062.Herring_Gull,13,66,345,438,179,252,332,372
../../CUB_200_2011/images\062.Herring_Gull/Herring_Gull_0045_46845.jpg,500,333,062.Herring_Gull,158,16,361,260,259,138,203,244
../../CUB_200_2011/images\062.Herring_Gull/Herring_Gull_0015_46353.jpg,500,376,062.Herring_Gull,4,95,499,263,251,179,495,168
../../CUB_200_2011/images\062.Herring_Gull/Herring_Gull_0058_47383.jpg,500,355,062.Herring_Gull,34,82,365,258,199,170,331,176
../../CUB_200_2011/images\062.Herring_Gull/Herring_Gull_0132_47395.jpg,500,333,062.Herring_Gull,115,106,368,255,241,180,253,149
../../CUB_200_2011/images\062.Herring_Gull/Herring_Gull_0075_48935.jpg,500,357,062.Herring_Gull,54,41,476,208,265,124,422,167
../../CUB_200_2011/images\062.Herring_Gull/Herring_Gull_0027_46389.jpg,500,380,062.Herring_Gull,80,55,315,286,197,170,235,231
../../CUB_200_2011/images\062.Herring_Gull/Herring_Gull_0068_46392.jpg,500,331,062.Herring_Gull,105,32,464,306,284,169,359,274
../../CUB_200_2011/images\062.Herring_Gull/Herring_Gull_0084_46406.jpg,453,500,062.Herring_Gull,109,26,376,447,242,236,267,421
../../CUB_200_2011/images\062.Herring_Gull/Herring_Gull_0106_46930.jpg,425,283,062.Herring_Gull,154,52,368,240,261,146,214,188
../../CUB_200_2011/images\062.Herring_Gull/Herring_Gull_0039_46420.jpg,457,500,062.Herring_Gull,24,59,401,438,212,248,377,379
../../CUB_200_2011/images\062.Herring_Gull/Herring_Gull_0010_46425.jpg,500,333,062.Herring_Gull,145,42,432,294,288,168,287,252
../../CUB_200_2011/images\062.Herring_Gull/Herring_Gull_0114_46956.jpg,500,375,062.Herring_Gull,188,95,396,285,292,190,208,190
../../CUB_200_2011/images\062.Herring_Gull/Herring_Gull_0140_46455.jpg,374,500,062.Herring_Gull,81,89,312,265,196,177,231,176
../../CUB_200_2011/images\062.Herring_Gull/Herring_Gull_0055_47994.jpg,500,314,062.Herring_Gull,44,14,487,287,265,150,443,273
../../CUB_200_2011/images\062.Herring_Gull/Herring_Gull_0076_47497.jpg,500,333,062.Herring_Gull,18,18,361,322,189,170,343,304
../../CUB_200_2011/images\062.Herring_Gull/Herring_Gull_0138_48023.jpg,500,375,062.Herring_Gull,43,20,437,365,240,192,394,345
../../CUB_200_2011/images\062.Herring_Gull/Herring_Gull_0139_47006.jpg,500,375,062.Herring_Gull,124,89,403,354,263,221,279,265
../../CUB_200_2011/images\062.Herring_Gull/Herring_Gull_0061_46501.jpg,500,333,062.Herring_Gull,129,21,307,262,218,141,178,241
../../CUB_200_2011/images\062.Herring_Gull/Herring_Gull_0026_48041.jpg,500,375,062.Herring_Gull,179,145,437,278,308,211,258,133
../../CUB_200_2011/images\062.Herring_Gull/Herring_Gull_0103_45996.jpg,500,332,062.Herring_Gull,16,73,359,304,187,188,343,231
../../CUB_200_2011/images\062.Herring_Gull/Herring_Gull_0004_48046.jpg,375,500,062.Herring_Gull,134,60,298,436,216,248,164,376
../../CUB_200_2011/images\062.Herring_Gull/Herring_Gull_0082_47540.jpg,500,375,062.Herring_Gull,156,72,389,256,272,164,233,184
../../CUB_200_2011/images\062.Herring_Gull/Herring_Gull_0016_48969.jpg,500,357,062.Herring_Gull,162,6,450,249,306,127,288,243
../../CUB_200_2011/images\062.Herring_Gull/Herring_Gull_0095_48058.jpg,500,375,062.Herring_Gull,202,50,372,229,287,139,170,179
../../CUB_200_2011/images\062.Herring_Gull/Herring_Gull_0093_46029.jpg,500,390,062.Herring_Gull,73,28,469,335,271,181,396,307
../../CUB_200_2011/images\062.Herring_Gull/Herring_Gull_0102_48078.jpg,500,332,062.Herring_Gull,132,93,417,292,274,192,285,199
../../CUB_200_2011/images\062.Herring_Gull/Herring_Gull_0065_48098.jpg,500,362,062.Herring_Gull,230,125,423,288,326,206,193,163
../../CUB_200_2011/images\062.Herring_Gull/Herring_Gull_0048_46061.jpg,500,376,062.Herring_Gull,65,93,400,332,232,212,335,239
../../CUB_200_2011/images\063.Ivory_Gull/Ivory_Gull_0110_49408.jpg,500,390,063.Ivory_Gull,159,36,421,360,290,198,262,324
../../CUB_200_2011/images\063.Ivory_Gull/Ivory_Gull_0104_49666.jpg,500,357,063.Ivory_Gull,130,121,298,225,214,173,168,104
../../CUB_200_2011/images\063.Ivory_Gull/Ivory_Gull_0039_49412.jpg,500,375,063.Ivory_Gull,92,26,478,330,285,178,386,304
../../CUB_200_2011/images\063.Ivory_Gull/Ivory_Gull_0052_50013.jpg,500,375,063.Ivory_Gull,78,97,460,350,269,223,382,253
../../CUB_200_2011/images\063.Ivory_Gull/Ivory_Gull_0061_49416.jpg,500,342,063.Ivory_Gull,91,25,447,313,269,169,356,288
../../CUB_200_2011/images\063.Ivory_Gull/Ivory_Gull_0037_49068.jpg,500,333,063.Ivory_Gull,207,39,472,279,339,159,265,240
../../CUB_200_2011/images\063.Ivory_Gull/Ivory_Gull_0010_49169.jpg,500,357,063.Ivory_Gull,110,30,400,289,255,159,290,259
../../CUB_200_2011/images\063.Ivory_Gull/Ivory_Gull_0041_49172.jpg,500,373,063.Ivory_Gull,48,105,447,286,247,195,399,181
../../CUB_200_2011/images\063.Ivory_Gull/Ivory_Gull_0088_49177.jpg,500,334,063.Ivory_Gull,61,142,249,264,155,203,188,122
../../CUB_200_2011/images\063.Ivory_Gull/Ivory_Gull_0079_49179.jpg,500,378,063.Ivory_Gull,55,90,391,293,223,191,336,203
../../CUB_200_2011/images\063.Ivory_Gull/Ivory_Gull_0040_49180.jpg,500,326,063.Ivory_Gull,193,70,494,247,343,158,301,177
../../CUB_200_2011/images\063.Ivory_Gull/Ivory_Gull_0045_49696.jpg,500,375,063.Ivory_Gull,223,121,385,225,304,173,162,104
../../CUB_200_2011/images\063.Ivory_Gull/Ivory_Gull_0085_49456.jpg,500,398,063.Ivory_Gull,40,27,454,349,247,188,414,322
../../CUB_200_2011/images\063.Ivory_Gull/Ivory_Gull_0107_49186.jpg,500,375,063.Ivory_Gull,122,113,297,249,209,181,175,136
../../CUB_200_2011/images\063.Ivory_Gull/Ivory_Gull_0089_49699.jpg,360,288,063.Ivory_Gull,98,102,287,214,192,158,189,112
../../CUB_200_2011/images\063.Ivory_Gull/Ivory_Gull_0118_49191.jpg,500,357,063.Ivory_Gull,76,3,271,312,173,157,195,309
../../CUB_200_2011/images\063.Ivory_Gull/Ivory_Gull_0024_49195.jpg,500,333,063.Ivory_Gull,101,29,480,299,290,164,379,270
../../CUB_200_2011/images\063.Ivory_Gull/Ivory_Gull_0086_49532.jpg,500,337,063.Ivory_Gull,123,37,396,288,259,162,273,251
../../CUB_200_2011/images\063.Ivory_Gull/Ivory_Gull_0015_49199.jpg,500,400,063.Ivory_Gull,53,98,325,319,189,208,272,221
../../CUB_200_2011/images\063.Ivory_Gull/Ivory_Gull_0087_49202.jpg,500,329,063.Ivory_Gull,116,84,350,258,233,171,234,174
../../CUB_200_2011/images\063.Ivory_Gull/Ivory_Gull_0062_49722.jpg,500,375,063.Ivory_Gull,105,51,361,303,233,177,256,252
../../CUB_200_2011/images\063.Ivory_Gull/Ivory_Gull_0098_49810.jpg,500,369,063.Ivory_Gull,109,79,234,203,171,141,125,124
../../CUB_200_2011/images\063.Ivory_Gull/Ivory_Gull_0099_49218.jpg,500,431,063.Ivory_Gull,18,27,460,386,239,206,442,359
../../CUB_200_2011/images\063.Ivory_Gull/Ivory_Gull_0117_49227.jpg,500,392,063.Ivory_Gull,36,82,306,257,171,169,270,175
../../CUB_200_2011/images\063.Ivory_Gull/Ivory_Gull_0092_49996.jpg,500,394,063.Ivory_Gull,52,51,396,352,224,201,344,301
../../CUB_200_2011/images\063.Ivory_Gull/Ivory_Gull_0080_49748.jpg,485,500,063.Ivory_Gull,123,153,316,463,219,308,193,310
../../CUB_200_2011/images\063.Ivory_Gull/Ivory_Gull_0014_48983.jpg,500,333,063.Ivory_Gull,23,86,352,303,187,194,329,217
../../CUB_200_2011/images\063.Ivory_Gull/Ivory_Gull_0036_49754.jpg,500,318,063.Ivory_Gull,268,94,374,289,321,191,106,195
../../CUB_200_2011/images\063.Ivory_Gull/Ivory_Gull_0043_49755.jpg,500,400,063.Ivory_Gull,19,127,367,376,193,251,348,249
../../CUB_200_2011/images\063.Ivory_Gull/Ivory_Gull_0050_49245.jpg,500,368,063.Ivory_Gull,129,101,468,341,298,221,339,240
../../CUB_200_2011/images\063.Ivory_Gull/Ivory_Gull_0035_49523.jpg,500,312,063.Ivory_Gull,167,60,412,241,289,150,245,181
../../CUB_200_2011/images\063.Ivory_Gull/Ivory_Gull_0004_49019.jpg,433,500,063.Ivory_Gull,71,11,430,494,250,252,359,483
../../CUB_200_2011/images\063.Ivory_Gull/Ivory_Gull_0002_49788.jpg,500,414,063.Ivory_Gull,132,93,418,352,275,222,286,259
../../CUB_200_2011/images\063.Ivory_Gull/Ivory_Gull_0005_49021.jpg,500,333,063.Ivory_Gull,173,48,411,214,292,131,238,166
../../CUB_200_2011/images\063.Ivory_Gull/Ivory_Gull_0101_49790.jpg,500,376,063.Ivory_Gull,189,124,334,225,261,174,145,101
../../CUB_200_2011/images\063.Ivory_Gull/Ivory_Gull_0114_49535.jpg,500,332,063.Ivory_Gull,107,0,267,137,187,68,160,137
../../CUB_200_2011/images\063.Ivory_Gull/Ivory_Gull_0073_49287.jpg,500,375,063.Ivory_Gull,110,70,412,271,261,170,302,201
../../CUB_200_2011/images\063.Ivory_Gull/Ivory_Gull_0038_49298.jpg,500,400,063.Ivory_Gull,30,105,370,326,200,215,340,221
../../CUB_200_2011/images\063.Ivory_Gull/Ivory_Gull_0105_49559.jpg,500,375,063.Ivory_Gull,173,33,498,333,335,183,325,300
../../CUB_200_2011/images\063.Ivory_Gull/Ivory_Gull_0018_49988.jpg,500,406,063.Ivory_Gull,5,98,387,380,196,239,382,282
../../CUB_200_2011/images\063.Ivory_Gull/Ivory_Gull_0082_49306.jpg,500,347,063.Ivory_Gull,71,196,475,323,273,259,404,127
../../CUB_200_2011/images\063.Ivory_Gull/Ivory_Gull_0077_49051.jpg,500,375,063.Ivory_Gull,56,11,438,329,247,170,382,318
../../CUB_200_2011/images\063.Ivory_Gull/Ivory_Gull_0093_49052.jpg,500,403,063.Ivory_Gull,65,101,384,370,224,235,319,269
../../CUB_200_2011/images\063.Ivory_Gull/Ivory_Gull_0065_49566.jpg,500,355,063.Ivory_Gull,100,12,437,271,268,141,337,259
../../CUB_200_2011/images\063.Ivory_Gull/Ivory_Gull_0032_49322.jpg,500,368,063.Ivory_Gull,88,37,443,260,265,148,355,223
../../CUB_200_2011/images\063.Ivory_Gull/Ivory_Gull_0094_49347.jpg,500,333,063.Ivory_Gull,180,76,391,255,285,165,211,179
../../CUB_200_2011/images\063.Ivory_Gull/Ivory_Gull_0055_49353.jpg,500,334,063.Ivory_Gull,98,107,499,260,298,183,401,153
../../CUB_200_2011/images\063.Ivory_Gull/Ivory_Gull_0108_49356.jpg,500,340,063.Ivory_Gull,74,47,338,272,206,159,264,225
../../CUB_200_2011/images\063.Ivory_Gull/Ivory_Gull_0074_49698.jpg,500,333,063.Ivory_Gull,187,33,401,272,294,152,214,239
../../CUB_200_2011/images\063.Ivory_Gull/Ivory_Gull_0007_49364.jpg,500,310,063.Ivory_Gull,176,66,471,250,323,158,295,184
../../CUB_200_2011/images\063.Ivory_Gull/Ivory_Gull_0027_48974.jpg,500,408,063.Ivory_Gull,104,1,383,305,243,153,279,304
../../CUB_200_2011/images\063.Ivory_Gull/Ivory_Gull_0059_49662.jpg,500,333,063.Ivory_Gull,203,155,356,262,279,208,153,107
../../CUB_200_2011/images\063.Ivory_Gull/Ivory_Gull_0026_49466.jpg,500,333,063.Ivory_Gull,140,98,330,222,235,160,190,124
../../CUB_200_2011/images\063.Ivory_Gull/Ivory_Gull_0096_49487.jpg,500,415,063.Ivory_Gull,68,51,363,319,215,185,295,268
../../CUB_200_2011/images\063.Ivory_Gull/Ivory_Gull_0109_49382.jpg,500,333,063.Ivory_Gull,68,42,443,252,255,147,375,210
../../CUB_200_2011/images\063.Ivory_Gull/Ivory_Gull_0023_49385.jpg,322,403,063.Ivory_Gull,14,76,305,327,159,201,291,251
../../CUB_200_2011/images\063.Ivory_Gull/Ivory_Gull_0020_49978.jpg,500,374,063.Ivory_Gull,32,77,371,355,201,216,339,278
../../CUB_200_2011/images\063.Ivory_Gull/Ivory_Gull_0071_49402.jpg,373,500,063.Ivory_Gull,14,88,293,391,153,239,279,303
../../CUB_200_2011/images\063.Ivory_Gull/Ivory_Gull_0067_49659.jpg,500,346,063.Ivory_Gull,135,45,491,288,313,166,356,243
../../CUB_200_2011/images\063.Ivory_Gull/Ivory_Gull_0064_49406.jpg,500,367,063.Ivory_Gull,158,138,307,253,232,195,149,115
../../CUB_200_2011/images\064.Ring_billed_Gull/Ring_Billed_Gull_0013_50180.jpg,500,345,064.Ring_billed_Gull,19,85,330,291,174,188,311,206
../../CUB_200_2011/images\064.Ring_billed_Gull/Ring_Billed_Gull_0079_51206.jpg,500,332,064.Ring_billed_Gull,66,28,396,252,231,140,330,224
../../CUB_200_2011/images\064.Ring_billed_Gull/Ring_Billed_Gull_0039_50191.jpg,500,333,064.Ring_billed_Gull,25,179,276,316,150,247,251,137
../../CUB_200_2011/images\064.Ring_billed_Gull/Ring_Billed_Gull_0020_50204.jpg,500,375,064.Ring_billed_Gull,143,73,438,369,290,221,295,296
../../CUB_200_2011/images\064.Ring_billed_Gull/Ring_Billed_Gull_0074_52258.jpg,500,333,064.Ring_billed_Gull,47,84,304,247,175,165,257,163
../../CUB_200_2011/images\064.Ring_billed_Gull/Ring_Billed_Gull_0114_50214.jpg,500,400,064.Ring_billed_Gull,170,34,337,342,253,188,167,308
../../CUB_200_2011/images\064.Ring_billed_Gull/Ring_Billed_Gull_0045_50215.jpg,500,500,064.Ring_billed_Gull,77,50,364,430,220,240,287,380
../../CUB_200_2011/images\064.Ring_billed_Gull/Ring_Billed_Gull_0100_52779.jpg,349,500,064.Ring_billed_Gull,45,45,341,459,193,252,296,414
../../CUB_200_2011/images\064.Ring_billed_Gull/Ring_Billed_Gull_0129_51246.jpg,500,375,064.Ring_billed_Gull,17,78,487,187,252,132,470,109
../../CUB_200_2011/images\064.Ring_billed_Gull/Ring_Billed_Gull_0063_51256.jpg,500,393,064.Ring_billed_Gull,167,72,427,318,297,195,260,246
../../CUB_200_2011/images\064.Ring_billed_Gull/Ring_Billed_Gull_0044_50239.jpg,500,333,064.Ring_billed_Gull,74,4,442,249,258,126,368,245
../../CUB_200_2011/images\064.Ring_billed_Gull/Ring_Billed_Gull_0027_51266.jpg,500,389,064.Ring_billed_Gull,29,12,424,341,226,176,395,329
../../CUB_200_2011/images\064.Ring_billed_Gull/Ring_Billed_Gull_0034_51270.jpg,500,332,064.Ring_billed_Gull,160,35,318,286,239,160,158,251
../../CUB_200_2011/images\064.Ring_billed_Gull/Ring_Billed_Gull_0038_51275.jpg,500,334,064.Ring_billed_Gull,185,122,346,225,265,173,161,103
../../CUB_200_2011/images\064.Ring_billed_Gull/Ring_Billed_Gull_0033_51288.jpg,500,375,064.Ring_billed_Gull,81,73,468,330,274,201,387,257
../../CUB_200_2011/images\064.Ring_billed_Gull/Ring_Billed_Gull_0085_51292.jpg,500,333,064.Ring_billed_Gull,123,9,498,317,310,163,375,308
../../CUB_200_2011/images\064.Ring_billed_Gull/Ring_Billed_Gull_0021_51300.jpg,333,500,064.Ring_billed_Gull,26,52,306,470,166,261,280,418
../../CUB_200_2011/images\064.Ring_billed_Gull/Ring_Billed_Gull_0009_51301.jpg,500,378,064.Ring_billed_Gull,123,74,432,339,277,206,309,265
../../CUB_200_2011/images\064.Ring_billed_Gull/Ring_Billed_Gull_0093_51303.jpg,500,346,064.Ring_billed_Gull,60,56,252,221,156,138,192,165
../../CUB_200_2011/images\064.Ring_billed_Gull/Ring_Billed_Gull_0107_51306.jpg,500,375,064.Ring_billed_Gull,135,102,478,346,306,224,343,244
../../CUB_200_2011/images\064.Ring_billed_Gull/Ring_Billed_Gull_0125_51307.jpg,500,333,064.Ring_billed_Gull,94,35,333,322,213,178,239,287
../../CUB_200_2011/images\064.Ring_billed_Gull/Ring_Billed_Gull_0057_51315.jpg,500,369,064.Ring_billed_Gull,47,64,244,252,145,158,197,188
../../CUB_200_2011/images\064.Ring_billed_Gull/Ring_Billed_Gull_0070_51316.jpg,500,323,064.Ring_billed_Gull,133,62,435,267,284,164,302,205
../../CUB_200_2011/images\064.Ring_billed_Gull/Ring_Billed_Gull_0118_51322.jpg,379,500,064.Ring_billed_Gull,55,182,262,396,158,289,207,214
../../CUB_200_2011/images\064.Ring_billed_Gull/Ring_Billed_Gull_0089_51348.jpg,375,500,064.Ring_billed_Gull,61,164,271,329,166,246,210,165
../../CUB_200_2011/images\064.Ring_billed_Gull/Ring_Billed_Gull_0052_51357.jpg,500,314,064.Ring_billed_Gull,34,58,371,295,202,176,337,237
../../CUB_200_2011/images\064.Ring_billed_Gull/Ring_Billed_Gull_0117_51363.jpg,500,281,064.Ring_billed_Gull,22,48,474,219,248,133,452,171
../../CUB_200_2011/images\064.Ring_billed_Gull/Ring_Billed_Gull_0131_51370.jpg,500,365,064.Ring_billed_Gull,116,80,416,284,266,182,300,204
../../CUB_200_2011/images\064.Ring_billed_Gull/Ring_Billed_Gull_0101_51375.jpg,500,309,064.Ring_billed_Gull,104,32,451,284,277,158,347,252
../../CUB_200_2011/images\064.Ring_billed_Gull/Ring_Billed_Gull_0115_51891.jpg,500,413,064.Ring_billed_Gull,169,53,479,369,324,211,310,316
../../CUB_200_2011/images\064.Ring_billed_Gull/Ring_Billed_Gull_0095_50362.jpg,500,375,064.Ring_billed_Gull,12,58,406,340,209,199,394,282
../../CUB_200_2011/images\064.Ring_billed_Gull/Ring_Billed_Gull_0128_51403.jpg,500,333,064.Ring_billed_Gull,9,13,466,331,237,172,457,318
../../CUB_200_2011/images\064.Ring_billed_Gull/Ring_Billed_Gull_0083_51407.jpg,500,420,064.Ring_billed_Gull,143,100,444,292,293,196,301,192
../../CUB_200_2011/images\064.Ring_billed_Gull/Ring_Billed_Gull_0098_51410.jpg,500,333,064.Ring_billed_Gull,96,55,398,259,247,157,302,204
../../CUB_200_2011/images\064.Ring_billed_Gull/Ring_Billed_Gull_0017_51412.jpg,333,500,064.Ring_billed_Gull,66,43,290,445,178,244,224,402
../../CUB_200_2011/images\064.Ring_billed_Gull/Ring_Billed_Gull_0054_51414.jpg,500,375,064.Ring_billed_Gull,28,47,497,368,262,207,469,321
../../CUB_200_2011/images\064.Ring_billed_Gull/Ring_Billed_Gull_0001_51416.jpg,500,375,064.Ring_billed_Gull,98,30,459,349,278,189,361,319
../../CUB_200_2011/images\064.Ring_billed_Gull/Ring_Billed_Gull_0007_51430.jpg,500,398,064.Ring_billed_Gull,88,54,317,346,202,200,229,292
../../CUB_200_2011/images\064.Ring_billed_Gull/Ring_Billed_Gull_0051_51440.jpg,500,333,064.Ring_billed_Gull,32,19,421,305,226,162,389,286
../../CUB_200_2011/images\064.Ring_billed_Gull/Ring_Billed_Gull_0028_51454.jpg,500,400,064.Ring_billed_Gull,107,22,439,343,273,182,332,321
../../CUB_200_2011/images\064.Ring_billed_Gull/Ring_Billed_Gull_0036_51461.jpg,350,500,064.Ring_billed_Gull,67,45,281,392,174,218,214,347
../../CUB_200_2011/images\064.Ring_billed_Gull/Ring_Billed_Gull_0016_50392.jpg,429,500,064.Ring_billed_Gull,41,170,314,423,177,296,273,253
../../CUB_200_2011/images\064.Ring_billed_Gull/Ring_Billed_Gull_0003_51480.jpg,500,416,064.Ring_billed_Gull,114,71,496,375,305,223,382,304
../../CUB_200_2011/images\064.Ring_billed_Gull/Ring_Billed_Gull_0127_51485.jpg,500,334,064.Ring_billed_Gull,9,12,459,325,234,168,450,313
../../CUB_200_2011/images\064.Ring_billed_Gull/Ring_Billed_Gull_0078_51494.jpg,500,332,064.Ring_billed_Gull,11,63,389,312,200,187,378,249
../../CUB_200_2011/images\064.Ring_billed_Gull/Ring_Billed_Gull_0018_51505.jpg,500,375,064.Ring_billed_Gull,1,48,425,313,213,180,424,265
../../CUB_200_2011/images\064.Ring_billed_Gull/Ring_Billed_Gull_0105_51513.jpg,500,357,064.Ring_billed_Gull,201,44,406,218,303,131,205,174
../../CUB_200_2011/images\064.Ring_billed_Gull/Ring_Billed_Gull_0071_52845.jpg,500,375,064.Ring_billed_Gull,105,84,463,318,284,201,358,234
../../CUB_200_2011/images\064.Ring_billed_Gull/Ring_Billed_Gull_0092_51521.jpg,500,357,064.Ring_billed_Gull,125,78,409,276,267,177,284,198
../../CUB_200_2011/images\064.Ring_billed_Gull/Ring_Billed_Gull_0056_51523.jpg,500,375,064.Ring_billed_Gull,74,69,471,335,272,202,397,266
../../CUB_200_2011/images\064.Ring_billed_Gull/Ring_Billed_Gull_0113_51525.jpg,500,322,064.Ring_billed_Gull,95,72,348,301,221,186,253,229
../../CUB_200_2011/images\064.Ring_billed_Gull/Ring_Billed_Gull_0119_51551.jpg,500,336,064.Ring_billed_Gull,69,154,275,272,172,213,206,118
../../CUB_200_2011/images\064.Ring_billed_Gull/Ring_Billed_Gull_0132_51552.jpg,500,405,064.Ring_billed_Gull,14,98,357,345,185,221,343,247
../../CUB_200_2011/images\064.Ring_billed_Gull/Ring_Billed_Gull_0059_51554.jpg,500,480,064.Ring_billed_Gull,175,123,312,350,243,236,137,227
../../CUB_200_2011/images\064.Ring_billed_Gull/Ring_Billed_Gull_0050_51567.jpg,500,333,064.Ring_billed_Gull,76,83,351,219,213,151,275,136
../../CUB_200_2011/images\064.Ring_billed_Gull/Ring_Billed_Gull_0029_52613.jpg,500,334,064.Ring_billed_Gull,143,35,426,298,284,166,283,263
../../CUB_200_2011/images\064.Ring_billed_Gull/Ring_Billed_Gull_0104_52614.jpg,500,375,064.Ring_billed_Gull,35,55,378,347,206,201,343,292
../../CUB_200_2011/images\064.Ring_billed_Gull/Ring_Billed_Gull_0108_51108.jpg,500,446,064.Ring_billed_Gull,32,65,380,421,206,243,348,356
../../CUB_200_2011/images\064.Ring_billed_Gull/Ring_Billed_Gull_0055_51156.jpg,402,500,064.Ring_billed_Gull,7,125,350,390,178,257,343,265
../../CUB_200_2011/images\064.Ring_billed_Gull/Ring_Billed_Gull_0106_52729.jpg,500,375,064.Ring_billed_Gull,95,34,356,339,225,186,261,305
../../CUB_200_2011/images\065.Slaty_backed_Gull/Slaty_Backed_Gull_0017_796034.jpg,500,332,065.Slaty_backed_Gull,129,44,500,333,314,188,371,289
../../CUB_200_2011/images\065.Slaty_backed_Gull/Slaty_Backed_Gull_0081_53264.jpg,500,334,065.Slaty_backed_Gull,101,83,341,215,221,149,240,132
../../CUB_200_2011/images\065.Slaty_backed_Gull/Slaty_Backed_Gull_0061_53309.jpg,500,333,065.Slaty_backed_Gull,10,13,402,326,206,169,392,313
../../CUB_200_2011/images\065.Slaty_backed_Gull/Slaty_Backed_Gull_0072_53314.jpg,500,334,065.Slaty_backed_Gull,4,1,334,289,169,145,330,288
../../CUB_200_2011/images\065.Slaty_backed_Gull/Slaty_Backed_Gull_0049_53318.jpg,479,309,065.Slaty_backed_Gull,109,68,453,213,281,140,344,145
../../CUB_200_2011/images\065.Slaty_backed_Gull/Slaty_Backed_Gull_0007_53334.jpg,500,375,065.Slaty_backed_Gull,35,76,395,310,215,193,360,234
../../CUB_200_2011/images\065.Slaty_backed_Gull/Slaty_Backed_Gull_0027_53080.jpg,500,378,065.Slaty_backed_Gull,9,47,450,379,229,213,441,332
../../CUB_200_2011/images\065.Slaty_backed_Gull/Slaty_Backed_Gull_0030_796003.jpg,500,366,065.Slaty_backed_Gull,122,15,326,306,224,160,204,291
../../CUB_200_2011/images\065.Slaty_backed_Gull/Slaty_Backed_Gull_0015_796004.jpg,500,253,065.Slaty_backed_Gull,67,77,382,177,224,127,315,100
../../CUB_200_2011/images\065.Slaty_backed_Gull/Slaty_Backed_Gull_0076_796005.jpg,500,424,065.Slaty_backed_Gull,74,153,397,414,235,283,323,261
../../CUB_200_2011/images\065.Slaty_backed_Gull/Slaty_Backed_Gull_0021_796008.jpg,500,378,065.Slaty_backed_Gull,97,46,462,358,279,202,365,312
../../CUB_200_2011/images\065.Slaty_backed_Gull/Slaty_Backed_Gull_0043_796009.jpg,500,365,065.Slaty_backed_Gull,96,41,489,347,292,194,393,306
../../CUB_200_2011/images\065.Slaty_backed_Gull/Slaty_Backed_Gull_0020_796012.jpg,500,375,065.Slaty_backed_Gull,43,77,361,347,202,212,318,270
../../CUB_200_2011/images\065.Slaty_backed_Gull/Slaty_Backed_Gull_0056_796013.jpg,500,357,065.Slaty_backed_Gull,0,55,418,354,209,204,418,299
../../CUB_200_2011/images\065.Slaty_backed_Gull/Slaty_Backed_Gull_0006_796014.jpg,144,144,065.Slaty_backed_Gull,1,10,133,136,67,73,132,126
../../CUB_200_2011/images\065.Slaty_backed_Gull/Slaty_Backed_Gull_0066_796016.jpg,272,182,065.Slaty_backed_Gull,22,8,241,168,131,88,219,160
../../CUB_200_2011/images\065.Slaty_backed_Gull/Slaty_Backed_Gull_0077_796017.jpg,400,338,065.Slaty_backed_Gull,52,14,358,311,205,162,306,297
../../CUB_200_2011/images\065.Slaty_backed_Gull/Slaty_Backed_Gull_0079_796020.jpg,500,386,065.Slaty_backed_Gull,208,84,428,292,318,188,220,208
../../CUB_200_2011/images\065.Slaty_backed_Gull/Slaty_Backed_Gull_0022_796022.jpg,200,171,065.Slaty_backed_Gull,15,18,164,147,89,82,149,129
../../CUB_200_2011/images\065.Slaty_backed_Gull/Slaty_Backed_Gull_0033_796023.jpg,272,259,065.Slaty_backed_Gull,11,10,263,250,137,130,252,240
../../CUB_200_2011/images\065.Slaty_backed_Gull/Slaty_Backed_Gull_0058_796024.jpg,450,331,065.Slaty_backed_Gull,9,18,424,313,216,165,415,295
../../CUB_200_2011/images\065.Slaty_backed_Gull/Slaty_Backed_Gull_0045_796025.jpg,500,332,065.Slaty_backed_Gull,21,47,406,293,213,170,385,246
../../CUB_200_2011/images\065.Slaty_backed_Gull/Slaty_Backed_Gull_0035_796026.jpg,500,334,065.Slaty_backed_Gull,58,32,472,279,265,155,414,247
../../CUB_200_2011/images\065.Slaty_backed_Gull/Slaty_Backed_Gull_0075_796027.jpg,400,358,065.Slaty_backed_Gull,108,62,296,312,202,187,188,250
../../CUB_200_2011/images\065.Slaty_backed_Gull/Slaty_Backed_Gull_0024_796028.jpg,500,284,065.Slaty_backed_Gull,35,28,345,254,190,141,310,226
../../CUB_200_2011/images\065.Slaty_backed_Gull/Slaty_Backed_Gull_0031_796029.jpg,500,350,065.Slaty_backed_Gull,115,57,411,318,263,187,296,261
../../CUB_200_2011/images\065.Slaty_backed_Gull/Slaty_Backed_Gull_0023_796030.jpg,500,370,065.Slaty_backed_Gull,69,75,393,287,231,181,324,212
../../CUB_200_2011/images\065.Slaty_backed_Gull/Slaty_Backed_Gull_0051_796031.jpg,350,321,065.Slaty_backed_Gull,15,34,318,273,166,153,303,239
../../CUB_200_2011/images\065.Slaty_backed_Gull/Slaty_Backed_Gull_0003_796032.jpg,300,259,065.Slaty_backed_Gull,51,58,248,207,149,132,197,149
../../CUB_200_2011/images\065.Slaty_backed_Gull/Slaty_Backed_Gull_0046_796035.jpg,244,307,065.Slaty_backed_Gull,53,42,210,263,131,152,157,221
../../CUB_200_2011/images\065.Slaty_backed_Gull/Slaty_Backed_Gull_0071_796037.jpg,500,361,065.Slaty_backed_Gull,72,21,472,360,272,190,400,339
../../CUB_200_2011/images\065.Slaty_backed_Gull/Slaty_Backed_Gull_0078_796042.jpg,500,303,065.Slaty_backed_Gull,42,51,184,196,113,123,142,145
../../CUB_200_2011/images\065.Slaty_backed_Gull/Slaty_Backed_Gull_0038_796044.jpg,428,500,065.Slaty_backed_Gull,44,82,359,478,201,280,315,396
../../CUB_200_2011/images\065.Slaty_backed_Gull/Slaty_Backed_Gull_0050_796045.jpg,500,403,065.Slaty_backed_Gull,148,32,441,389,294,210,293,357
../../CUB_200_2011/images\065.Slaty_backed_Gull/Slaty_Backed_Gull_0032_796046.jpg,450,306,065.Slaty_backed_Gull,76,33,378,274,227,153,302,241
../../CUB_200_2011/images\065.Slaty_backed_Gull/Slaty_Backed_Gull_0025_796047.jpg,268,324,065.Slaty_backed_Gull,32,34,250,296,141,165,218,262
../../CUB_200_2011/images\065.Slaty_backed_Gull/Slaty_Backed_Gull_0063_796050.jpg,500,359,065.Slaty_backed_Gull,113,73,360,216,236,144,247,143
../../CUB_200_2011/images\065.Slaty_backed_Gull/Slaty_Backed_Gull_0053_796051.jpg,400,300,065.Slaty_backed_Gull,90,55,376,272,233,163,286,217
../../CUB_200_2011/images\065.Slaty_backed_Gull/Slaty_Backed_Gull_0060_796052.jpg,500,326,065.Slaty_backed_Gull,55,14,481,318,268,166,426,304
../../CUB_200_2011/images\065.Slaty_backed_Gull/Slaty_Backed_Gull_0036_796053.jpg,500,367,065.Slaty_backed_Gull,66,20,351,362,208,191,285,342
../../CUB_200_2011/images\065.Slaty_backed_Gull/Slaty_Backed_Gull_0008_53145.jpg,500,375,065.Slaty_backed_Gull,103,39,468,338,285,188,365,299
../../CUB_200_2011/images\065.Slaty_backed_Gull/Slaty_Backed_Gull_0085_53158.jpg,500,333,065.Slaty_backed_Gull,45,35,461,325,253,180,416,290
../../CUB_200_2011/images\065.Slaty_backed_Gull/Slaty_Backed_Gull_0087_786374.jpg,500,375,065.Slaty_backed_Gull,286,144,407,285,346,214,121,141
../../CUB_200_2011/images\065.Slaty_backed_Gull/Slaty_Backed_Gull_0084_786383.jpg,500,375,065.Slaty_backed_Gull,115,136,487,282,301,209,372,146
../../CUB_200_2011/images\065.Slaty_backed_Gull/Slaty_Backed_Gull_0083_786386.jpg,500,497,065.Slaty_backed_Gull,98,61,275,218,186,139,177,157
../../CUB_200_2011/images\065.Slaty_backed_Gull/Slaty_Backed_Gull_0086_786387.jpg,500,388,065.Slaty_backed_Gull,21,15,326,205,173,110,305,190
../../CUB_200_2011/images\065.Slaty_backed_Gull/Slaty_Backed_Gull_0068_53206.jpg,500,329,065.Slaty_backed_Gull,83,65,499,328,291,196,416,263
../../CUB_200_2011/images\065.Slaty_backed_Gull/Slaty_Backed_Gull_0002_53238.jpg,499,500,065.Slaty_backed_Gull,88,134,460,457,274,295,372,323
../../CUB_200_2011/images\065.Slaty_backed_Gull/Slaty_Backed_Gull_0029_45047.jpg,500,333,065.Slaty_backed_Gull,2,79,378,280,190,179,376,201
../../CUB_200_2011/images\065.Slaty_backed_Gull/Slaty_Backed_Gull_0026_53245.jpg,500,375,065.Slaty_backed_Gull,72,65,415,321,243,193,343,256
../../CUB_200_2011/images\066.Western_Gull/Western_Gull_0013_54794.jpg,500,375,066.Western_Gull,138,108,310,301,224,204,172,193
../../CUB_200_2011/images\066.Western_Gull/Western_Gull_0048_53776.jpg,500,332,066.Western_Gull,135,49,463,304,299,176,328,255
../../CUB_200_2011/images\066.Western_Gull/Western_Gull_0078_53595.jpg,500,356,066.Western_Gull,180,75,462,337,321,206,282,262
../../CUB_200_2011/images\066.Western_Gull/Western_Gull_0002_54825.jpg,500,281,066.Western_Gull,216,42,485,249,350,145,269,207
../../CUB_200_2011/images\066.Western_Gull/Western_Gull_0051_54320.jpg,500,373,066.Western_Gull,72,91,420,357,246,224,348,266
../../CUB_200_2011/images\066.Western_Gull/Western_Gull_0104_53816.jpg,500,400,066.Western_Gull,21,42,368,356,194,199,347,314
../../CUB_200_2011/images\066.Western_Gull/Western_Gull_0089_55306.jpg,500,333,066.Western_Gull,17,68,355,326,186,197,338,258
../../CUB_200_2011/images\066.Western_Gull/Western_Gull_0124_53838.jpg,500,325,066.Western_Gull,68,97,398,305,233,201,330,208
../../CUB_200_2011/images\066.Western_Gull/Western_Gull_0042_53843.jpg,500,333,066.Western_Gull,48,60,358,290,203,175,310,230
../../CUB_200_2011/images\066.Western_Gull/Western_Gull_0128_53852.jpg,500,375,066.Western_Gull,5,39,429,373,217,206,424,334
../../CUB_200_2011/images\066.Western_Gull/Western_Gull_0131_53349.jpg,500,487,066.Western_Gull,67,22,476,472,271,247,409,450
../../CUB_200_2011/images\066.Western_Gull/Western_Gull_0110_53861.jpg,500,333,066.Western_Gull,67,46,365,331,216,188,298,285
../../CUB_200_2011/images\066.Western_Gull/Western_Gull_0012_53605.jpg,500,333,066.Western_Gull,62,20,497,206,279,113,435,186
../../CUB_200_2011/images\066.Western_Gull/Western_Gull_0058_53882.jpg,500,282,066.Western_Gull,59,13,346,270,202,141,287,257
../../CUB_200_2011/images\066.Western_Gull/Western_Gull_0143_54909.jpg,500,375,066.Western_Gull,220,55,357,210,288,132,137,155
../../CUB_200_2011/images\066.Western_Gull/Western_Gull_0093_54925.jpg,500,334,066.Western_Gull,62,48,334,311,198,179,272,263
../../CUB_200_2011/images\066.Western_Gull/Western_Gull_0050_54425.jpg,500,375,066.Western_Gull,209,113,330,239,269,176,121,126
../../CUB_200_2011/images\066.Western_Gull/Western_Gull_0098_53925.jpg,500,333,066.Western_Gull,0,10,470,314,235,162,470,304
../../CUB_200_2011/images\066.Western_Gull/Western_Gull_0057_55312.jpg,500,333,066.Western_Gull,137,39,373,281,255,160,236,242
../../CUB_200_2011/images\066.Western_Gull/Western_Gull_0091_55465.jpg,500,335,066.Western_Gull,113,45,451,303,282,174,338,258
../../CUB_200_2011/images\066.Western_Gull/Western_Gull_0007_53431.jpg,500,367,066.Western_Gull,1,37,385,366,193,201,384,329
../../CUB_200_2011/images\066.Western_Gull/Western_Gull_0070_54978.jpg,500,375,066.Western_Gull,94,34,471,353,282,193,377,319
../../CUB_200_2011/images\066.Western_Gull/Western_Gull_0080_53445.jpg,500,333,066.Western_Gull,147,70,435,313,291,191,288,243
../../CUB_200_2011/images\066.Western_Gull/Western_Gull_0027_53994.jpg,500,375,066.Western_Gull,29,34,442,343,235,188,413,309
../../CUB_200_2011/images\066.Western_Gull/Western_Gull_0097_54508.jpg,500,375,066.Western_Gull,122,83,383,347,252,215,261,264
../../CUB_200_2011/images\066.Western_Gull/Western_Gull_0052_53485.jpg,500,334,066.Western_Gull,189,48,478,329,333,188,289,281
../../CUB_200_2011/images\066.Western_Gull/Western_Gull_0025_55421.jpg,500,333,066.Western_Gull,74,29,496,332,285,180,422,303
../../CUB_200_2011/images\066.Western_Gull/Western_Gull_0029_54143.jpg,500,333,066.Western_Gull,76,39,465,328,270,183,389,289
../../CUB_200_2011/images\066.Western_Gull/Western_Gull_0006_53504.jpg,500,333,066.Western_Gull,23,56,376,328,199,192,353,272
../../CUB_200_2011/images\066.Western_Gull/Western_Gull_0116_54037.jpg,500,333,066.Western_Gull,86,28,316,282,201,155,230,254
../../CUB_200_2011/images\066.Western_Gull/Western_Gull_0062_53538.jpg,380,500,066.Western_Gull,19,54,377,434,198,244,358,380
../../CUB_200_2011/images\066.Western_Gull/Western_Gull_0069_53553.jpg,500,375,066.Western_Gull,93,82,394,310,243,196,301,228
../../CUB_200_2011/images\066.Western_Gull/Western_Gull_0041_53554.jpg,500,346,066.Western_Gull,142,113,464,252,303,182,322,139
../../CUB_200_2011/images\066.Western_Gull/Western_Gull_0004_55605.jpg,500,335,066.Western_Gull,2,39,330,316,166,177,328,277
../../CUB_200_2011/images\066.Western_Gull/Western_Gull_0030_54083.jpg,500,333,066.Western_Gull,171,21,467,317,319,169,296,296
../../CUB_200_2011/images\066.Western_Gull/Western_Gull_0036_54329.jpg,500,333,066.Western_Gull,47,109,248,305,147,207,201,196
../../CUB_200_2011/images\066.Western_Gull/Western_Gull_0133_55639.jpg,500,332,066.Western_Gull,165,122,495,293,330,207,330,171
../../CUB_200_2011/images\066.Western_Gull/Western_Gull_0066_54105.jpg,500,500,066.Western_Gull,24,81,492,485,258,283,468,404
../../CUB_200_2011/images\066.Western_Gull/Western_Gull_0114_55644.jpg,500,397,066.Western_Gull,76,61,465,394,270,227,389,333
../../CUB_200_2011/images\066.Western_Gull/Western_Gull_0090_53603.jpg,500,357,066.Western_Gull,22,79,324,329,173,204,302,250
../../CUB_200_2011/images\066.Western_Gull/Western_Gull_0073_54118.jpg,500,375,066.Western_Gull,178,73,424,302,301,187,246,229
../../CUB_200_2011/images\066.Western_Gull/Western_Gull_0117_44697.jpg,500,375,066.Western_Gull,155,70,459,357,307,213,304,287
../../CUB_200_2011/images\066.Western_Gull/Western_Gull_0094_55156.jpg,500,395,066.Western_Gull,126,107,464,329,295,218,338,222
../../CUB_200_2011/images\066.Western_Gull/Western_Gull_0021_54649.jpg,500,334,066.Western_Gull,79,69,230,236,154,152,151,167
../../CUB_200_2011/images\066.Western_Gull/Western_Gull_0024_53631.jpg,500,333,066.Western_Gull,23,81,259,272,141,176,236,191
../../CUB_200_2011/images\066.Western_Gull/Western_Gull_0028_55680.jpg,500,375,066.Western_Gull,112,81,416,343,264,212,304,262
../../CUB_200_2011/images\066.Western_Gull/Western_Gull_0035_55703.jpg,500,323,066.Western_Gull,51,15,493,313,272,164,442,298
../../CUB_200_2011/images\066.Western_Gull/Western_Gull_0122_40866.jpg,500,334,066.Western_Gull,154,60,447,305,300,182,293,245
../../CUB_200_2011/images\066.Western_Gull/Western_Gull_0099_53670.jpg,500,335,066.Western_Gull,117,47,345,329,231,188,228,282
../../CUB_200_2011/images\066.Western_Gull/Western_Gull_0065_55728.jpg,500,400,066.Western_Gull,116,141,369,345,242,243,253,204
../../CUB_200_2011/images\066.Western_Gull/Western_Gull_0087_54193.jpg,333,500,066.Western_Gull,79,197,281,438,180,317,202,241
../../CUB_200_2011/images\066.Western_Gull/Western_Gull_0043_54706.jpg,497,500,066.Western_Gull,2,20,481,440,241,230,479,420
../../CUB_200_2011/images\066.Western_Gull/Western_Gull_0071_54207.jpg,500,333,066.Western_Gull,2,15,403,332,202,173,401,317
../../CUB_200_2011/images\066.Western_Gull/Western_Gull_0045_54735.jpg,500,338,066.Western_Gull,81,74,310,290,195,182,229,216
../../CUB_200_2011/images\066.Western_Gull/Western_Gull_0011_53713.jpg,500,333,066.Western_Gull,51,51,366,301,208,176,315,250
../../CUB_200_2011/images\066.Western_Gull/Western_Gull_0022_54607.jpg,500,375,066.Western_Gull,213,129,443,354,328,241,230,225
../../CUB_200_2011/images\066.Western_Gull/Western_Gull_0115_54950.jpg,500,334,066.Western_Gull,35,79,304,333,169,206,269,254
../../CUB_200_2011/images\066.Western_Gull/Western_Gull_0100_54761.jpg,500,500,066.Western_Gull,27,120,336,469,181,294,309,349
../../CUB_200_2011/images\066.Western_Gull/Western_Gull_0009_54768.jpg,500,328,066.Western_Gull,29,81,435,319,232,200,406,238
../../CUB_200_2011/images\066.Western_Gull/Western_Gull_0049_53748.jpg,500,375,066.Western_Gull,88,21,489,356,288,188,401,335
../../CUB_200_2011/images\067.Anna_Hummingbird/Anna_Hummingbird_0106_56335.jpg,500,394,067.Anna_Hummingbird,211,111,474,363,342,237,263,252
../../CUB_200_2011/images\067.Anna_Hummingbird/Anna_Hummingbird_0093_56851.jpg,333,500,067.Anna_Hummingbird,37,31,312,482,174,256,275,451
../../CUB_200_2011/images\067.Anna_Hummingbird/Anna_Hummingbird_0052_56344.jpg,500,500,067.Anna_Hummingbird,100,84,418,484,259,284,318,400
../../CUB_200_2011/images\067.Anna_Hummingbird/Anna_Hummingbird_0126_55983.jpg,500,345,067.Anna_Hummingbird,31,65,373,279,202,172,342,214
../../CUB_200_2011/images\067.Anna_Hummingbird/Anna_Hummingbird_0023_55841.jpg,423,500,067.Anna_Hummingbird,108,96,380,406,244,251,272,310
../../CUB_200_2011/images\067.Anna_Hummingbird/Anna_Hummingbird_0080_56366.jpg,500,333,067.Anna_Hummingbird,30,42,278,329,154,185,248,287
../../CUB_200_2011/images\067.Anna_Hummingbird/Anna_Hummingbird_0006_55871.jpg,500,325,067.Anna_Hummingbird,173,116,328,243,250,179,155,127
../../CUB_200_2011/images\067.Anna_Hummingbird/Anna_Hummingbird_0027_55873.jpg,333,500,067.Anna_Hummingbird,37,111,288,456,162,283,251,345
../../CUB_200_2011/images\067.Anna_Hummingbird/Anna_Hummingbird_0098_56388.jpg,500,333,067.Anna_Hummingbird,164,82,396,326,280,204,232,244
../../CUB_200_2011/images\067.Anna_Hummingbird/Anna_Hummingbird_0055_56396.jpg,500,500,067.Anna_Hummingbird,142,149,312,378,227,263,170,229
../../CUB_200_2011/images\067.Anna_Hummingbird/Anna_Hummingbird_0074_56917.jpg,500,448,067.Anna_Hummingbird,127,62,353,377,240,219,226,315
../../CUB_200_2011/images\067.Anna_Hummingbird/Anna_Hummingbird_0029_55823.jpg,391,500,067.Anna_Hummingbird,67,124,267,247,167,185,200,123
../../CUB_200_2011/images\067.Anna_Hummingbird/Anna_Hummingbird_0054_56419.jpg,500,343,067.Anna_Hummingbird,10,83,467,336,238,209,457,253
../../CUB_200_2011/images\067.Anna_Hummingbird/Anna_Hummingbird_0069_56933.jpg,500,334,067.Anna_Hummingbird,29,61,465,274,247,167,436,213
../../CUB_200_2011/images\067.Anna_Hummingbird/Anna_Hummingbird_0099_55916.jpg,500,333,067.Anna_Hummingbird,128,8,359,330,243,169,231,322
../../CUB_200_2011/images\067.Anna_Hummingbird/Anna_Hummingbird_0087_56435.jpg,500,335,067.Anna_Hummingbird,67,64,433,306,250,185,366,242
../../CUB_200_2011/images\067.Anna_Hummingbird/Anna_Hummingbird_0121_56436.jpg,334,500,067.Anna_Hummingbird,158,219,289,372,223,295,131,153
../../CUB_200_2011/images\067.Anna_Hummingbird/Anna_Hummingbird_0017_56954.jpg,500,336,067.Anna_Hummingbird,59,52,251,242,155,147,192,190
../../CUB_200_2011/images\067.Anna_Hummingbird/Anna_Hummingbird_0001_56960.jpg,500,478,067.Anna_Hummingbird,137,92,355,365,246,228,218,273
../../CUB_200_2011/images\067.Anna_Hummingbird/Anna_Hummingbird_0101_56459.jpg,500,334,067.Anna_Hummingbird,35,41,245,200,140,120,210,159
../../CUB_200_2011/images\067.Anna_Hummingbird/Anna_Hummingbird_0066_56486.jpg,500,470,067.Anna_Hummingbird,230,185,465,465,347,325,235,280
../../CUB_200_2011/images\067.Anna_Hummingbird/Anna_Hummingbird_0035_56493.jpg,500,495,067.Anna_Hummingbird,65,115,336,337,200,226,271,222
../../CUB_200_2011/images\067.Anna_Hummingbird/Anna_Hummingbird_0086_56495.jpg,333,500,067.Anna_Hummingbird,108,163,224,298,166,230,116,135
../../CUB_200_2011/images\067.Anna_Hummingbird/Anna_Hummingbird_0042_55990.jpg,458,500,067.Anna_Hummingbird,66,57,389,469,227,263,323,412
../../CUB_200_2011/images\067.Anna_Hummingbird/Anna_Hummingbird_0028_55993.jpg,500,438,067.Anna_Hummingbird,155,130,358,354,256,242,203,224
../../CUB_200_2011/images\067.Anna_Hummingbird/Anna_Hummingbird_0109_57022.jpg,500,333,067.Anna_Hummingbird,0,0,318,265,159,132,318,265
../../CUB_200_2011/images\067.Anna_Hummingbird/Anna_Hummingbird_0019_57025.jpg,500,333,067.Anna_Hummingbird,225,128,326,293,275,210,101,165
../../CUB_200_2011/images\067.Anna_Hummingbird/Anna_Hummingbird_0091_56004.jpg,500,317,067.Anna_Hummingbird,166,35,459,242,312,138,293,207
../../CUB_200_2011/images\067.Anna_Hummingbird/Anna_Hummingbird_0112_56353.jpg,498,500,067.Anna_Hummingbird,49,104,422,392,235,248,373,288
../../CUB_200_2011/images\067.Anna_Hummingbird/Anna_Hummingbird_0127_56520.jpg,369,500,067.Anna_Hummingbird,98,187,290,339,194,263,192,152
../../CUB_200_2011/images\067.Anna_Hummingbird/Anna_Hummingbird_0038_57036.jpg,411,448,067.Anna_Hummingbird,101,108,398,379,249,243,297,271
../../CUB_200_2011/images\067.Anna_Hummingbird/Anna_Hummingbird_0047_56049.jpg,375,500,067.Anna_Hummingbird,123,108,263,348,193,228,140,240
../../CUB_200_2011/images\067.Anna_Hummingbird/Anna_Hummingbird_0044_56066.jpg,500,369,067.Anna_Hummingbird,87,108,441,323,264,215,354,215
../../CUB_200_2011/images\067.Anna_Hummingbird/Anna_Hummingbird_0037_56587.jpg,500,333,067.Anna_Hummingbird,107,70,400,313,253,191,293,243
../../CUB_200_2011/images\067.Anna_Hummingbird/Anna_Hummingbird_0070_56085.jpg,500,333,067.Anna_Hummingbird,141,74,416,272,278,173,275,198
../../CUB_200_2011/images\067.Anna_Hummingbird/Anna_Hummingbird_0102_56087.jpg,500,398,067.Anna_Hummingbird,49,52,375,388,212,220,326,336
../../CUB_200_2011/images\067.Anna_Hummingbird/Anna_Hummingbird_0094_56092.jpg,500,298,067.Anna_Hummingbird,24,83,302,223,163,153,278,140
../../CUB_200_2011/images\067.Anna_Hummingbird/Anna_Hummingbird_0128_57047.jpg,500,288,067.Anna_Hummingbird,54,84,360,277,207,180,306,193
../../CUB_200_2011/images\067.Anna_Hummingbird/Anna_Hummingbird_0053_56112.jpg,404,500,067.Anna_Hummingbird,98,68,320,403,209,235,222,335
../../CUB_200_2011/images\067.Anna_Hummingbird/Anna_Hummingbird_0034_56614.jpg,500,461,067.Anna_Hummingbird,112,20,407,446,259,233,295,426
../../CUB_200_2011/images\067.Anna_Hummingbird/Anna_Hummingbird_0122_56622.jpg,422,500,067.Anna_Hummingbird,92,138,326,437,209,287,234,299
../../CUB_200_2011/images\067.Anna_Hummingbird/Anna_Hummingbird_0130_56122.jpg,500,334,067.Anna_Hummingbird,200,117,379,244,289,180,179,127
../../CUB_200_2011/images\067.Anna_Hummingbird/Anna_Hummingbird_0022_55779.jpg,500,379,067.Anna_Hummingbird,84,43,460,313,272,178,376,270
../../CUB_200_2011/images\067.Anna_Hummingbird/Anna_Hummingbird_0065_56154.jpg,500,374,067.Anna_Hummingbird,179,28,482,285,330,156,303,257
../../CUB_200_2011/images\067.Anna_Hummingbird/Anna_Hummingbird_0059_56674.jpg,500,333,067.Anna_Hummingbird,152,48,276,273,214,160,124,225
../../CUB_200_2011/images\067.Anna_Hummingbird/Anna_Hummingbird_0117_55785.jpg,407,500,067.Anna_Hummingbird,128,74,345,472,236,273,217,398
../../CUB_200_2011/images\067.Anna_Hummingbird/Anna_Hummingbird_0031_56709.jpg,500,375,067.Anna_Hummingbird,110,16,354,268,232,142,244,252
../../CUB_200_2011/images\067.Anna_Hummingbird/Anna_Hummingbird_0018_56732.jpg,500,300,067.Anna_Hummingbird,221,92,441,250,331,171,220,158
../../CUB_200_2011/images\067.Anna_Hummingbird/Anna_Hummingbird_0096_56754.jpg,500,375,067.Anna_Hummingbird,66,41,427,344,246,192,361,303
../../CUB_200_2011/images\067.Anna_Hummingbird/Anna_Hummingbird_0085_56756.jpg,406,500,067.Anna_Hummingbird,85,38,367,375,226,206,282,337
../../CUB_200_2011/images\067.Anna_Hummingbird/Anna_Hummingbird_0024_55760.jpg,500,365,067.Anna_Hummingbird,48,70,395,315,221,192,347,245
../../CUB_200_2011/images\067.Anna_Hummingbird/Anna_Hummingbird_0021_55763.jpg,500,375,067.Anna_Hummingbird,90,66,470,372,280,219,380,306
../../CUB_200_2011/images\067.Anna_Hummingbird/Anna_Hummingbird_0115_55766.jpg,500,333,067.Anna_Hummingbird,10,21,362,312,186,166,352,291
../../CUB_200_2011/images\067.Anna_Hummingbird/Anna_Hummingbird_0050_56794.jpg,500,357,067.Anna_Hummingbird,283,157,476,330,379,243,193,173
../../CUB_200_2011/images\067.Anna_Hummingbird/Anna_Hummingbird_0118_55773.jpg,500,357,067.Anna_Hummingbird,81,57,435,284,258,170,354,227
../../CUB_200_2011/images\067.Anna_Hummingbird/Anna_Hummingbird_0043_56059.jpg,385,500,067.Anna_Hummingbird,28,169,235,348,131,258,207,179
../../CUB_200_2011/images\067.Anna_Hummingbird/Anna_Hummingbird_0040_56293.jpg,340,500,067.Anna_Hummingbird,34,68,284,290,159,179,250,222
../../CUB_200_2011/images\067.Anna_Hummingbird/Anna_Hummingbird_0113_56296.jpg,333,500,067.Anna_Hummingbird,69,118,324,417,196,267,255,299
../../CUB_200_2011/images\067.Anna_Hummingbird/Anna_Hummingbird_0036_56809.jpg,500,333,067.Anna_Hummingbird,111,24,437,300,274,162,326,276
../../CUB_200_2011/images\067.Anna_Hummingbird/Anna_Hummingbird_0119_56309.jpg,500,375,067.Anna_Hummingbird,74,115,342,331,208,223,268,216
../../CUB_200_2011/images\068.Ruby_throated_Hummingbird/Ruby_Throated_Hummingbird_0045_57347.jpg,500,295,068.Ruby_throated_Hummingbird,117,10,318,114,217,62,201,104
../../CUB_200_2011/images\068.Ruby_throated_Hummingbird/Ruby_Throated_Hummingbird_0005_57349.jpg,500,399,068.Ruby_throated_Hummingbird,44,56,338,353,191,204,294,297
../../CUB_200_2011/images\068.Ruby_throated_Hummingbird/Ruby_Throated_Hummingbird_0077_57858.jpg,401,500,068.Ruby_throated_Hummingbird,90,81,324,417,207,249,234,336
../../CUB_200_2011/images\068.Ruby_throated_Hummingbird/Ruby_Throated_Hummingbird_0123_57745.jpg,500,421,068.Ruby_throated_Hummingbird,97,103,344,379,220,241,247,276
../../CUB_200_2011/images\068.Ruby_throated_Hummingbird/Ruby_Throated_Hummingbird_0054_57364.jpg,363,500,068.Ruby_throated_Hummingbird,106,232,282,354,194,293,176,122
../../CUB_200_2011/images\068.Ruby_throated_Hummingbird/Ruby_Throated_Hummingbird_0088_57366.jpg,500,400,068.Ruby_throated_Hummingbird,28,104,430,309,229,206,402,205
../../CUB_200_2011/images\068.Ruby_throated_Hummingbird/Ruby_Throated_Hummingbird_0126_57371.jpg,400,500,068.Ruby_throated_Hummingbird,29,118,358,370,193,244,329,252
../../CUB_200_2011/images\068.Ruby_throated_Hummingbird/Ruby_Throated_Hummingbird_0071_57886.jpg,500,320,068.Ruby_throated_Hummingbird,76,33,388,310,232,171,312,277
../../CUB_200_2011/images\068.Ruby_throated_Hummingbird/Ruby_Throated_Hummingbird_0049_57891.jpg,500,386,068.Ruby_throated_Hummingbird,8,22,493,377,250,199,485,355
../../CUB_200_2011/images\068.Ruby_throated_Hummingbird/Ruby_Throated_Hummingbird_0064_57387.jpg,500,333,068.Ruby_throated_Hummingbird,6,86,251,284,128,185,245,198
../../CUB_200_2011/images\068.Ruby_throated_Hummingbird/Ruby_Throated_Hummingbird_0007_57388.jpg,398,500,068.Ruby_throated_Hummingbird,124,119,303,419,213,269,179,300
../../CUB_200_2011/images\068.Ruby_throated_Hummingbird/Ruby_Throated_Hummingbird_0072_57391.jpg,500,400,068.Ruby_throated_Hummingbird,81,45,485,356,283,200,404,311
../../CUB_200_2011/images\068.Ruby_throated_Hummingbird/Ruby_Throated_Hummingbird_0009_57904.jpg,500,367,068.Ruby_throated_Hummingbird,131,99,306,233,218,166,175,134
../../CUB_200_2011/images\068.Ruby_throated_Hummingbird/Ruby_Throated_Hummingbird_0083_57397.jpg,500,324,068.Ruby_throated_Hummingbird,57,53,255,170,156,111,198,117
../../CUB_200_2011/images\068.Ruby_throated_Hummingbird/Ruby_Throated_Hummingbird_0090_57411.jpg,500,500,068.Ruby_throated_Hummingbird,75,65,445,383,260,224,370,318
../../CUB_200_2011/images\068.Ruby_throated_Hummingbird/Ruby_Throated_Hummingbird_0030_57422.jpg,500,362,068.Ruby_throated_Hummingbird,20,43,460,261,240,152,440,218
../../CUB_200_2011/images\068.Ruby_throated_Hummingbird/Ruby_Throated_Hummingbird_0042_57431.jpg,407,500,068.Ruby_throated_Hummingbird,22,141,339,400,180,270,317,259
../../CUB_200_2011/images\068.Ruby_throated_Hummingbird/Ruby_Throated_Hummingbird_0052_57432.jpg,386,500,068.Ruby_throated_Hummingbird,12,166,378,341,195,253,366,175
../../CUB_200_2011/images\068.Ruby_throated_Hummingbird/Ruby_Throated_Hummingbird_0024_57969.jpg,500,333,068.Ruby_throated_Hummingbird,181,41,453,190,317,115,272,149
../../CUB_200_2011/images\068.Ruby_throated_Hummingbird/Ruby_Throated_Hummingbird_0106_57976.jpg,500,356,068.Ruby_throated_Hummingbird,58,105,290,280,174,192,232,175
../../CUB_200_2011/images\068.Ruby_throated_Hummingbird/Ruby_Throated_Hummingbird_0040_57982.jpg,339,500,068.Ruby_throated_Hummingbird,47,69,297,412,172,240,250,343
../../CUB_200_2011/images\068.Ruby_throated_Hummingbird/Ruby_Throated_Hummingbird_0014_57477.jpg,500,477,068.Ruby_throated_Hummingbird,145,173,366,384,255,278,221,211
../../CUB_200_2011/images\068.Ruby_throated_Hummingbird/Ruby_Throated_Hummingbird_0095_57990.jpg,377,500,068.Ruby_throated_Hummingbird,41,243,248,459,144,351,207,216
../../CUB_200_2011/images\068.Ruby_throated_Hummingbird/Ruby_Throated_Hummingbird_0096_57505.jpg,500,375,068.Ruby_throated_Hummingbird,27,95,252,221,139,158,225,126
../../CUB_200_2011/images\068.Ruby_throated_Hummingbird/Ruby_Throated_Hummingbird_0050_57510.jpg,385,500,068.Ruby_throated_Hummingbird,28,129,377,377,202,253,349,248
../../CUB_200_2011/images\068.Ruby_throated_Hummingbird/Ruby_Throated_Hummingbird_0098_57514.jpg,500,388,068.Ruby_throated_Hummingbird,64,74,455,345,259,209,391,271
../../CUB_200_2011/images\068.Ruby_throated_Hummingbird/Ruby_Throated_Hummingbird_0066_57518.jpg,500,364,068.Ruby_throated_Hummingbird,144,92,316,288,230,190,172,196
../../CUB_200_2011/images\068.Ruby_throated_Hummingbird/Ruby_Throated_Hummingbird_0116_58031.jpg,500,333,068.Ruby_throated_Hummingbird,90,147,260,258,175,202,170,111
../../CUB_200_2011/images\068.Ruby_throated_Hummingbird/Ruby_Throated_Hummingbird_0118_57536.jpg,500,357,068.Ruby_throated_Hummingbird,19,139,282,319,150,229,263,180
../../CUB_200_2011/images\068.Ruby_throated_Hummingbird/Ruby_Throated_Hummingbird_0075_57537.jpg,500,333,068.Ruby_throated_Hummingbird,39,71,414,219,226,145,375,148
../../CUB_200_2011/images\068.Ruby_throated_Hummingbird/Ruby_Throated_Hummingbird_0115_58067.jpg,500,375,068.Ruby_throated_Hummingbird,95,54,347,372,221,213,252,318
../../CUB_200_2011/images\068.Ruby_throated_Hummingbird/Ruby_Throated_Hummingbird_0079_58075.jpg,469,500,068.Ruby_throated_Hummingbird,219,132,380,340,299,236,161,208
../../CUB_200_2011/images\068.Ruby_throated_Hummingbird/Ruby_Throated_Hummingbird_0103_57573.jpg,500,358,068.Ruby_throated_Hummingbird,58,41,459,350,258,195,401,309
../../CUB_200_2011/images\068.Ruby_throated_Hummingbird/Ruby_Throated_Hummingbird_0119_57575.jpg,333,500,068.Ruby_throated_Hummingbird,159,232,273,345,216,288,114,113
../../CUB_200_2011/images\068.Ruby_throated_Hummingbird/Ruby_Throated_Hummingbird_0117_58092.jpg,500,363,068.Ruby_throated_Hummingbird,60,106,311,280,185,193,251,174
../../CUB_200_2011/images\068.Ruby_throated_Hummingbird/Ruby_Throated_Hummingbird_0111_58141.jpg,500,357,068.Ruby_throated_Hummingbird,43,79,386,321,214,200,343,242
../../CUB_200_2011/images\068.Ruby_throated_Hummingbird/Ruby_Throated_Hummingbird_0034_58148.jpg,500,343,068.Ruby_throated_Hummingbird,95,102,399,257,247,179,304,155
../../CUB_200_2011/images\068.Ruby_throated_Hummingbird/Ruby_Throated_Hummingbird_0048_57222.jpg,500,401,068.Ruby_throated_Hummingbird,64,90,409,319,236,204,345,229
../../CUB_200_2011/images\068.Ruby_throated_Hummingbird/Ruby_Throated_Hummingbird_0076_57649.jpg,500,417,068.Ruby_throated_Hummingbird,139,110,265,236,202,173,126,126
../../CUB_200_2011/images\068.Ruby_throated_Hummingbird/Ruby_Throated_Hummingbird_0001_58162.jpg,500,400,068.Ruby_throated_Hummingbird,108,116,441,363,274,239,333,247
../../CUB_200_2011/images\068.Ruby_throated_Hummingbird/Ruby_Throated_Hummingbird_0108_57653.jpg,436,500,068.Ruby_throated_Hummingbird,67,135,285,314,176,224,218,179
../../CUB_200_2011/images\068.Ruby_throated_Hummingbird/Ruby_Throated_Hummingbird_0032_58168.jpg,500,333,068.Ruby_throated_Hummingbird,98,95,306,229,202,162,208,134
../../CUB_200_2011/images\068.Ruby_throated_Hummingbird/Ruby_Throated_Hummingbird_0129_57666.jpg,333,500,068.Ruby_throated_Hummingbird,21,131,322,390,171,260,301,259
../../CUB_200_2011/images\068.Ruby_throated_Hummingbird/Ruby_Throated_Hummingbird_0008_58204.jpg,500,400,068.Ruby_throated_Hummingbird,235,88,359,313,297,200,124,225
../../CUB_200_2011/images\068.Ruby_throated_Hummingbird/Ruby_Throated_Hummingbird_0059_58210.jpg,500,352,068.Ruby_throated_Hummingbird,48,98,406,285,227,191,358,187
../../CUB_200_2011/images\068.Ruby_throated_Hummingbird/Ruby_Throated_Hummingbird_0078_57208.jpg,500,485,068.Ruby_throated_Hummingbird,121,126,415,413,268,269,294,287
../../CUB_200_2011/images\068.Ruby_throated_Hummingbird/Ruby_Throated_Hummingbird_0013_57212.jpg,500,400,068.Ruby_throated_Hummingbird,80,97,426,361,253,229,346,264
../../CUB_200_2011/images\068.Ruby_throated_Hummingbird/Ruby_Throated_Hummingbird_0025_57835.jpg,500,375,068.Ruby_throated_Hummingbird,136,112,356,296,246,204,220,184
../../CUB_200_2011/images\068.Ruby_throated_Hummingbird/Ruby_Throated_Hummingbird_0046_57225.jpg,495,500,068.Ruby_throated_Hummingbird,56,85,441,389,248,237,385,304
../../CUB_200_2011/images\068.Ruby_throated_Hummingbird/Ruby_Throated_Hummingbird_0003_58269.jpg,500,400,068.Ruby_throated_Hummingbird,47,62,431,375,239,218,384,313
../../CUB_200_2011/images\068.Ruby_throated_Hummingbird/Ruby_Throated_Hummingbird_0128_58281.jpg,500,375,068.Ruby_throated_Hummingbird,12,41,254,320,133,180,242,279
../../CUB_200_2011/images\068.Ruby_throated_Hummingbird/Ruby_Throated_Hummingbird_0010_58285.jpg,500,371,068.Ruby_throated_Hummingbird,49,81,403,342,226,211,354,261
../../CUB_200_2011/images\068.Ruby_throated_Hummingbird/Ruby_Throated_Hummingbird_0055_57781.jpg,500,386,068.Ruby_throated_Hummingbird,18,70,353,295,185,182,335,225
../../CUB_200_2011/images\068.Ruby_throated_Hummingbird/Ruby_Throated_Hummingbird_0084_58311.jpg,500,500,068.Ruby_throated_Hummingbird,51,97,434,429,242,263,383,332
../../CUB_200_2011/images\068.Ruby_throated_Hummingbird/Ruby_Throated_Hummingbird_0120_58316.jpg,500,333,068.Ruby_throated_Hummingbird,43,61,420,283,231,172,377,222
../../CUB_200_2011/images\068.Ruby_throated_Hummingbird/Ruby_Throated_Hummingbird_0058_57298.jpg,500,326,068.Ruby_throated_Hummingbird,39,46,264,214,151,130,225,168
../../CUB_200_2011/images\068.Ruby_throated_Hummingbird/Ruby_Throated_Hummingbird_0131_57813.jpg,500,360,068.Ruby_throated_Hummingbird,15,159,268,348,141,253,253,189
../../CUB_200_2011/images\068.Ruby_throated_Hummingbird/Ruby_Throated_Hummingbird_0027_58191.jpg,500,487,068.Ruby_throated_Hummingbird,73,102,438,393,255,247,365,291
../../CUB_200_2011/images\068.Ruby_throated_Hummingbird/Ruby_Throated_Hummingbird_0107_57339.jpg,333,500,068.Ruby_throated_Hummingbird,48,155,328,311,188,233,280,156
../../CUB_200_2011/images\068.Ruby_throated_Hummingbird/Ruby_Throated_Hummingbird_0110_57851.jpg,500,354,068.Ruby_throated_Hummingbird,56,67,408,267,232,167,352,200
../../CUB_200_2011/images\069.Rufous_Hummingbird/Rufous_Hummingbird_0118_59393.jpg,500,412,069.Rufous_Hummingbird,114,106,282,390,198,248,168,284
../../CUB_200_2011/images\069.Rufous_Hummingbird/Rufous_Hummingbird_0009_59405.jpg,486,500,069.Rufous_Hummingbird,101,67,449,393,275,230,348,326
../../CUB_200_2011/images\069.Rufous_Hummingbird/Rufous_Hummingbird_0111_59408.jpg,500,333,069.Rufous_Hummingbird,19,70,431,307,225,188,412,237
../../CUB_200_2011/images\069.Rufous_Hummingbird/Rufous_Hummingbird_0002_58387.jpg,500,360,069.Rufous_Hummingbird,28,28,461,348,244,188,433,320
../../CUB_200_2011/images\069.Rufous_Hummingbird/Rufous_Hummingbird_0102_59414.jpg,500,332,069.Rufous_Hummingbird,120,67,370,244,245,155,250,177
../../CUB_200_2011/images\069.Rufous_Hummingbird/Rufous_Hummingbird_0031_58391.jpg,500,322,069.Rufous_Hummingbird,126,67,450,218,288,142,324,151
../../CUB_200_2011/images\069.Rufous_Hummingbird/Rufous_Hummingbird_0101_59420.jpg,500,345,069.Rufous_Hummingbird,63,96,429,256,246,176,366,160
../../CUB_200_2011/images\069.Rufous_Hummingbird/Rufous_Hummingbird_0055_59935.jpg,500,378,069.Rufous_Hummingbird,204,193,378,330,291,261,174,137
../../CUB_200_2011/images\069.Rufous_Hummingbird/Rufous_Hummingbird_0021_58408.jpg,500,500,069.Rufous_Hummingbird,124,149,414,308,269,228,290,159
../../CUB_200_2011/images\069.Rufous_Hummingbird/Rufous_Hummingbird_0035_59434.jpg,500,384,069.Rufous_Hummingbird,225,59,402,239,313,149,177,180
../../CUB_200_2011/images\069.Rufous_Hummingbird/Rufous_Hummingbird_0106_60465.jpg,500,386,069.Rufous_Hummingbird,64,154,320,326,192,240,256,172
../../CUB_200_2011/images\069.Rufous_Hummingbird/Rufous_Hummingbird_0125_58932.jpg,450,375,069.Rufous_Hummingbird,48,64,287,309,167,186,239,245
../../CUB_200_2011/images\069.Rufous_Hummingbird/Rufous_Hummingbird_0018_59447.jpg,333,500,069.Rufous_Hummingbird,112,215,253,476,182,345,141,261
../../CUB_200_2011/images\069.Rufous_Hummingbird/Rufous_Hummingbird_0047_59448.jpg,500,333,069.Rufous_Hummingbird,263,90,466,234,364,162,203,144
../../CUB_200_2011/images\069.Rufous_Hummingbird/Rufous_Hummingbird_0134_59449.jpg,500,375,069.Rufous_Hummingbird,190,46,441,283,315,164,251,237
../../CUB_200_2011/images\069.Rufous_Hummingbird/Rufous_Hummingbird_0077_59452.jpg,430,500,069.Rufous_Hummingbird,65,82,307,376,186,229,242,294
../../CUB_200_2011/images\069.Rufous_Hummingbird/Rufous_Hummingbird_0027_59456.jpg,500,334,069.Rufous_Hummingbird,203,114,335,305,269,209,132,191
../../CUB_200_2011/images\069.Rufous_Hummingbird/Rufous_Hummingbird_0007_58433.jpg,500,333,069.Rufous_Hummingbird,179,101,360,235,269,168,181,134
../../CUB_200_2011/images\069.Rufous_Hummingbird/Rufous_Hummingbird_0025_59461.jpg,500,351,069.Rufous_Hummingbird,41,43,400,242,220,142,359,199
../../CUB_200_2011/images\069.Rufous_Hummingbird/Rufous_Hummingbird_0014_59476.jpg,333,500,069.Rufous_Hummingbird,20,164,307,372,163,268,287,208
../../CUB_200_2011/images\069.Rufous_Hummingbird/Rufous_Hummingbird_0011_59480.jpg,500,347,069.Rufous_Hummingbird,105,41,459,324,282,182,354,283
../../CUB_200_2011/images\069.Rufous_Hummingbird/Rufous_Hummingbird_0057_59489.jpg,500,353,069.Rufous_Hummingbird,165,131,381,232,273,181,216,101
../../CUB_200_2011/images\069.Rufous_Hummingbird/Rufous_Hummingbird_0060_58986.jpg,500,471,069.Rufous_Hummingbird,32,136,468,386,250,261,436,250
../../CUB_200_2011/images\069.Rufous_Hummingbird/Rufous_Hummingbird_0130_59500.jpg,500,333,069.Rufous_Hummingbird,235,107,473,291,354,199,238,184
../../CUB_200_2011/images\069.Rufous_Hummingbird/Rufous_Hummingbird_0048_58478.jpg,500,312,069.Rufous_Hummingbird,23,78,428,244,225,161,405,166
../../CUB_200_2011/images\069.Rufous_Hummingbird/Rufous_Hummingbird_0052_59581.jpg,500,333,069.Rufous_Hummingbird,152,60,469,306,310,183,317,246
../../CUB_200_2011/images\069.Rufous_Hummingbird/Rufous_Hummingbird_0071_59505.jpg,500,405,069.Rufous_Hummingbird,5,54,360,379,182,216,355,325
../../CUB_200_2011/images\069.Rufous_Hummingbird/Rufous_Hummingbird_0109_60021.jpg,500,333,069.Rufous_Hummingbird,239,63,433,269,336,166,194,206
../../CUB_200_2011/images\069.Rufous_Hummingbird/Rufous_Hummingbird_0067_59510.jpg,500,371,069.Rufous_Hummingbird,25,112,259,329,142,220,234,217
../../CUB_200_2011/images\069.Rufous_Hummingbird/Rufous_Hummingbird_0017_59520.jpg,500,500,069.Rufous_Hummingbird,89,55,475,431,282,243,386,376
../../CUB_200_2011/images\069.Rufous_Hummingbird/Rufous_Hummingbird_0065_58497.jpg,500,333,069.Rufous_Hummingbird,119,121,280,274,199,197,161,153
../../CUB_200_2011/images\069.Rufous_Hummingbird/Rufous_Hummingbird_0089_59524.jpg,500,498,069.Rufous_Hummingbird,88,152,434,360,261,256,346,208
../../CUB_200_2011/images\069.Rufous_Hummingbird/Rufous_Hummingbird_0124_58465.jpg,500,375,069.Rufous_Hummingbird,38,58,433,350,235,204,395,292
../../CUB_200_2011/images\069.Rufous_Hummingbird/Rufous_Hummingbird_0064_58509.jpg,500,337,069.Rufous_Hummingbird,56,72,431,297,243,184,375,225
../../CUB_200_2011/images\069.Rufous_Hummingbird/Rufous_Hummingbird_0100_59541.jpg,500,334,069.Rufous_Hummingbird,103,86,319,286,211,186,216,200
../../CUB_200_2011/images\069.Rufous_Hummingbird/Rufous_Hummingbird_0036_59562.jpg,500,389,069.Rufous_Hummingbird,192,132,487,330,339,231,295,198
../../CUB_200_2011/images\069.Rufous_Hummingbird/Rufous_Hummingbird_0076_59563.jpg,500,332,069.Rufous_Hummingbird,131,55,396,281,263,168,265,226
../../CUB_200_2011/images\069.Rufous_Hummingbird/Rufous_Hummingbird_0081_59592.jpg,500,318,069.Rufous_Hummingbird,56,120,287,280,171,200,231,160
../../CUB_200_2011/images\069.Rufous_Hummingbird/Rufous_Hummingbird_0123_58546.jpg,414,500,069.Rufous_Hummingbird,118,166,288,337,203,251,170,171
../../CUB_200_2011/images\069.Rufous_Hummingbird/Rufous_Hummingbird_0127_59587.jpg,500,333,069.Rufous_Hummingbird,52,35,446,327,249,181,394,292
../../CUB_200_2011/images\069.Rufous_Hummingbird/Rufous_Hummingbird_0116_58568.jpg,400,500,069.Rufous_Hummingbird,92,239,317,415,204,327,225,176
../../CUB_200_2011/images\069.Rufous_Hummingbird/Rufous_Hummingbird_0006_59621.jpg,500,500,069.Rufous_Hummingbird,23,74,485,453,254,263,462,379
../../CUB_200_2011/images\069.Rufous_Hummingbird/Rufous_Hummingbird_0090_58598.jpg,500,478,069.Rufous_Hummingbird,56,123,352,388,204,255,296,265
../../CUB_200_2011/images\069.Rufous_Hummingbird/Rufous_Hummingbird_0024_59636.jpg,477,500,069.Rufous_Hummingbird,94,55,354,378,224,216,260,323
../../CUB_200_2011/images\069.Rufous_Hummingbird/Rufous_Hummingbird_0046_59647.jpg,500,346,069.Rufous_Hummingbird,91,79,446,262,268,170,355,183
../../CUB_200_2011/images\069.Rufous_Hummingbird/Rufous_Hummingbird_0016_59660.jpg,500,354,069.Rufous_Hummingbird,3,54,466,353,234,203,463,299
../../CUB_200_2011/images\069.Rufous_Hummingbird/Rufous_Hummingbird_0043_58652.jpg,500,427,069.Rufous_Hummingbird,66,102,414,346,240,224,348,244
../../CUB_200_2011/images\069.Rufous_Hummingbird/Rufous_Hummingbird_0119_59681.jpg,500,344,069.Rufous_Hummingbird,34,119,270,293,152,206,236,174
../../CUB_200_2011/images\069.Rufous_Hummingbird/Rufous_Hummingbird_0091_60551.jpg,500,333,069.Rufous_Hummingbird,180,106,342,223,261,164,162,117
../../CUB_200_2011/images\069.Rufous_Hummingbird/Rufous_Hummingbird_0113_59444.jpg,495,500,069.Rufous_Hummingbird,92,11,463,385,277,198,371,374
../../CUB_200_2011/images\069.Rufous_Hummingbird/Rufous_Hummingbird_0115_59202.jpg,500,462,069.Rufous_Hummingbird,93,38,417,183,255,110,324,145
../../CUB_200_2011/images\069.Rufous_Hummingbird/Rufous_Hummingbird_0045_59533.jpg,500,453,069.Rufous_Hummingbird,13,19,489,436,251,227,476,417
../../CUB_200_2011/images\069.Rufous_Hummingbird/Rufous_Hummingbird_0075_59619.jpg,420,280,069.Rufous_Hummingbird,123,46,380,215,251,130,257,169
../../CUB_200_2011/images\069.Rufous_Hummingbird/Rufous_Hummingbird_0074_59231.jpg,477,490,069.Rufous_Hummingbird,0,30,428,463,214,246,428,433
../../CUB_200_2011/images\069.Rufous_Hummingbird/Rufous_Hummingbird_0022_58725.jpg,432,341,069.Rufous_Hummingbird,147,113,383,266,265,189,236,153
../../CUB_200_2011/images\069.Rufous_Hummingbird/Rufous_Hummingbird_0095_60360.jpg,500,304,069.Rufous_Hummingbird,77,58,411,265,244,161,334,207
../../CUB_200_2011/images\069.Rufous_Hummingbird/Rufous_Hummingbird_0128_60398.jpg,500,375,069.Rufous_Hummingbird,135,42,362,329,248,185,227,287
../../CUB_200_2011/images\069.Rufous_Hummingbird/Rufous_Hummingbird_0121_59376.jpg,500,375,069.Rufous_Hummingbird,99,45,442,367,270,206,343,322
../../CUB_200_2011/images\069.Rufous_Hummingbird/Rufous_Hummingbird_0120_59900.jpg,500,333,069.Rufous_Hummingbird,48,98,242,287,145,192,194,189
../../CUB_200_2011/images\069.Rufous_Hummingbird/Rufous_Hummingbird_0037_60415.jpg,500,300,069.Rufous_Hummingbird,160,43,402,256,281,149,242,213
../../CUB_200_2011/images\070.Green_Violetear/Green_Violetear_0041_795648.jpg,450,313,070.Green_Violetear,152,56,280,238,216,147,128,182
../../CUB_200_2011/images\070.Green_Violetear/Green_Violetear_0017_795652.jpg,500,333,070.Green_Violetear,147,37,424,309,285,173,277,272
../../CUB_200_2011/images\070.Green_Violetear/Green_Violetear_0060_795657.jpg,500,500,070.Green_Violetear,82,88,401,445,241,266,319,357
../../CUB_200_2011/images\070.Green_Violetear/Green_Violetear_0064_795661.jpg,327,500,070.Green_Violetear,25,83,214,486,119,284,189,403
../../CUB_200_2011/images\070.Green_Violetear/Green_Violetear_0003_795662.jpg,152,200,070.Green_Violetear,17,32,138,168,77,100,121,136
../../CUB_200_2011/images\070.Green_Violetear/Green_Violetear_0005_795666.jpg,500,393,070.Green_Violetear,131,55,406,315,268,185,275,260
../../CUB_200_2011/images\070.Green_Violetear/Green_Violetear_0067_795674.jpg,208,235,070.Green_Violetear,30,22,199,214,114,118,169,192
../../CUB_200_2011/images\070.Green_Violetear/Green_Violetear_0047_795677.jpg,407,500,070.Green_Violetear,90,135,389,468,239,301,299,333
../../CUB_200_2011/images\070.Green_Violetear/Green_Violetear_0073_795680.jpg,500,388,070.Green_Violetear,34,84,465,350,249,217,431,266
../../CUB_200_2011/images\070.Green_Violetear/Green_Violetear_0066_795682.jpg,500,375,070.Green_Violetear,60,75,442,283,251,179,382,208
../../CUB_200_2011/images\070.Green_Violetear/Green_Violetear_0013_795684.jpg,500,375,070.Green_Violetear,199,60,482,327,340,193,283,267
../../CUB_200_2011/images\070.Green_Violetear/Green_Violetear_0079_795685.jpg,350,350,070.Green_Violetear,48,49,272,305,160,177,224,256
../../CUB_200_2011/images\070.Green_Violetear/Green_Violetear_0025_795692.jpg,500,442,070.Green_Violetear,131,103,416,324,273,213,285,221
../../CUB_200_2011/images\070.Green_Violetear/Green_Violetear_0105_795694.jpg,500,385,070.Green_Violetear,174,106,309,334,241,220,135,228
../../CUB_200_2011/images\070.Green_Violetear/Green_Violetear_0077_795696.jpg,500,333,070.Green_Violetear,69,12,312,249,190,130,243,237
../../CUB_200_2011/images\070.Green_Violetear/Green_Violetear_0089_795698.jpg,140,200,070.Green_Violetear,16,43,123,187,69,115,107,144
../../CUB_200_2011/images\070.Green_Violetear/Green_Violetear_0002_795699.jpg,444,500,070.Green_Violetear,33,68,440,403,236,235,407,335
../../CUB_200_2011/images\070.Green_Violetear/Green_Violetear_0057_795701.jpg,396,500,070.Green_Violetear,38,24,364,480,201,252,326,456
../../CUB_200_2011/images\070.Green_Violetear/Green_Violetear_0102_795702.jpg,225,300,070.Green_Violetear,51,72,194,252,122,162,143,180
../../CUB_200_2011/images\070.Green_Violetear/Green_Violetear_0008_795703.jpg,500,326,070.Green_Violetear,114,68,350,308,232,188,236,240
../../CUB_200_2011/images\070.Green_Violetear/Green_Violetear_0092_795704.jpg,500,375,070.Green_Violetear,100,41,358,357,229,199,258,316
../../CUB_200_2011/images\070.Green_Violetear/Green_Violetear_0024_795705.jpg,150,250,070.Green_Violetear,11,17,132,237,71,127,121,220
../../CUB_200_2011/images\070.Green_Violetear/Green_Violetear_0082_795706.jpg,500,375,070.Green_Violetear,118,121,327,349,222,235,209,228
../../CUB_200_2011/images\070.Green_Violetear/Green_Violetear_0032_795707.jpg,280,457,070.Green_Violetear,12,6,266,376,139,191,254,370
../../CUB_200_2011/images\070.Green_Violetear/Green_Violetear_0108_795711.jpg,500,403,070.Green_Violetear,207,161,456,400,331,280,249,239
../../CUB_200_2011/images\070.Green_Violetear/Green_Violetear_0055_795712.jpg,460,353,070.Green_Violetear,100,58,380,338,240,198,280,280
../../CUB_200_2011/images\070.Green_Violetear/Green_Violetear_0112_795713.jpg,500,445,070.Green_Violetear,73,38,471,423,272,230,398,385
../../CUB_200_2011/images\070.Green_Violetear/Green_Violetear_0080_795716.jpg,309,400,070.Green_Violetear,25,37,293,394,159,215,268,357
../../CUB_200_2011/images\070.Green_Violetear/Green_Violetear_0044_795717.jpg,500,442,070.Green_Violetear,78,78,410,368,244,223,332,290
../../CUB_200_2011/images\070.Green_Violetear/Green_Violetear_0074_795720.jpg,325,268,070.Green_Violetear,120,47,232,203,176,125,112,156
../../CUB_200_2011/images\070.Green_Violetear/Green_Violetear_0069_795723.jpg,300,400,070.Green_Violetear,87,43,236,379,161,211,149,336
../../CUB_200_2011/images\070.Green_Violetear/Green_Violetear_0119_795724.jpg,500,375,070.Green_Violetear,144,65,471,333,307,199,327,268
../../CUB_200_2011/images\070.Green_Violetear/Green_Violetear_0030_795736.jpg,300,306,070.Green_Violetear,56,54,214,278,135,166,158,224
../../CUB_200_2011/images\070.Green_Violetear/Green_Violetear_0045_60765.jpg,500,333,070.Green_Violetear,94,42,389,324,241,183,295,282
../../CUB_200_2011/images\070.Green_Violetear/Green_Violetear_0031_60774.jpg,500,375,070.Green_Violetear,137,38,338,374,237,206,201,336
../../CUB_200_2011/images\070.Green_Violetear/Green_Violetear_0107_60781.jpg,500,375,070.Green_Violetear,80,10,320,367,200,188,240,357
../../CUB_200_2011/images\070.Green_Violetear/Green_Violetear_0048_60789.jpg,333,500,070.Green_Violetear,54,58,327,406,190,232,273,348
../../CUB_200_2011/images\070.Green_Violetear/Green_Violetear_0034_60792.jpg,479,500,070.Green_Violetear,116,112,263,373,189,242,147,261
../../CUB_200_2011/images\070.Green_Violetear/Green_Violetear_0062_60797.jpg,500,405,070.Green_Violetear,123,93,315,273,219,183,192,180
../../CUB_200_2011/images\070.Green_Violetear/Green_Violetear_0022_60799.jpg,385,500,070.Green_Violetear,27,81,315,475,171,278,288,394
../../CUB_200_2011/images\070.Green_Violetear/Green_Violetear_0028_60800.jpg,403,500,070.Green_Violetear,112,120,295,419,203,269,183,299
../../CUB_200_2011/images\070.Green_Violetear/Green_Violetear_0029_60808.jpg,354,500,070.Green_Violetear,135,120,308,471,221,295,173,351
../../CUB_200_2011/images\070.Green_Violetear/Green_Violetear_0114_60809.jpg,500,341,070.Green_Violetear,13,76,353,315,183,195,340,239
../../CUB_200_2011/images\070.Green_Violetear/Green_Violetear_0043_60813.jpg,500,333,070.Green_Violetear,132,48,303,304,217,176,171,256
../../CUB_200_2011/images\070.Green_Violetear/Green_Violetear_0027_60841.jpg,500,369,070.Green_Violetear,107,45,377,300,242,172,270,255
../../CUB_200_2011/images\070.Green_Violetear/Green_Violetear_0078_60844.jpg,500,397,070.Green_Violetear,100,56,414,365,257,210,314,309
../../CUB_200_2011/images\070.Green_Violetear/Green_Violetear_0072_60858.jpg,500,375,070.Green_Violetear,176,36,320,235,248,135,144,199
../../CUB_200_2011/images\070.Green_Violetear/Green_Violetear_0110_60866.jpg,500,332,070.Green_Violetear,128,110,367,267,247,188,239,157
../../CUB_200_2011/images\070.Green_Violetear/Green_Violetear_0059_60873.jpg,374,500,070.Green_Violetear,31,175,297,435,164,305,266,260
../../CUB_200_2011/images\070.Green_Violetear/Green_Violetear_0021_795632.jpg,500,376,070.Green_Violetear,128,36,430,327,279,181,302,291
../../CUB_200_2011/images\070.Green_Violetear/Green_Violetear_0050_795633.jpg,500,334,070.Green_Violetear,179,87,361,267,270,177,182,180
../../CUB_200_2011/images\070.Green_Violetear/Green_Violetear_0094_795634.jpg,485,441,070.Green_Violetear,12,18,468,419,240,218,456,401
../../CUB_200_2011/images\070.Green_Violetear/Green_Violetear_0036_795635.jpg,423,500,070.Green_Violetear,106,94,252,448,179,271,146,354
../../CUB_200_2011/images\070.Green_Violetear/Green_Violetear_0081_795638.jpg,390,500,070.Green_Violetear,87,74,269,412,178,243,182,338
../../CUB_200_2011/images\070.Green_Violetear/Green_Violetear_0086_795639.jpg,500,359,070.Green_Violetear,69,55,322,354,195,204,253,299
../../CUB_200_2011/images\070.Green_Violetear/Green_Violetear_0084_795641.jpg,371,500,070.Green_Violetear,103,203,304,448,203,325,201,245
../../CUB_200_2011/images\070.Green_Violetear/Green_Violetear_0106_795643.jpg,280,360,070.Green_Violetear,8,6,269,356,138,181,261,350
../../CUB_200_2011/images\070.Green_Violetear/Green_Violetear_0103_795644.jpg,333,500,070.Green_Violetear,45,102,239,459,142,280,194,357
../../CUB_200_2011/images\070.Green_Violetear/Green_Violetear_0095_795646.jpg,500,375,070.Green_Violetear,79,52,377,353,228,202,298,301
../../CUB_200_2011/images\070.Green_Violetear/Green_Violetear_0009_795647.jpg,500,334,070.Green_Violetear,107,43,257,290,182,166,150,247
../../CUB_200_2011/images\071.Long_tailed_Jaeger/Long_Tailed_Jaeger_0025_60937.jpg,500,500,071.Long_tailed_Jaeger,143,94,440,228,291,161,297,134
../../CUB_200_2011/images\071.Long_tailed_Jaeger/Long_Tailed_Jaeger_0012_797101.jpg,500,346,071.Long_tailed_Jaeger,29,80,397,224,213,152,368,144
../../CUB_200_2011/images\071.Long_tailed_Jaeger/Long_Tailed_Jaeger_0027_60950.jpg,500,331,071.Long_tailed_Jaeger,220,133,394,268,307,200,174,135
../../CUB_200_2011/images\071.Long_tailed_Jaeger/Long_Tailed_Jaeger_0033_60955.jpg,500,333,071.Long_tailed_Jaeger,122,89,445,237,283,163,323,148
../../CUB_200_2011/images\071.Long_tailed_Jaeger/Long_Tailed_Jaeger_0030_60961.jpg,416,259,071.Long_tailed_Jaeger,62,29,268,208,165,118,206,179
../../CUB_200_2011/images\071.Long_tailed_Jaeger/Long_Tailed_Jaeger_0011_60963.jpg,500,375,071.Long_tailed_Jaeger,153,104,301,220,227,162,148,116
../../CUB_200_2011/images\071.Long_tailed_Jaeger/Long_Tailed_Jaeger_0044_60968.jpg,500,420,071.Long_tailed_Jaeger,40,75,406,235,223,155,366,160
../../CUB_200_2011/images\071.Long_tailed_Jaeger/Long_Tailed_Jaeger_0019_60970.jpg,500,400,071.Long_tailed_Jaeger,76,76,388,338,232,207,312,262
../../CUB_200_2011/images\071.Long_tailed_Jaeger/Long_Tailed_Jaeger_0017_797081.jpg,500,333,071.Long_tailed_Jaeger,83,100,365,256,224,178,282,156
../../CUB_200_2011/images\071.Long_tailed_Jaeger/Long_Tailed_Jaeger_0064_60999.jpg,500,333,071.Long_tailed_Jaeger,117,55,387,256,252,155,270,201
../../CUB_200_2011/images\071.Long_tailed_Jaeger/Long_Tailed_Jaeger_0045_61007.jpg,500,357,071.Long_tailed_Jaeger,127,9,333,268,230,138,206,259
../../CUB_200_2011/images\071.Long_tailed_Jaeger/Long_Tailed_Jaeger_0065_61042.jpg,500,299,071.Long_tailed_Jaeger,87,32,256,174,171,103,169,142
../../CUB_200_2011/images\071.Long_tailed_Jaeger/Long_Tailed_Jaeger_0055_61046.jpg,500,333,071.Long_tailed_Jaeger,187,67,392,252,289,159,205,185
../../CUB_200_2011/images\071.Long_tailed_Jaeger/Long_Tailed_Jaeger_0061_61049.jpg,500,333,071.Long_tailed_Jaeger,24,128,286,255,155,191,262,127
../../CUB_200_2011/images\071.Long_tailed_Jaeger/Long_Tailed_Jaeger_0069_61060.jpg,500,334,071.Long_tailed_Jaeger,169,40,383,244,276,142,214,204
../../CUB_200_2011/images\071.Long_tailed_Jaeger/Long_Tailed_Jaeger_0001_797061.jpg,500,333,071.Long_tailed_Jaeger,46,3,499,331,272,167,453,328
../../CUB_200_2011/images\071.Long_tailed_Jaeger/Long_Tailed_Jaeger_0005_797062.jpg,500,334,071.Long_tailed_Jaeger,3,4,496,333,249,168,493,329
../../CUB_200_2011/images\071.Long_tailed_Jaeger/Long_Tailed_Jaeger_0049_797063.jpg,500,357,071.Long_tailed_Jaeger,162,90,361,225,261,157,199,135
../../CUB_200_2011/images\071.Long_tailed_Jaeger/Long_Tailed_Jaeger_0006_797065.jpg,500,342,071.Long_tailed_Jaeger,119,8,419,290,269,149,300,282
../../CUB_200_2011/images\071.Long_tailed_Jaeger/Long_Tailed_Jaeger_0008_797066.jpg,466,350,071.Long_tailed_Jaeger,31,141,372,268,201,204,341,127
../../CUB_200_2011/images\071.Long_tailed_Jaeger/Long_Tailed_Jaeger_0009_797070.jpg,500,375,071.Long_tailed_Jaeger,210,97,457,303,333,200,247,206
../../CUB_200_2011/images\071.Long_tailed_Jaeger/Long_Tailed_Jaeger_0023_797072.jpg,500,333,071.Long_tailed_Jaeger,10,86,500,219,255,152,490,133
../../CUB_200_2011/images\071.Long_tailed_Jaeger/Long_Tailed_Jaeger_0063_797073.jpg,500,332,071.Long_tailed_Jaeger,11,33,451,257,231,145,440,224
../../CUB_200_2011/images\071.Long_tailed_Jaeger/Long_Tailed_Jaeger_0022_797074.jpg,500,265,071.Long_tailed_Jaeger,75,23,491,246,283,134,416,223
../../CUB_200_2011/images\071.Long_tailed_Jaeger/Long_Tailed_Jaeger_0047_797075.jpg,328,274,071.Long_tailed_Jaeger,52,25,245,237,148,131,193,212
../../CUB_200_2011/images\071.Long_tailed_Jaeger/Long_Tailed_Jaeger_0036_797076.jpg,300,214,071.Long_tailed_Jaeger,53,1,276,212,164,106,223,211
../../CUB_200_2011/images\071.Long_tailed_Jaeger/Long_Tailed_Jaeger_0038_797077.jpg,500,374,071.Long_tailed_Jaeger,87,98,392,320,239,209,305,222
../../CUB_200_2011/images\071.Long_tailed_Jaeger/Long_Tailed_Jaeger_0059_797079.jpg,500,333,071.Long_tailed_Jaeger,168,129,340,282,254,205,172,153
../../CUB_200_2011/images\071.Long_tailed_Jaeger/Long_Tailed_Jaeger_0018_61081.jpg,500,357,071.Long_tailed_Jaeger,108,41,456,289,282,165,348,248
../../CUB_200_2011/images\071.Long_tailed_Jaeger/Long_Tailed_Jaeger_0003_61082.jpg,500,375,071.Long_tailed_Jaeger,58,223,306,326,182,274,248,103
../../CUB_200_2011/images\071.Long_tailed_Jaeger/Long_Tailed_Jaeger_0021_797083.jpg,500,372,071.Long_tailed_Jaeger,79,44,483,264,281,154,404,220
../../CUB_200_2011/images\071.Long_tailed_Jaeger/Long_Tailed_Jaeger_0020_61084.jpg,500,334,071.Long_tailed_Jaeger,49,48,226,228,137,138,177,180
../../CUB_200_2011/images\071.Long_tailed_Jaeger/Long_Tailed_Jaeger_0028_797082.jpg,500,326,071.Long_tailed_Jaeger,95,72,438,255,266,163,343,183
../../CUB_200_2011/images\071.Long_tailed_Jaeger/Long_Tailed_Jaeger_0014_797086.jpg,468,303,071.Long_tailed_Jaeger,38,70,391,255,214,162,353,185
../../CUB_200_2011/images\071.Long_tailed_Jaeger/Long_Tailed_Jaeger_0048_797087.jpg,500,375,071.Long_tailed_Jaeger,122,52,369,266,245,159,247,214
../../CUB_200_2011/images\071.Long_tailed_Jaeger/Long_Tailed_Jaeger_0054_797088.jpg,494,403,071.Long_tailed_Jaeger,39,69,392,369,215,219,353,300
../../CUB_200_2011/images\071.Long_tailed_Jaeger/Long_Tailed_Jaeger_0039_797089.jpg,400,281,071.Long_tailed_Jaeger,86,82,335,212,210,147,249,130
../../CUB_200_2011/images\071.Long_tailed_Jaeger/Long_Tailed_Jaeger_0070_797090.jpg,500,325,071.Long_tailed_Jaeger,169,86,483,248,326,167,314,162
../../CUB_200_2011/images\071.Long_tailed_Jaeger/Long_Tailed_Jaeger_0066_60921.jpg,500,406,071.Long_tailed_Jaeger,191,127,353,302,272,214,162,175
../../CUB_200_2011/images\071.Long_tailed_Jaeger/Long_Tailed_Jaeger_0056_797092.jpg,500,339,071.Long_tailed_Jaeger,136,54,440,214,288,134,304,160
../../CUB_200_2011/images\071.Long_tailed_Jaeger/Long_Tailed_Jaeger_0068_797093.jpg,438,296,071.Long_tailed_Jaeger,17,22,392,248,204,135,375,226
../../CUB_200_2011/images\071.Long_tailed_Jaeger/Long_Tailed_Jaeger_0057_797094.jpg,230,237,071.Long_tailed_Jaeger,6,25,218,215,112,120,212,190
../../CUB_200_2011/images\071.Long_tailed_Jaeger/Long_Tailed_Jaeger_0051_797095.jpg,500,434,071.Long_tailed_Jaeger,5,18,443,425,224,221,438,407
../../CUB_200_2011/images\071.Long_tailed_Jaeger/Long_Tailed_Jaeger_0016_797084.jpg,489,348,071.Long_tailed_Jaeger,42,30,446,303,244,166,404,273
../../CUB_200_2011/images\071.Long_tailed_Jaeger/Long_Tailed_Jaeger_0026_797098.jpg,300,240,071.Long_tailed_Jaeger,33,45,270,184,151,114,237,139
../../CUB_200_2011/images\071.Long_tailed_Jaeger/Long_Tailed_Jaeger_0037_797099.jpg,500,368,071.Long_tailed_Jaeger,63,12,401,343,232,177,338,331
../../CUB_200_2011/images\071.Long_tailed_Jaeger/Long_Tailed_Jaeger_0035_797100.jpg,499,336,071.Long_tailed_Jaeger,75,51,375,273,225,162,300,222
../../CUB_200_2011/images\071.Long_tailed_Jaeger/Long_Tailed_Jaeger_0029_61101.jpg,500,434,071.Long_tailed_Jaeger,16,39,366,415,191,227,350,376
../../CUB_200_2011/images\071.Long_tailed_Jaeger/Long_Tailed_Jaeger_0034_797102.jpg,500,376,071.Long_tailed_Jaeger,73,87,347,279,210,183,274,192
../../CUB_200_2011/images\071.Long_tailed_Jaeger/Long_Tailed_Jaeger_0050_797085.jpg,500,333,071.Long_tailed_Jaeger,86,62,412,298,249,180,326,236
../../CUB_200_2011/images\071.Long_tailed_Jaeger/Long_Tailed_Jaeger_0062_797104.jpg,275,183,071.Long_tailed_Jaeger,14,38,192,159,103,98,178,121
../../CUB_200_2011/images\071.Long_tailed_Jaeger/Long_Tailed_Jaeger_0046_797103.jpg,500,500,071.Long_tailed_Jaeger,75,58,343,468,209,263,268,410
../../CUB_200_2011/images\071.Long_tailed_Jaeger/Long_Tailed_Jaeger_0060_60886.jpg,500,390,071.Long_tailed_Jaeger,211,124,443,310,327,217,232,186
../../CUB_200_2011/images\071.Long_tailed_Jaeger/Long_Tailed_Jaeger_0013_60887.jpg,500,405,071.Long_tailed_Jaeger,107,124,483,330,295,227,376,206
../../CUB_200_2011/images\071.Long_tailed_Jaeger/Long_Tailed_Jaeger_0041_60891.jpg,500,404,071.Long_tailed_Jaeger,98,60,300,301,199,180,202,241
../../CUB_200_2011/images\071.Long_tailed_Jaeger/Long_Tailed_Jaeger_0010_60895.jpg,500,343,071.Long_tailed_Jaeger,48,113,334,247,191,180,286,134
../../CUB_200_2011/images\071.Long_tailed_Jaeger/Long_Tailed_Jaeger_0058_60900.jpg,500,330,071.Long_tailed_Jaeger,98,107,409,301,253,204,311,194
../../CUB_200_2011/images\071.Long_tailed_Jaeger/Long_Tailed_Jaeger_0053_60906.jpg,500,333,071.Long_tailed_Jaeger,1,0,311,331,156,165,310,331
../../CUB_200_2011/images\071.Long_tailed_Jaeger/Long_Tailed_Jaeger_0024_60915.jpg,500,269,071.Long_tailed_Jaeger,63,30,456,247,259,138,393,217
../../CUB_200_2011/images\071.Long_tailed_Jaeger/Long_Tailed_Jaeger_0032_61177.jpg,500,352,071.Long_tailed_Jaeger,107,77,392,274,249,175,285,197
../../CUB_200_2011/images\072.Pomarine_Jaeger/Pomarine_Jaeger_0038_61446.jpg,500,350,072.Pomarine_Jaeger,54,51,470,302,262,176,416,251
../../CUB_200_2011/images\072.Pomarine_Jaeger/Pomarine_Jaeger_0030_61447.jpg,500,313,072.Pomarine_Jaeger,73,53,448,282,260,167,375,229
../../CUB_200_2011/images\072.Pomarine_Jaeger/Pomarine_Jaeger_0010_61457.jpg,500,338,072.Pomarine_Jaeger,118,118,408,281,263,199,290,163
../../CUB_200_2011/images\072.Pomarine_Jaeger/Pomarine_Jaeger_0008_61231.jpg,500,360,072.Pomarine_Jaeger,134,134,406,238,270,186,272,104
../../CUB_200_2011/images\072.Pomarine_Jaeger/Pomarine_Jaeger_0034_61247.jpg,500,336,072.Pomarine_Jaeger,98,96,363,254,230,175,265,158
../../CUB_200_2011/images\072.Pomarine_Jaeger/Pomarine_Jaeger_0024_61281.jpg,500,333,072.Pomarine_Jaeger,81,154,451,290,266,222,370,136
../../CUB_200_2011/images\072.Pomarine_Jaeger/Pomarine_Jaeger_0026_61273.jpg,500,423,072.Pomarine_Jaeger,231,34,415,337,323,185,184,303
../../CUB_200_2011/images\072.Pomarine_Jaeger/Pomarine_Jaeger_0051_795738.jpg,500,400,072.Pomarine_Jaeger,56,54,458,374,257,214,402,320
../../CUB_200_2011/images\072.Pomarine_Jaeger/Pomarine_Jaeger_0077_795739.jpg,450,300,072.Pomarine_Jaeger,33,85,428,214,230,149,395,129
../../CUB_200_2011/images\072.Pomarine_Jaeger/Pomarine_Jaeger_0009_795740.jpg,288,288,072.Pomarine_Jaeger,53,44,222,212,137,128,169,168
../../CUB_200_2011/images\072.Pomarine_Jaeger/Pomarine_Jaeger_0072_795743.jpg,500,375,072.Pomarine_Jaeger,68,54,408,290,238,172,340,236
../../CUB_200_2011/images\072.Pomarine_Jaeger/Pomarine_Jaeger_0058_795746.jpg,500,375,072.Pomarine_Jaeger,180,81,472,325,326,203,292,244
../../CUB_200_2011/images\072.Pomarine_Jaeger/Pomarine_Jaeger_0022_795747.jpg,500,333,072.Pomarine_Jaeger,61,34,246,311,153,172,185,277
../../CUB_200_2011/images\072.Pomarine_Jaeger/Pomarine_Jaeger_0033_795749.jpg,500,334,072.Pomarine_Jaeger,36,40,272,305,154,172,236,265
../../CUB_200_2011/images\072.Pomarine_Jaeger/Pomarine_Jaeger_0045_795750.jpg,375,500,072.Pomarine_Jaeger,75,105,306,443,190,274,231,338
../../CUB_200_2011/images\072.Pomarine_Jaeger/Pomarine_Jaeger_0080_795751.jpg,500,405,072.Pomarine_Jaeger,45,89,496,356,270,222,451,267
../../CUB_200_2011/images\072.Pomarine_Jaeger/Pomarine_Jaeger_0042_795755.jpg,500,398,072.Pomarine_Jaeger,60,49,476,333,268,191,416,284
../../CUB_200_2011/images\072.Pomarine_Jaeger/Pomarine_Jaeger_0060_795756.jpg,500,356,072.Pomarine_Jaeger,62,50,455,300,258,175,393,250
../../CUB_200_2011/images\072.Pomarine_Jaeger/Pomarine_Jaeger_0078_795758.jpg,459,310,072.Pomarine_Jaeger,41,31,378,289,209,160,337,258
../../CUB_200_2011/images\072.Pomarine_Jaeger/Pomarine_Jaeger_0013_795759.jpg,500,309,072.Pomarine_Jaeger,81,61,334,287,207,174,253,226
../../CUB_200_2011/images\072.Pomarine_Jaeger/Pomarine_Jaeger_0020_795761.jpg,333,500,072.Pomarine_Jaeger,46,58,294,392,170,225,248,334
../../CUB_200_2011/images\072.Pomarine_Jaeger/Pomarine_Jaeger_0055_795762.jpg,500,333,072.Pomarine_Jaeger,143,28,395,269,269,148,252,241
../../CUB_200_2011/images\072.Pomarine_Jaeger/Pomarine_Jaeger_0007_795764.jpg,250,120,072.Pomarine_Jaeger,5,13,216,116,110,64,211,103
../../CUB_200_2011/images\072.Pomarine_Jaeger/Pomarine_Jaeger_0046_61301.jpg,500,333,072.Pomarine_Jaeger,184,18,325,309,254,163,141,291
../../CUB_200_2011/images\072.Pomarine_Jaeger/Pomarine_Jaeger_0027_795767.jpg,500,400,072.Pomarine_Jaeger,23,67,438,297,230,182,415,230
../../CUB_200_2011/images\072.Pomarine_Jaeger/Pomarine_Jaeger_0071_795769.jpg,480,371,072.Pomarine_Jaeger,73,76,266,285,169,180,193,209
../../CUB_200_2011/images\072.Pomarine_Jaeger/Pomarine_Jaeger_0056_795770.jpg,500,343,072.Pomarine_Jaeger,154,80,301,211,227,145,147,131
../../CUB_200_2011/images\072.Pomarine_Jaeger/Pomarine_Jaeger_0048_795771.jpg,500,350,072.Pomarine_Jaeger,76,67,460,329,268,198,384,262
../../CUB_200_2011/images\072.Pomarine_Jaeger/Pomarine_Jaeger_0001_795772.jpg,500,375,072.Pomarine_Jaeger,74,28,446,314,260,171,372,286
../../CUB_200_2011/images\072.Pomarine_Jaeger/Pomarine_Jaeger_0012_795773.jpg,500,334,072.Pomarine_Jaeger,146,11,464,285,305,148,318,274
../../CUB_200_2011/images\072.Pomarine_Jaeger/Pomarine_Jaeger_0006_795775.jpg,500,371,072.Pomarine_Jaeger,35,118,492,291,263,204,457,173
../../CUB_200_2011/images\072.Pomarine_Jaeger/Pomarine_Jaeger_0021_795776.jpg,500,357,072.Pomarine_Jaeger,78,60,412,297,245,178,334,237
../../CUB_200_2011/images\072.Pomarine_Jaeger/Pomarine_Jaeger_0011_795777.jpg,437,374,072.Pomarine_Jaeger,28,27,396,334,212,180,368,307
../../CUB_200_2011/images\072.Pomarine_Jaeger/Pomarine_Jaeger_0003_795778.jpg,300,400,072.Pomarine_Jaeger,43,17,274,355,158,186,231,338
../../CUB_200_2011/images\072.Pomarine_Jaeger/Pomarine_Jaeger_0066_795780.jpg,500,362,072.Pomarine_Jaeger,193,150,353,262,273,206,160,112
../../CUB_200_2011/images\072.Pomarine_Jaeger/Pomarine_Jaeger_0017_795782.jpg,500,339,072.Pomarine_Jaeger,157,34,447,288,302,161,290,254
../../CUB_200_2011/images\072.Pomarine_Jaeger/Pomarine_Jaeger_0061_795788.jpg,500,375,072.Pomarine_Jaeger,146,28,386,286,266,157,240,258
../../CUB_200_2011/images\072.Pomarine_Jaeger/Pomarine_Jaeger_0032_795789.jpg,327,327,072.Pomarine_Jaeger,9,33,314,284,161,158,305,251
../../CUB_200_2011/images\072.Pomarine_Jaeger/Pomarine_Jaeger_0054_795791.jpg,500,339,072.Pomarine_Jaeger,131,47,317,312,224,179,186,265
../../CUB_200_2011/images\072.Pomarine_Jaeger/Pomarine_Jaeger_0053_795792.jpg,500,335,072.Pomarine_Jaeger,83,20,429,269,256,144,346,249
../../CUB_200_2011/images\072.Pomarine_Jaeger/Pomarine_Jaeger_0049_795795.jpg,486,315,072.Pomarine_Jaeger,96,94,244,197,170,145,148,103
../../CUB_200_2011/images\072.Pomarine_Jaeger/Pomarine_Jaeger_0004_795796.jpg,500,325,072.Pomarine_Jaeger,179,103,421,264,300,183,242,161
../../CUB_200_2011/images\072.Pomarine_Jaeger/Pomarine_Jaeger_0028_795797.jpg,315,275,072.Pomarine_Jaeger,20,7,238,215,129,111,218,208
../../CUB_200_2011/images\072.Pomarine_Jaeger/Pomarine_Jaeger_0014_61335.jpg,500,352,072.Pomarine_Jaeger,64,81,291,303,177,192,227,222
../../CUB_200_2011/images\072.Pomarine_Jaeger/Pomarine_Jaeger_0073_795800.jpg,500,334,072.Pomarine_Jaeger,147,77,433,235,290,156,286,158
../../CUB_200_2011/images\072.Pomarine_Jaeger/Pomarine_Jaeger_0059_61347.jpg,500,399,072.Pomarine_Jaeger,198,53,412,275,305,164,214,222
../../CUB_200_2011/images\072.Pomarine_Jaeger/Pomarine_Jaeger_0039_61348.jpg,500,343,072.Pomarine_Jaeger,65,83,359,275,212,179,294,192
../../CUB_200_2011/images\072.Pomarine_Jaeger/Pomarine_Jaeger_0075_61349.jpg,500,333,072.Pomarine_Jaeger,112,29,273,313,192,171,161,284
../../CUB_200_2011/images\072.Pomarine_Jaeger/Pomarine_Jaeger_0062_61351.jpg,500,399,072.Pomarine_Jaeger,88,84,301,334,194,209,213,250
../../CUB_200_2011/images\072.Pomarine_Jaeger/Pomarine_Jaeger_0002_61361.jpg,500,333,072.Pomarine_Jaeger,187,82,396,211,291,146,209,129
../../CUB_200_2011/images\072.Pomarine_Jaeger/Pomarine_Jaeger_0029_61365.jpg,420,280,072.Pomarine_Jaeger,146,50,312,194,229,122,166,144
../../CUB_200_2011/images\072.Pomarine_Jaeger/Pomarine_Jaeger_0079_61370.jpg,500,333,072.Pomarine_Jaeger,125,75,441,222,283,148,316,147
../../CUB_200_2011/images\072.Pomarine_Jaeger/Pomarine_Jaeger_0069_61381.jpg,500,318,072.Pomarine_Jaeger,141,75,394,254,267,164,253,179
../../CUB_200_2011/images\072.Pomarine_Jaeger/Pomarine_Jaeger_0043_61384.jpg,500,335,072.Pomarine_Jaeger,0,41,431,333,215,187,431,292
../../CUB_200_2011/images\072.Pomarine_Jaeger/Pomarine_Jaeger_0041_61305.jpg,411,500,072.Pomarine_Jaeger,100,101,327,420,213,260,227,319
../../CUB_200_2011/images\072.Pomarine_Jaeger/Pomarine_Jaeger_0063_61406.jpg,500,350,072.Pomarine_Jaeger,165,92,320,235,242,163,155,143
../../CUB_200_2011/images\072.Pomarine_Jaeger/Pomarine_Jaeger_0036_61410.jpg,411,500,072.Pomarine_Jaeger,72,23,340,483,206,253,268,460
../../CUB_200_2011/images\072.Pomarine_Jaeger/Pomarine_Jaeger_0031_61420.jpg,500,351,072.Pomarine_Jaeger,102,53,291,227,196,140,189,174
../../CUB_200_2011/images\072.Pomarine_Jaeger/Pomarine_Jaeger_0015_61429.jpg,500,333,072.Pomarine_Jaeger,116,39,432,271,274,155,316,232
../../CUB_200_2011/images\072.Pomarine_Jaeger/Pomarine_Jaeger_0023_61431.jpg,500,339,072.Pomarine_Jaeger,124,19,390,257,257,138,266,238
../../CUB_200_2011/images\073.Blue_Jay/Blue_Jay_0015_62916.jpg,500,309,073.Blue_Jay,88,32,475,286,281,159,387,254
../../CUB_200_2011/images\073.Blue_Jay/Blue_Jay_0033_62024.jpg,421,500,073.Blue_Jay,44,87,284,382,164,234,240,295
../../CUB_200_2011/images\073.Blue_Jay/Blue_Jay_0052_63148.jpg,500,393,073.Blue_Jay,165,30,471,271,318,150,306,241
../../CUB_200_2011/images\073.Blue_Jay/Blue_Jay_0006_63504.jpg,500,333,073.Blue_Jay,201,65,347,210,274,137,146,145
../../CUB_200_2011/images\073.Blue_Jay/Blue_Jay_0095_63505.jpg,500,333,073.Blue_Jay,133,17,417,325,275,171,284,308
../../CUB_200_2011/images\073.Blue_Jay/Blue_Jay_0081_61714.jpg,500,333,073.Blue_Jay,153,61,394,247,273,154,241,186
../../CUB_200_2011/images\073.Blue_Jay/Blue_Jay_0013_61463.jpg,500,472,073.Blue_Jay,97,95,500,471,298,283,403,376
../../CUB_200_2011/images\073.Blue_Jay/Blue_Jay_0053_62744.jpg,500,408,073.Blue_Jay,61,81,473,368,267,224,412,287
../../CUB_200_2011/images\073.Blue_Jay/Blue_Jay_0056_61723.jpg,400,500,073.Blue_Jay,18,110,343,468,180,289,325,358
../../CUB_200_2011/images\073.Blue_Jay/Blue_Jay_0088_63264.jpg,500,335,073.Blue_Jay,222,54,414,289,318,171,192,235
../../CUB_200_2011/images\073.Blue_Jay/Blue_Jay_0044_62759.jpg,500,333,073.Blue_Jay,69,68,298,309,183,188,229,241
../../CUB_200_2011/images\073.Blue_Jay/Blue_Jay_0075_63021.jpg,500,375,073.Blue_Jay,78,8,404,375,241,191,326,367
../../CUB_200_2011/images\073.Blue_Jay/Blue_Jay_0066_61490.jpg,500,447,073.Blue_Jay,139,95,369,429,254,262,230,334
../../CUB_200_2011/images\073.Blue_Jay/Blue_Jay_0083_61492.jpg,402,500,073.Blue_Jay,27,28,373,355,200,191,346,327
../../CUB_200_2011/images\073.Blue_Jay/Blue_Jay_0102_61494.jpg,460,500,073.Blue_Jay,106,125,340,444,223,284,234,319
../../CUB_200_2011/images\073.Blue_Jay/Blue_Jay_0012_63753.jpg,500,360,073.Blue_Jay,4,63,386,360,195,211,382,297
../../CUB_200_2011/images\073.Blue_Jay/Blue_Jay_0082_62524.jpg,500,313,073.Blue_Jay,146,12,419,302,282,157,273,290
../../CUB_200_2011/images\073.Blue_Jay/Blue_Jay_0038_62784.jpg,480,500,073.Blue_Jay,206,118,448,463,327,290,242,345
../../CUB_200_2011/images\073.Blue_Jay/Blue_Jay_0055_61507.jpg,500,333,073.Blue_Jay,41,26,460,332,250,179,419,306
../../CUB_200_2011/images\073.Blue_Jay/Blue_Jay_0035_63560.jpg,500,342,073.Blue_Jay,73,88,428,242,250,165,355,154
../../CUB_200_2011/images\073.Blue_Jay/Blue_Jay_0096_63330.jpg,500,389,073.Blue_Jay,57,81,342,303,199,192,285,222
../../CUB_200_2011/images\073.Blue_Jay/Blue_Jay_0089_61521.jpg,480,500,073.Blue_Jay,172,264,367,364,269,314,195,100
../../CUB_200_2011/images\073.Blue_Jay/Blue_Jay_0022_63074.jpg,500,413,073.Blue_Jay,97,43,305,366,201,204,208,323
../../CUB_200_2011/images\073.Blue_Jay/Blue_Jay_0068_61543.jpg,500,415,073.Blue_Jay,219,54,483,274,351,164,264,220
../../CUB_200_2011/images\073.Blue_Jay/Blue_Jay_0042_61545.jpg,500,426,073.Blue_Jay,184,91,300,288,242,189,116,197
../../CUB_200_2011/images\073.Blue_Jay/Blue_Jay_0060_62570.jpg,500,400,073.Blue_Jay,47,110,419,395,233,252,372,285
../../CUB_200_2011/images\073.Blue_Jay/Blue_Jay_0051_63339.jpg,500,421,073.Blue_Jay,11,56,358,391,184,223,347,335
../../CUB_200_2011/images\073.Blue_Jay/Blue_Jay_0028_63599.jpg,500,375,073.Blue_Jay,88,99,295,237,191,168,207,138
../../CUB_200_2011/images\073.Blue_Jay/Blue_Jay_0020_63604.jpg,500,316,073.Blue_Jay,234,121,364,302,299,211,130,181
../../CUB_200_2011/images\073.Blue_Jay/Blue_Jay_0036_61560.jpg,404,500,073.Blue_Jay,133,70,346,364,239,217,213,294
../../CUB_200_2011/images\073.Blue_Jay/Blue_Jay_0062_62585.jpg,500,335,073.Blue_Jay,134,88,427,310,280,199,293,222
../../CUB_200_2011/images\073.Blue_Jay/Blue_Jay_0049_63082.jpg,328,500,073.Blue_Jay,62,100,247,362,154,231,185,262
../../CUB_200_2011/images\073.Blue_Jay/Blue_Jay_0085_62831.jpg,500,400,073.Blue_Jay,45,112,259,359,152,235,214,247
../../CUB_200_2011/images\073.Blue_Jay/Blue_Jay_0017_62854.jpg,500,401,073.Blue_Jay,107,54,442,304,274,179,335,250
../../CUB_200_2011/images\073.Blue_Jay/Blue_Jay_0031_62913.jpg,500,384,073.Blue_Jay,268,22,403,367,335,194,135,345
../../CUB_200_2011/images\073.Blue_Jay/Blue_Jay_0078_62351.jpg,500,375,073.Blue_Jay,177,89,492,373,334,231,315,284
../../CUB_200_2011/images\073.Blue_Jay/Blue_Jay_0009_62873.jpg,500,312,073.Blue_Jay,44,45,312,188,178,116,268,143
../../CUB_200_2011/images\073.Blue_Jay/Blue_Jay_0027_63133.jpg,500,414,073.Blue_Jay,17,94,464,329,240,211,447,235
../../CUB_200_2011/images\073.Blue_Jay/Blue_Jay_0079_62626.jpg,500,357,073.Blue_Jay,27,28,480,293,253,160,453,265
../../CUB_200_2011/images\073.Blue_Jay/Blue_Jay_0010_61939.jpg,500,351,073.Blue_Jay,184,79,331,321,257,200,147,242
../../CUB_200_2011/images\073.Blue_Jay/Blue_Jay_0011_63660.jpg,500,330,073.Blue_Jay,105,15,360,320,232,167,255,305
../../CUB_200_2011/images\073.Blue_Jay/Blue_Jay_0061_63645.jpg,500,333,073.Blue_Jay,14,70,431,225,222,147,417,155
../../CUB_200_2011/images\073.Blue_Jay/Blue_Jay_0003_63408.jpg,500,332,073.Blue_Jay,0,49,304,331,152,190,304,282
../../CUB_200_2011/images\073.Blue_Jay/Blue_Jay_0080_61617.jpg,500,401,073.Blue_Jay,46,73,308,304,177,188,262,231
../../CUB_200_2011/images\073.Blue_Jay/Blue_Jay_0099_64435.jpg,500,400,073.Blue_Jay,91,44,387,324,239,184,296,280
../../CUB_200_2011/images\073.Blue_Jay/Blue_Jay_0024_63167.jpg,333,500,073.Blue_Jay,62,123,313,407,187,265,251,284
../../CUB_200_2011/images\073.Blue_Jay/Blue_Jay_0002_62657.jpg,500,400,073.Blue_Jay,147,125,348,328,247,226,201,203
../../CUB_200_2011/images\073.Blue_Jay/Blue_Jay_0070_63684.jpg,500,375,073.Blue_Jay,212,134,437,253,324,193,225,119
../../CUB_200_2011/images\073.Blue_Jay/Blue_Jay_0101_62882.jpg,500,366,073.Blue_Jay,14,91,482,351,248,221,468,260
../../CUB_200_2011/images\073.Blue_Jay/Blue_Jay_0092_61654.jpg,500,330,073.Blue_Jay,3,53,430,312,216,182,427,259
../../CUB_200_2011/images\073.Blue_Jay/Blue_Jay_0076_61817.jpg,500,337,073.Blue_Jay,141,33,314,305,227,169,173,272
../../CUB_200_2011/images\073.Blue_Jay/Blue_Jay_0054_61656.jpg,500,468,073.Blue_Jay,178,114,297,278,237,196,119,164
../../CUB_200_2011/images\073.Blue_Jay/Blue_Jay_0018_63455.jpg,500,335,073.Blue_Jay,93,91,300,320,196,205,207,229
../../CUB_200_2011/images\073.Blue_Jay/Blue_Jay_0072_62944.jpg,500,468,073.Blue_Jay,73,99,393,332,233,215,320,233
../../CUB_200_2011/images\073.Blue_Jay/Blue_Jay_0048_62433.jpg,500,393,073.Blue_Jay,204,60,494,343,349,201,290,283
../../CUB_200_2011/images\073.Blue_Jay/Blue_Jay_0094_62698.jpg,500,369,073.Blue_Jay,55,89,396,282,225,185,341,193
../../CUB_200_2011/images\073.Blue_Jay/Blue_Jay_0029_62199.jpg,386,500,073.Blue_Jay,55,1,338,418,196,209,283,417
../../CUB_200_2011/images\073.Blue_Jay/Blue_Jay_0086_63394.jpg,500,495,073.Blue_Jay,125,72,413,411,269,241,288,339
../../CUB_200_2011/images\073.Blue_Jay/Blue_Jay_0050_62974.jpg,500,355,073.Blue_Jay,22,82,373,340,197,211,351,258
../../CUB_200_2011/images\073.Blue_Jay/Blue_Jay_0074_63487.jpg,375,500,073.Blue_Jay,111,270,306,423,208,346,195,153
../../CUB_200_2011/images\074.Florida_Jay/Florida_Jay_0037_64515.jpg,311,500,074.Florida_Jay,48,18,264,486,156,252,216,468
../../CUB_200_2011/images\074.Florida_Jay/Florida_Jay_0105_64522.jpg,333,500,074.Florida_Jay,47,61,249,441,148,251,202,380
../../CUB_200_2011/images\074.Florida_Jay/Florida_Jay_0003_65036.jpg,500,447,074.Florida_Jay,181,62,369,377,275,219,188,315
../../CUB_200_2011/images\074.Florida_Jay/Florida_Jay_0063_64781.jpg,500,375,074.Florida_Jay,242,50,350,294,296,172,108,244
../../CUB_200_2011/images\074.Florida_Jay/Florida_Jay_0004_65042.jpg,333,500,074.Florida_Jay,96,127,268,418,182,272,172,291
../../CUB_200_2011/images\074.Florida_Jay/Florida_Jay_0086_65025.jpg,500,389,074.Florida_Jay,20,88,416,320,218,204,396,232
../../CUB_200_2011/images\074.Florida_Jay/Florida_Jay_0054_65046.jpg,357,500,074.Florida_Jay,67,114,310,451,188,282,243,337
../../CUB_200_2011/images\074.Florida_Jay/Florida_Jay_0103_64537.jpg,500,333,074.Florida_Jay,84,67,324,279,204,173,240,212
../../CUB_200_2011/images\074.Florida_Jay/Florida_Jay_0016_65051.jpg,500,375,074.Florida_Jay,28,114,340,342,184,228,312,228
../../CUB_200_2011/images\074.Florida_Jay/Florida_Jay_0109_64558.jpg,500,404,074.Florida_Jay,20,48,435,378,227,213,415,330
../../CUB_200_2011/images\074.Florida_Jay/Florida_Jay_0039_64576.jpg,500,333,074.Florida_Jay,126,13,498,331,312,172,372,318
../../CUB_200_2011/images\074.Florida_Jay/Florida_Jay_0075_65093.jpg,369,500,074.Florida_Jay,82,60,218,466,150,263,136,406
../../CUB_200_2011/images\074.Florida_Jay/Florida_Jay_0071_64993.jpg,399,500,074.Florida_Jay,115,76,302,475,208,275,187,399
../../CUB_200_2011/images\074.Florida_Jay/Florida_Jay_0061_65097.jpg,386,500,074.Florida_Jay,153,146,363,407,258,276,210,261
../../CUB_200_2011/images\074.Florida_Jay/Florida_Jay_0050_65099.jpg,500,333,074.Florida_Jay,105,72,430,332,267,202,325,260
../../CUB_200_2011/images\074.Florida_Jay/Florida_Jay_0018_64994.jpg,500,334,074.Florida_Jay,76,66,370,298,223,182,294,232
../../CUB_200_2011/images\074.Florida_Jay/Florida_Jay_0036_65107.jpg,500,375,074.Florida_Jay,42,70,321,374,181,222,279,304
../../CUB_200_2011/images\074.Florida_Jay/Florida_Jay_0083_64599.jpg,500,333,074.Florida_Jay,33,51,441,306,237,178,408,255
../../CUB_200_2011/images\074.Florida_Jay/Florida_Jay_0029_65114.jpg,500,460,074.Florida_Jay,142,99,336,289,239,194,194,190
../../CUB_200_2011/images\074.Florida_Jay/Florida_Jay_0081_64859.jpg,451,500,074.Florida_Jay,79,137,404,355,241,246,325,218
../../CUB_200_2011/images\074.Florida_Jay/Florida_Jay_0110_64605.jpg,500,377,074.Florida_Jay,157,56,293,363,225,209,136,307
../../CUB_200_2011/images\074.Florida_Jay/Florida_Jay_0085_65129.jpg,500,375,074.Florida_Jay,205,124,337,364,271,244,132,240
../../CUB_200_2011/images\074.Florida_Jay/Florida_Jay_0104_64885.jpg,500,333,074.Florida_Jay,45,94,326,291,185,192,281,197
../../CUB_200_2011/images\074.Florida_Jay/Florida_Jay_0012_64887.jpg,500,375,074.Florida_Jay,153,111,421,374,287,242,268,263
../../CUB_200_2011/images\074.Florida_Jay/Florida_Jay_0052_64633.jpg,500,409,074.Florida_Jay,46,43,468,393,257,218,422,350
../../CUB_200_2011/images\074.Florida_Jay/Florida_Jay_0088_65147.jpg,500,333,074.Florida_Jay,83,89,312,222,197,155,229,133
../../CUB_200_2011/images\074.Florida_Jay/Florida_Jay_0047_65088.jpg,333,500,074.Florida_Jay,46,125,206,499,126,312,160,374
../../CUB_200_2011/images\074.Florida_Jay/Florida_Jay_0100_64645.jpg,500,369,074.Florida_Jay,193,72,431,338,312,205,238,266
../../CUB_200_2011/images\074.Florida_Jay/Florida_Jay_0097_64906.jpg,416,500,074.Florida_Jay,70,115,329,465,199,290,259,350
../../CUB_200_2011/images\074.Florida_Jay/Florida_Jay_0111_64651.jpg,500,323,074.Florida_Jay,157,59,361,261,259,160,204,202
../../CUB_200_2011/images\074.Florida_Jay/Florida_Jay_0011_64920.jpg,373,500,074.Florida_Jay,47,50,259,468,153,259,212,418
../../CUB_200_2011/images\074.Florida_Jay/Florida_Jay_0044_64664.jpg,500,333,074.Florida_Jay,12,37,361,319,186,178,349,282
../../CUB_200_2011/images\074.Florida_Jay/Florida_Jay_0092_64924.jpg,429,481,074.Florida_Jay,83,116,198,217,140,166,115,101
../../CUB_200_2011/images\074.Florida_Jay/Florida_Jay_0025_64673.jpg,500,333,074.Florida_Jay,161,55,410,294,285,174,249,239
../../CUB_200_2011/images\074.Florida_Jay/Florida_Jay_0093_64675.jpg,500,479,074.Florida_Jay,44,54,377,458,210,256,333,404
../../CUB_200_2011/images\074.Florida_Jay/Florida_Jay_0026_64938.jpg,332,500,074.Florida_Jay,87,150,260,399,173,274,173,249
../../CUB_200_2011/images\074.Florida_Jay/Florida_Jay_0005_64940.jpg,458,500,074.Florida_Jay,107,97,429,491,268,294,322,394
../../CUB_200_2011/images\074.Florida_Jay/Florida_Jay_0027_64689.jpg,500,333,074.Florida_Jay,92,93,348,318,220,205,256,225
../../CUB_200_2011/images\074.Florida_Jay/Florida_Jay_0078_64692.jpg,500,357,074.Florida_Jay,10,71,377,343,193,207,367,272
../../CUB_200_2011/images\074.Florida_Jay/Florida_Jay_0108_64694.jpg,500,375,074.Florida_Jay,147,89,360,235,253,162,213,146
../../CUB_200_2011/images\074.Florida_Jay/Florida_Jay_0021_64698.jpg,500,333,074.Florida_Jay,127,89,323,230,225,159,196,141
../../CUB_200_2011/images\074.Florida_Jay/Florida_Jay_0013_64706.jpg,500,375,074.Florida_Jay,161,60,371,374,266,217,210,314
../../CUB_200_2011/images\074.Florida_Jay/Florida_Jay_0095_64707.jpg,500,408,074.Florida_Jay,122,261,288,361,205,311,166,100
../../CUB_200_2011/images\074.Florida_Jay/Florida_Jay_0007_64708.jpg,500,333,074.Florida_Jay,191,47,482,196,336,121,291,149
../../CUB_200_2011/images\074.Florida_Jay/Florida_Jay_0053_64966.jpg,500,375,074.Florida_Jay,194,8,351,374,272,191,157,366
../../CUB_200_2011/images\074.Florida_Jay/Florida_Jay_0079_64713.jpg,393,500,074.Florida_Jay,197,82,346,239,271,160,149,157
../../CUB_200_2011/images\074.Florida_Jay/Florida_Jay_0035_64463.jpg,500,400,074.Florida_Jay,133,75,499,399,316,237,366,324
../../CUB_200_2011/images\074.Florida_Jay/Florida_Jay_0009_64723.jpg,400,500,074.Florida_Jay,149,112,315,372,232,242,166,260
../../CUB_200_2011/images\074.Florida_Jay/Florida_Jay_0080_64505.jpg,500,375,074.Florida_Jay,32,48,236,336,134,192,204,288
../../CUB_200_2011/images\074.Florida_Jay/Florida_Jay_0002_64476.jpg,500,336,074.Florida_Jay,29,110,391,314,210,212,362,204
../../CUB_200_2011/images\074.Florida_Jay/Florida_Jay_0041_64734.jpg,500,363,074.Florida_Jay,74,78,443,305,258,191,369,227
../../CUB_200_2011/images\074.Florida_Jay/Florida_Jay_0099_64735.jpg,500,333,074.Florida_Jay,50,83,336,275,193,179,286,192
../../CUB_200_2011/images\074.Florida_Jay/Florida_Jay_0008_64482.jpg,323,500,074.Florida_Jay,114,101,299,499,206,300,185,398
../../CUB_200_2011/images\074.Florida_Jay/Florida_Jay_0065_64739.jpg,500,333,074.Florida_Jay,104,116,271,246,187,181,167,130
../../CUB_200_2011/images\074.Florida_Jay/Florida_Jay_0062_64996.jpg,500,333,074.Florida_Jay,127,47,499,332,313,189,372,285
../../CUB_200_2011/images\074.Florida_Jay/Florida_Jay_0058_64997.jpg,500,375,074.Florida_Jay,179,60,330,333,254,196,151,273
../../CUB_200_2011/images\074.Florida_Jay/Florida_Jay_0046_64488.jpg,500,444,074.Florida_Jay,58,9,380,442,219,225,322,433
../../CUB_200_2011/images\074.Florida_Jay/Florida_Jay_0073_64896.jpg,500,375,074.Florida_Jay,105,36,405,371,255,203,300,335
../../CUB_200_2011/images\074.Florida_Jay/Florida_Jay_0017_65017.jpg,500,333,074.Florida_Jay,32,35,327,330,179,182,295,295
../../CUB_200_2011/images\074.Florida_Jay/Florida_Jay_0066_65018.jpg,500,407,074.Florida_Jay,169,37,451,405,310,221,282,368
../../CUB_200_2011/images\075.Green_Jay/Green_Jay_0041_65548.jpg,299,194,075.Green_Jay,50,10,253,177,151,93,203,167
../../CUB_200_2011/images\075.Green_Jay/Green_Jay_0064_65552.jpg,500,333,075.Green_Jay,195,94,338,310,266,202,143,216
../../CUB_200_2011/images\075.Green_Jay/Green_Jay_0089_66075.jpg,500,375,075.Green_Jay,152,155,443,265,297,210,291,110
../../CUB_200_2011/images\075.Green_Jay/Green_Jay_0121_65564.jpg,500,333,075.Green_Jay,172,75,312,290,242,182,140,215
../../CUB_200_2011/images\075.Green_Jay/Green_Jay_0085_66077.jpg,333,500,075.Green_Jay,87,98,242,358,164,228,155,260
../../CUB_200_2011/images\075.Green_Jay/Green_Jay_0059_65586.jpg,500,386,075.Green_Jay,75,57,408,351,241,204,333,294
../../CUB_200_2011/images\075.Green_Jay/Green_Jay_0126_65716.jpg,500,333,075.Green_Jay,152,122,315,270,233,196,163,148
../../CUB_200_2011/images\075.Green_Jay/Green_Jay_0049_65600.jpg,373,500,075.Green_Jay,53,30,270,458,161,244,217,428
../../CUB_200_2011/images\075.Green_Jay/Green_Jay_0039_66118.jpg,500,379,075.Green_Jay,72,130,336,315,204,222,264,185
../../CUB_200_2011/images\075.Green_Jay/Green_Jay_0128_65629.jpg,500,333,075.Green_Jay,71,59,297,306,184,182,226,247
../../CUB_200_2011/images\075.Green_Jay/Green_Jay_0029_65637.jpg,320,240,075.Green_Jay,0,62,192,236,96,149,192,174
../../CUB_200_2011/images\075.Green_Jay/Green_Jay_0020_66168.jpg,500,333,075.Green_Jay,118,29,499,331,308,180,381,302
../../CUB_200_2011/images\075.Green_Jay/Green_Jay_0036_65660.jpg,332,500,075.Green_Jay,1,187,206,499,103,343,205,312
../../CUB_200_2011/images\075.Green_Jay/Green_Jay_0052_66174.jpg,500,384,075.Green_Jay,75,143,310,333,192,238,235,190
../../CUB_200_2011/images\075.Green_Jay/Green_Jay_0129_65680.jpg,448,336,075.Green_Jay,181,74,336,335,258,204,155,261
../../CUB_200_2011/images\075.Green_Jay/Green_Jay_0075_65701.jpg,437,500,075.Green_Jay,111,174,372,460,241,317,261,286
../../CUB_200_2011/images\075.Green_Jay/Green_Jay_0038_65702.jpg,500,322,075.Green_Jay,140,22,390,310,265,166,250,288
../../CUB_200_2011/images\075.Green_Jay/Green_Jay_0044_66228.jpg,500,339,075.Green_Jay,193,51,369,311,281,181,176,260
../../CUB_200_2011/images\075.Green_Jay/Green_Jay_0028_65719.jpg,420,280,075.Green_Jay,60,56,301,205,180,130,241,149
../../CUB_200_2011/images\075.Green_Jay/Green_Jay_0077_65736.jpg,500,333,075.Green_Jay,220,145,400,249,310,197,180,104
../../CUB_200_2011/images\075.Green_Jay/Green_Jay_0118_66251.jpg,500,375,075.Green_Jay,2,31,440,370,221,200,438,339
../../CUB_200_2011/images\075.Green_Jay/Green_Jay_0042_65740.jpg,500,333,075.Green_Jay,103,13,339,329,221,171,236,316
../../CUB_200_2011/images\075.Green_Jay/Green_Jay_0115_65745.jpg,250,153,075.Green_Jay,92,23,198,141,145,82,106,118
../../CUB_200_2011/images\075.Green_Jay/Green_Jay_0047_65757.jpg,333,500,075.Green_Jay,95,112,287,474,191,293,192,362
../../CUB_200_2011/images\075.Green_Jay/Green_Jay_0003_65767.jpg,500,332,075.Green_Jay,104,114,362,279,233,196,258,165
../../CUB_200_2011/images\075.Green_Jay/Green_Jay_0094_65775.jpg,500,375,075.Green_Jay,174,107,337,214,255,160,163,107
../../CUB_200_2011/images\075.Green_Jay/Green_Jay_0051_65662.jpg,333,500,075.Green_Jay,58,146,235,388,146,267,177,242
../../CUB_200_2011/images\075.Green_Jay/Green_Jay_0027_65783.jpg,500,481,075.Green_Jay,108,19,285,422,196,220,177,403
../../CUB_200_2011/images\075.Green_Jay/Green_Jay_0100_65786.jpg,500,332,075.Green_Jay,3,6,389,327,196,166,386,321
../../CUB_200_2011/images\075.Green_Jay/Green_Jay_0006_65788.jpg,500,333,075.Green_Jay,13,133,311,315,162,224,298,182
../../CUB_200_2011/images\075.Green_Jay/Green_Jay_0015_65796.jpg,500,376,075.Green_Jay,113,136,246,261,179,198,133,125
../../CUB_200_2011/images\075.Green_Jay/Green_Jay_0071_65799.jpg,500,375,075.Green_Jay,180,61,333,223,256,142,153,162
../../CUB_200_2011/images\075.Green_Jay/Green_Jay_0043_65805.jpg,320,240,075.Green_Jay,113,61,234,204,173,132,121,143
../../CUB_200_2011/images\075.Green_Jay/Green_Jay_0055_65807.jpg,500,332,075.Green_Jay,13,108,257,282,135,195,244,174
../../CUB_200_2011/images\075.Green_Jay/Green_Jay_0106_65811.jpg,500,375,075.Green_Jay,176,67,308,332,242,199,132,265
../../CUB_200_2011/images\075.Green_Jay/Green_Jay_0102_65813.jpg,487,311,075.Green_Jay,96,101,375,297,235,199,279,196
../../CUB_200_2011/images\075.Green_Jay/Green_Jay_0030_65824.jpg,375,500,075.Green_Jay,0,204,221,449,110,326,221,245
../../CUB_200_2011/images\075.Green_Jay/Green_Jay_0014_65825.jpg,500,354,075.Green_Jay,117,29,324,352,220,190,207,323
../../CUB_200_2011/images\075.Green_Jay/Green_Jay_0114_65841.jpg,500,314,075.Green_Jay,25,25,474,300,249,162,449,275
../../CUB_200_2011/images\075.Green_Jay/Green_Jay_0086_65847.jpg,500,372,075.Green_Jay,47,38,495,359,271,198,448,321
../../CUB_200_2011/images\075.Green_Jay/Green_Jay_0124_65848.jpg,500,375,075.Green_Jay,51,6,474,325,262,165,423,319
../../CUB_200_2011/images\075.Green_Jay/Green_Jay_0032_65851.jpg,500,435,075.Green_Jay,115,122,343,392,229,257,228,270
../../CUB_200_2011/images\075.Green_Jay/Green_Jay_0098_65857.jpg,500,333,075.Green_Jay,105,90,322,322,213,206,217,232
../../CUB_200_2011/images\075.Green_Jay/Green_Jay_0040_65863.jpg,500,397,075.Green_Jay,168,125,342,337,255,231,174,212
../../CUB_200_2011/images\075.Green_Jay/Green_Jay_0016_65864.jpg,500,375,075.Green_Jay,112,99,460,352,286,225,348,253
../../CUB_200_2011/images\075.Green_Jay/Green_Jay_0111_65869.jpg,334,500,075.Green_Jay,52,123,333,461,192,292,281,338
../../CUB_200_2011/images\075.Green_Jay/Green_Jay_0095_65881.jpg,500,375,075.Green_Jay,26,7,365,375,195,191,339,368
../../CUB_200_2011/images\075.Green_Jay/Green_Jay_0092_65884.jpg,311,500,075.Green_Jay,92,142,269,459,180,300,177,317
../../CUB_200_2011/images\075.Green_Jay/Green_Jay_0130_65885.jpg,334,500,075.Green_Jay,127,133,297,386,212,259,170,253
../../CUB_200_2011/images\075.Green_Jay/Green_Jay_0132_65886.jpg,500,333,075.Green_Jay,155,74,439,305,297,189,284,231
../../CUB_200_2011/images\075.Green_Jay/Green_Jay_0074_65889.jpg,500,358,075.Green_Jay,76,109,333,282,204,195,257,173
../../CUB_200_2011/images\075.Green_Jay/Green_Jay_0090_65895.jpg,500,430,075.Green_Jay,93,54,338,329,215,191,245,275
../../CUB_200_2011/images\075.Green_Jay/Green_Jay_0023_65898.jpg,500,334,075.Green_Jay,68,38,377,300,222,169,309,262
../../CUB_200_2011/images\075.Green_Jay/Green_Jay_0066_65902.jpg,500,368,075.Green_Jay,254,42,471,303,362,172,217,261
../../CUB_200_2011/images\075.Green_Jay/Green_Jay_0104_65908.jpg,500,332,075.Green_Jay,132,75,491,309,311,192,359,234
../../CUB_200_2011/images\075.Green_Jay/Green_Jay_0063_65925.jpg,500,333,075.Green_Jay,178,118,296,326,237,222,118,208
../../CUB_200_2011/images\075.Green_Jay/Green_Jay_0011_65947.jpg,333,500,075.Green_Jay,5,63,334,498,169,280,329,435
../../CUB_200_2011/images\076.Dark_eyed_Junco/Dark_Eyed_Junco_0087_68102.jpg,500,470,076.Dark_eyed_Junco,177,114,474,312,325,213,297,198
../../CUB_200_2011/images\076.Dark_eyed_Junco/Dark_Eyed_Junco_0015_66576.jpg,500,267,076.Dark_eyed_Junco,75,37,424,234,249,135,349,197
../../CUB_200_2011/images\076.Dark_eyed_Junco/Dark_Eyed_Junco_0057_68650.jpg,500,367,076.Dark_eyed_Junco,29,54,400,287,214,170,371,233
../../CUB_200_2011/images\076.Dark_eyed_Junco/Dark_Eyed_Junco_0106_68139.jpg,386,500,076.Dark_eyed_Junco,73,151,338,359,205,255,265,208
../../CUB_200_2011/images\076.Dark_eyed_Junco/Dark_Eyed_Junco_0023_68661.jpg,375,500,076.Dark_eyed_Junco,86,122,284,353,185,237,198,231
../../CUB_200_2011/images\076.Dark_eyed_Junco/Dark_Eyed_Junco_0124_67664.jpg,500,408,076.Dark_eyed_Junco,219,85,410,305,314,195,191,220
../../CUB_200_2011/images\076.Dark_eyed_Junco/Dark_Eyed_Junco_0043_68689.jpg,500,333,076.Dark_eyed_Junco,31,89,325,270,178,179,294,181
../../CUB_200_2011/images\076.Dark_eyed_Junco/Dark_Eyed_Junco_0010_66649.jpg,500,330,076.Dark_eyed_Junco,145,84,376,313,260,198,231,229
../../CUB_200_2011/images\076.Dark_eyed_Junco/Dark_Eyed_Junco_0017_67676.jpg,500,333,076.Dark_eyed_Junco,190,133,368,235,279,184,178,102
../../CUB_200_2011/images\076.Dark_eyed_Junco/Dark_Eyed_Junco_0062_68198.jpg,500,350,076.Dark_eyed_Junco,86,76,469,302,277,189,383,226
../../CUB_200_2011/images\076.Dark_eyed_Junco/Dark_Eyed_Junco_0063_67688.jpg,500,400,076.Dark_eyed_Junco,208,76,368,339,288,207,160,263
../../CUB_200_2011/images\076.Dark_eyed_Junco/Dark_Eyed_Junco_0103_67700.jpg,500,334,076.Dark_eyed_Junco,194,93,462,273,328,183,268,180
../../CUB_200_2011/images\076.Dark_eyed_Junco/Dark_Eyed_Junco_0044_68213.jpg,500,375,076.Dark_eyed_Junco,190,82,371,264,280,173,181,182
../../CUB_200_2011/images\076.Dark_eyed_Junco/Dark_Eyed_Junco_0094_68735.jpg,336,500,076.Dark_eyed_Junco,100,164,226,425,163,294,126,261
../../CUB_200_2011/images\076.Dark_eyed_Junco/Dark_Eyed_Junco_0040_66689.jpg,375,500,076.Dark_eyed_Junco,169,243,372,423,270,333,203,180
../../CUB_200_2011/images\076.Dark_eyed_Junco/Dark_Eyed_Junco_0016_68738.jpg,500,271,076.Dark_eyed_Junco,177,42,373,220,275,131,196,178
../../CUB_200_2011/images\076.Dark_eyed_Junco/Dark_Eyed_Junco_0081_67223.jpg,500,375,076.Dark_eyed_Junco,183,130,407,242,295,186,224,112
../../CUB_200_2011/images\076.Dark_eyed_Junco/Dark_Eyed_Junco_0088_66722.jpg,500,500,076.Dark_eyed_Junco,66,114,396,413,231,263,330,299
../../CUB_200_2011/images\076.Dark_eyed_Junco/Dark_Eyed_Junco_0013_66332.jpg,500,357,076.Dark_eyed_Junco,5,79,395,279,200,179,390,200
../../CUB_200_2011/images\076.Dark_eyed_Junco/Dark_Eyed_Junco_0058_68784.jpg,500,324,076.Dark_eyed_Junco,77,34,458,318,267,176,381,284
../../CUB_200_2011/images\076.Dark_eyed_Junco/Dark_Eyed_Junco_0005_68813.jpg,500,375,076.Dark_eyed_Junco,1,65,341,373,171,219,340,308
../../CUB_200_2011/images\076.Dark_eyed_Junco/Dark_Eyed_Junco_0014_66258.jpg,500,333,076.Dark_eyed_Junco,148,66,310,265,229,165,162,199
../../CUB_200_2011/images\076.Dark_eyed_Junco/Dark_Eyed_Junco_0021_66261.jpg,500,359,076.Dark_eyed_Junco,81,44,356,319,218,181,275,275
../../CUB_200_2011/images\076.Dark_eyed_Junco/Dark_Eyed_Junco_0031_66785.jpg,500,401,076.Dark_eyed_Junco,158,43,457,363,307,203,299,320
../../CUB_200_2011/images\076.Dark_eyed_Junco/Dark_Eyed_Junco_0072_67810.jpg,500,332,076.Dark_eyed_Junco,91,39,367,304,229,171,276,265
../../CUB_200_2011/images\076.Dark_eyed_Junco/Dark_Eyed_Junco_0011_66280.jpg,500,458,076.Dark_eyed_Junco,167,88,338,387,252,237,171,299
../../CUB_200_2011/images\076.Dark_eyed_Junco/Dark_Eyed_Junco_0104_67820.jpg,500,370,076.Dark_eyed_Junco,0,68,481,367,240,217,481,299
../../CUB_200_2011/images\076.Dark_eyed_Junco/Dark_Eyed_Junco_0061_66858.jpg,500,407,076.Dark_eyed_Junco,38,49,397,340,217,194,359,291
../../CUB_200_2011/images\076.Dark_eyed_Junco/Dark_Eyed_Junco_0059_66305.jpg,500,384,076.Dark_eyed_Junco,225,127,415,284,320,205,190,157
../../CUB_200_2011/images\076.Dark_eyed_Junco/Dark_Eyed_Junco_0093_67335.jpg,500,333,076.Dark_eyed_Junco,212,63,460,189,336,126,248,126
../../CUB_200_2011/images\076.Dark_eyed_Junco/Dark_Eyed_Junco_0037_66321.jpg,375,500,076.Dark_eyed_Junco,25,22,374,456,199,239,349,434
../../CUB_200_2011/images\076.Dark_eyed_Junco/Dark_Eyed_Junco_0109_66326.jpg,400,500,076.Dark_eyed_Junco,32,25,352,438,192,231,320,413
../../CUB_200_2011/images\076.Dark_eyed_Junco/Dark_Eyed_Junco_0130_67867.jpg,500,311,076.Dark_eyed_Junco,105,36,357,270,231,153,252,234
../../CUB_200_2011/images\076.Dark_eyed_Junco/Dark_Eyed_Junco_0099_67868.jpg,500,333,076.Dark_eyed_Junco,84,150,306,306,195,228,222,156
../../CUB_200_2011/images\076.Dark_eyed_Junco/Dark_Eyed_Junco_0078_66866.jpg,500,301,076.Dark_eyed_Junco,28,68,253,195,140,131,225,127
../../CUB_200_2011/images\076.Dark_eyed_Junco/Dark_Eyed_Junco_0069_68416.jpg,500,334,076.Dark_eyed_Junco,188,124,353,273,270,198,165,149
../../CUB_200_2011/images\076.Dark_eyed_Junco/Dark_Eyed_Junco_0008_68321.jpg,500,327,076.Dark_eyed_Junco,120,70,335,274,227,172,215,204
../../CUB_200_2011/images\076.Dark_eyed_Junco/Dark_Eyed_Junco_0102_67402.jpg,500,375,076.Dark_eyed_Junco,139,99,404,262,271,180,265,163
../../CUB_200_2011/images\076.Dark_eyed_Junco/Dark_Eyed_Junco_0030_68439.jpg,400,500,076.Dark_eyed_Junco,99,51,310,379,204,215,211,328
../../CUB_200_2011/images\076.Dark_eyed_Junco/Dark_Eyed_Junco_0024_68961.jpg,500,500,076.Dark_eyed_Junco,124,185,493,422,308,303,369,237
../../CUB_200_2011/images\076.Dark_eyed_Junco/Dark_Eyed_Junco_0071_67426.jpg,386,500,076.Dark_eyed_Junco,135,230,327,371,231,300,192,141
../../CUB_200_2011/images\076.Dark_eyed_Junco/Dark_Eyed_Junco_0091_67304.jpg,499,500,076.Dark_eyed_Junco,20,150,252,346,136,248,232,196
../../CUB_200_2011/images\076.Dark_eyed_Junco/Dark_Eyed_Junco_0012_66932.jpg,500,357,076.Dark_eyed_Junco,47,99,169,236,108,167,122,137
../../CUB_200_2011/images\076.Dark_eyed_Junco/Dark_Eyed_Junco_0113_68470.jpg,500,222,076.Dark_eyed_Junco,120,63,490,221,305,142,370,158
../../CUB_200_2011/images\076.Dark_eyed_Junco/Dark_Eyed_Junco_0131_66423.jpg,500,375,076.Dark_eyed_Junco,101,111,236,304,168,207,135,193
../../CUB_200_2011/images\076.Dark_eyed_Junco/Dark_Eyed_Junco_0114_67964.jpg,500,335,076.Dark_eyed_Junco,177,128,305,292,241,210,128,164
../../CUB_200_2011/images\076.Dark_eyed_Junco/Dark_Eyed_Junco_0086_66437.jpg,500,333,076.Dark_eyed_Junco,304,47,421,206,362,126,117,159
../../CUB_200_2011/images\076.Dark_eyed_Junco/Dark_Eyed_Junco_0083_66449.jpg,500,363,076.Dark_eyed_Junco,78,57,460,302,269,179,382,245
../../CUB_200_2011/images\076.Dark_eyed_Junco/Dark_Eyed_Junco_0089_68498.jpg,500,353,076.Dark_eyed_Junco,228,129,500,331,364,230,272,202
../../CUB_200_2011/images\076.Dark_eyed_Junco/Dark_Eyed_Junco_0084_66455.jpg,500,370,076.Dark_eyed_Junco,3,57,401,333,202,195,398,276
../../CUB_200_2011/images\076.Dark_eyed_Junco/Dark_Eyed_Junco_0115_68840.jpg,500,366,076.Dark_eyed_Junco,76,62,292,272,184,167,216,210
../../CUB_200_2011/images\076.Dark_eyed_Junco/Dark_Eyed_Junco_0041_66464.jpg,500,326,076.Dark_eyed_Junco,21,68,334,288,177,178,313,220
../../CUB_200_2011/images\076.Dark_eyed_Junco/Dark_Eyed_Junco_0096_68514.jpg,500,400,076.Dark_eyed_Junco,104,39,214,202,159,120,110,163
../../CUB_200_2011/images\076.Dark_eyed_Junco/Dark_Eyed_Junco_0048_66981.jpg,500,396,076.Dark_eyed_Junco,37,83,377,371,207,227,340,288
../../CUB_200_2011/images\076.Dark_eyed_Junco/Dark_Eyed_Junco_0056_67498.jpg,500,341,076.Dark_eyed_Junco,16,73,465,289,240,181,449,216
../../CUB_200_2011/images\076.Dark_eyed_Junco/Dark_Eyed_Junco_0132_66476.jpg,500,500,076.Dark_eyed_Junco,122,46,357,478,239,262,235,432
../../CUB_200_2011/images\076.Dark_eyed_Junco/Dark_Eyed_Junco_0105_66479.jpg,500,388,076.Dark_eyed_Junco,180,151,485,303,332,227,305,152
../../CUB_200_2011/images\076.Dark_eyed_Junco/Dark_Eyed_Junco_0111_66488.jpg,500,356,076.Dark_eyed_Junco,39,113,468,296,253,204,429,183
../../CUB_200_2011/images\076.Dark_eyed_Junco/Dark_Eyed_Junco_0090_69051.jpg,500,333,076.Dark_eyed_Junco,219,115,370,322,294,218,151,207
../../CUB_200_2011/images\076.Dark_eyed_Junco/Dark_Eyed_Junco_0026_68061.jpg,500,400,076.Dark_eyed_Junco,72,67,498,399,285,233,426,332
../../CUB_200_2011/images\077.Tropical_Kingbird/Tropical_Kingbird_0064_69889.jpg,500,398,077.Tropical_Kingbird,166,78,358,363,262,220,192,285
../../CUB_200_2011/images\077.Tropical_Kingbird/Tropical_Kingbird_0098_69642.jpg,401,500,077.Tropical_Kingbird,44,70,304,467,174,268,260,397
../../CUB_200_2011/images\077.Tropical_Kingbird/Tropical_Kingbird_0019_69643.jpg,500,333,077.Tropical_Kingbird,139,40,349,318,244,179,210,278
../../CUB_200_2011/images\077.Tropical_Kingbird/Tropical_Kingbird_0014_69647.jpg,500,375,077.Tropical_Kingbird,162,86,319,269,240,177,157,183
../../CUB_200_2011/images\077.Tropical_Kingbird/Tropical_Kingbird_0068_69397.jpg,500,346,077.Tropical_Kingbird,41,45,338,323,189,184,297,278
../../CUB_200_2011/images\077.Tropical_Kingbird/Tropical_Kingbird_0102_69654.jpg,375,500,077.Tropical_Kingbird,170,133,297,423,233,278,127,290
../../CUB_200_2011/images\077.Tropical_Kingbird/Tropical_Kingbird_0081_69656.jpg,500,357,077.Tropical_Kingbird,184,66,307,330,245,198,123,264
../../CUB_200_2011/images\077.Tropical_Kingbird/Tropical_Kingbird_0073_69401.jpg,500,334,077.Tropical_Kingbird,83,58,339,264,211,161,256,206
../../CUB_200_2011/images\077.Tropical_Kingbird/Tropical_Kingbird_0006_69521.jpg,364,500,077.Tropical_Kingbird,89,102,257,395,173,248,168,293
../../CUB_200_2011/images\077.Tropical_Kingbird/Tropical_Kingbird_0004_69659.jpg,500,362,077.Tropical_Kingbird,144,49,387,311,265,180,243,262
../../CUB_200_2011/images\077.Tropical_Kingbird/Tropical_Kingbird_0005_69662.jpg,375,500,077.Tropical_Kingbird,28,81,284,450,156,265,256,369
../../CUB_200_2011/images\077.Tropical_Kingbird/Tropical_Kingbird_0049_69933.jpg,500,372,077.Tropical_Kingbird,114,104,338,268,226,186,224,164
../../CUB_200_2011/images\077.Tropical_Kingbird/Tropical_Kingbird_0002_69595.jpg,500,402,077.Tropical_Kingbird,66,80,341,364,203,222,275,284
../../CUB_200_2011/images\077.Tropical_Kingbird/Tropical_Kingbird_0036_69939.jpg,500,379,077.Tropical_Kingbird,63,91,404,306,233,198,341,215
../../CUB_200_2011/images\077.Tropical_Kingbird/Tropical_Kingbird_0096_69684.jpg,500,375,077.Tropical_Kingbird,30,82,311,327,170,204,281,245
../../CUB_200_2011/images\077.Tropical_Kingbird/Tropical_Kingbird_0060_69942.jpg,333,500,077.Tropical_Kingbird,117,148,293,365,205,256,176,217
../../CUB_200_2011/images\077.Tropical_Kingbird/Tropical_Kingbird_0122_69687.jpg,333,500,077.Tropical_Kingbird,114,166,230,414,172,290,116,248
../../CUB_200_2011/images\077.Tropical_Kingbird/Tropical_Kingbird_0045_69605.jpg,408,500,077.Tropical_Kingbird,106,147,358,446,232,296,252,299
../../CUB_200_2011/images\077.Tropical_Kingbird/Tropical_Kingbird_0097_69436.jpg,500,334,077.Tropical_Kingbird,105,43,401,300,253,171,296,257
../../CUB_200_2011/images\077.Tropical_Kingbird/Tropical_Kingbird_0074_69949.jpg,500,498,077.Tropical_Kingbird,204,161,363,410,283,285,159,249
../../CUB_200_2011/images\077.Tropical_Kingbird/Tropical_Kingbird_0041_69954.jpg,333,500,077.Tropical_Kingbird,24,75,299,399,161,237,275,324
../../CUB_200_2011/images\077.Tropical_Kingbird/Tropical_Kingbird_0114_69700.jpg,500,375,077.Tropical_Kingbird,132,118,250,318,191,218,118,200
../../CUB_200_2011/images\077.Tropical_Kingbird/Tropical_Kingbird_0001_69958.jpg,463,500,077.Tropical_Kingbird,83,57,451,314,267,185,368,257
../../CUB_200_2011/images\077.Tropical_Kingbird/Tropical_Kingbird_0038_69455.jpg,500,456,077.Tropical_Kingbird,24,59,472,411,248,235,448,352
../../CUB_200_2011/images\077.Tropical_Kingbird/Tropical_Kingbird_0116_69714.jpg,500,496,077.Tropical_Kingbird,73,52,437,440,255,246,364,388
../../CUB_200_2011/images\077.Tropical_Kingbird/Tropical_Kingbird_0017_69715.jpg,344,500,077.Tropical_Kingbird,161,129,269,391,215,260,108,262
../../CUB_200_2011/images\077.Tropical_Kingbird/Tropical_Kingbird_0047_69719.jpg,500,358,077.Tropical_Kingbird,41,66,342,284,191,175,301,218
../../CUB_200_2011/images\077.Tropical_Kingbird/Tropical_Kingbird_0075_69978.jpg,500,375,077.Tropical_Kingbird,147,58,431,353,289,205,284,295
../../CUB_200_2011/images\077.Tropical_Kingbird/Tropical_Kingbird_0040_69728.jpg,500,375,077.Tropical_Kingbird,181,12,335,358,258,185,154,346
../../CUB_200_2011/images\077.Tropical_Kingbird/Tropical_Kingbird_0110_69731.jpg,500,311,077.Tropical_Kingbird,187,89,300,200,243,144,113,111
../../CUB_200_2011/images\077.Tropical_Kingbird/Tropical_Kingbird_0027_69735.jpg,500,375,077.Tropical_Kingbird,150,133,314,248,232,190,164,115
../../CUB_200_2011/images\077.Tropical_Kingbird/Tropical_Kingbird_0085_69737.jpg,500,472,077.Tropical_Kingbird,138,66,289,440,213,253,151,374
../../CUB_200_2011/images\077.Tropical_Kingbird/Tropical_Kingbird_0095_69482.jpg,500,375,077.Tropical_Kingbird,105,87,363,277,234,182,258,190
../../CUB_200_2011/images\077.Tropical_Kingbird/Tropical_Kingbird_0052_69739.jpg,445,500,077.Tropical_Kingbird,115,130,368,460,241,295,253,330
../../CUB_200_2011/images\077.Tropical_Kingbird/Tropical_Kingbird_0115_69485.jpg,500,405,077.Tropical_Kingbird,53,17,405,389,229,203,352,372
../../CUB_200_2011/images\077.Tropical_Kingbird/Tropical_Kingbird_0022_69742.jpg,500,333,077.Tropical_Kingbird,230,91,356,306,293,198,126,215
../../CUB_200_2011/images\077.Tropical_Kingbird/Tropical_Kingbird_0034_69242.jpg,375,500,077.Tropical_Kingbird,54,141,349,441,201,291,295,300
../../CUB_200_2011/images\077.Tropical_Kingbird/Tropical_Kingbird_0086_69759.jpg,253,500,077.Tropical_Kingbird,68,95,225,446,146,270,157,351
../../CUB_200_2011/images\077.Tropical_Kingbird/Tropical_Kingbird_0039_69253.jpg,500,400,077.Tropical_Kingbird,97,126,322,337,209,231,225,211
../../CUB_200_2011/images\077.Tropical_Kingbird/Tropical_Kingbird_0023_69998.jpg,500,376,077.Tropical_Kingbird,43,96,368,279,205,187,325,183
../../CUB_200_2011/images\077.Tropical_Kingbird/Tropical_Kingbird_0067_69792.jpg,500,375,077.Tropical_Kingbird,19,31,434,332,226,181,415,301
../../CUB_200_2011/images\077.Tropical_Kingbird/Tropical_Kingbird_0057_69283.jpg,470,470,077.Tropical_Kingbird,128,50,456,443,292,246,328,393
../../CUB_200_2011/images\077.Tropical_Kingbird/Tropical_Kingbird_0044_69815.jpg,500,375,077.Tropical_Kingbird,142,73,370,316,256,194,228,243
../../CUB_200_2011/images\077.Tropical_Kingbird/Tropical_Kingbird_0056_69509.jpg,500,334,077.Tropical_Kingbird,176,127,328,273,252,200,152,146
../../CUB_200_2011/images\077.Tropical_Kingbird/Tropical_Kingbird_0103_69311.jpg,400,500,077.Tropical_Kingbird,135,156,365,472,250,314,230,316
../../CUB_200_2011/images\077.Tropical_Kingbird/Tropical_Kingbird_0084_69312.jpg,500,363,077.Tropical_Kingbird,140,89,450,278,295,183,310,189
../../CUB_200_2011/images\077.Tropical_Kingbird/Tropical_Kingbird_0066_69320.jpg,500,409,077.Tropical_Kingbird,127,50,268,347,197,198,141,297
../../CUB_200_2011/images\077.Tropical_Kingbird/Tropical_Kingbird_0024_69582.jpg,450,401,077.Tropical_Kingbird,108,47,380,356,244,201,272,309
../../CUB_200_2011/images\077.Tropical_Kingbird/Tropical_Kingbird_0010_69583.jpg,500,333,077.Tropical_Kingbird,204,45,403,321,303,183,199,276
../../CUB_200_2011/images\077.Tropical_Kingbird/Tropical_Kingbird_0031_69333.jpg,500,489,077.Tropical_Kingbird,182,41,329,390,255,215,147,349
../../CUB_200_2011/images\077.Tropical_Kingbird/Tropical_Kingbird_0087_69592.jpg,400,500,077.Tropical_Kingbird,37,120,351,419,194,269,314,299
../../CUB_200_2011/images\077.Tropical_Kingbird/Tropical_Kingbird_0003_69852.jpg,500,333,077.Tropical_Kingbird,198,57,411,312,304,184,213,255
../../CUB_200_2011/images\077.Tropical_Kingbird/Tropical_Kingbird_0088_69856.jpg,500,333,077.Tropical_Kingbird,157,55,330,249,243,152,173,194
../../CUB_200_2011/images\077.Tropical_Kingbird/Tropical_Kingbird_0051_69609.jpg,500,486,077.Tropical_Kingbird,172,74,447,457,309,265,275,383
../../CUB_200_2011/images\077.Tropical_Kingbird/Tropical_Kingbird_0043_69613.jpg,500,333,077.Tropical_Kingbird,137,53,360,266,248,159,223,213
../../CUB_200_2011/images\077.Tropical_Kingbird/Tropical_Kingbird_0007_69361.jpg,500,333,077.Tropical_Kingbird,167,91,304,305,235,198,137,214
../../CUB_200_2011/images\077.Tropical_Kingbird/Tropical_Kingbird_0018_69619.jpg,500,420,077.Tropical_Kingbird,58,82,331,412,194,247,273,330
../../CUB_200_2011/images\077.Tropical_Kingbird/Tropical_Kingbird_0011_69877.jpg,333,500,077.Tropical_Kingbird,78,146,235,296,156,221,157,150
../../CUB_200_2011/images\077.Tropical_Kingbird/Tropical_Kingbird_0079_69371.jpg,500,500,077.Tropical_Kingbird,179,79,310,431,244,255,131,352
../../CUB_200_2011/images\077.Tropical_Kingbird/Tropical_Kingbird_0063_69589.jpg,500,333,077.Tropical_Kingbird,194,108,357,216,275,162,163,108
../../CUB_200_2011/images\078.Gray_Kingbird/Gray_Kingbird_0025_70152.jpg,500,360,078.Gray_Kingbird,20,58,345,347,182,202,325,289
../../CUB_200_2011/images\078.Gray_Kingbird/Gray_Kingbird_0022_70155.jpg,500,356,078.Gray_Kingbird,124,89,340,261,232,175,216,172
../../CUB_200_2011/images\078.Gray_Kingbird/Gray_Kingbird_0056_70156.jpg,500,460,078.Gray_Kingbird,149,99,331,382,240,240,182,283
../../CUB_200_2011/images\078.Gray_Kingbird/Gray_Kingbird_0017_70161.jpg,357,500,078.Gray_Kingbird,121,60,352,302,236,181,231,242
../../CUB_200_2011/images\078.Gray_Kingbird/Gray_Kingbird_0083_70162.jpg,500,375,078.Gray_Kingbird,66,25,285,279,175,152,219,254
../../CUB_200_2011/images\078.Gray_Kingbird/Gray_Kingbird_0053_70166.jpg,500,500,078.Gray_Kingbird,36,84,427,441,231,262,391,357
../../CUB_200_2011/images\078.Gray_Kingbird/Gray_Kingbird_0084_70171.jpg,375,500,078.Gray_Kingbird,106,66,261,471,183,268,155,405
../../CUB_200_2011/images\078.Gray_Kingbird/Gray_Kingbird_0036_70184.jpg,427,500,078.Gray_Kingbird,14,51,399,477,206,264,385,426
../../CUB_200_2011/images\078.Gray_Kingbird/Gray_Kingbird_0075_70188.jpg,375,500,078.Gray_Kingbird,134,106,314,382,224,244,180,276
../../CUB_200_2011/images\078.Gray_Kingbird/Gray_Kingbird_0077_70191.jpg,500,357,078.Gray_Kingbird,63,75,368,336,215,205,305,261
../../CUB_200_2011/images\078.Gray_Kingbird/Gray_Kingbird_0001_70224.jpg,500,333,078.Gray_Kingbird,234,127,405,290,319,208,171,163
../../CUB_200_2011/images\078.Gray_Kingbird/Gray_Kingbird_0014_70227.jpg,500,333,078.Gray_Kingbird,106,87,287,240,196,163,181,153
../../CUB_200_2011/images\078.Gray_Kingbird/Gray_Kingbird_0021_70228.jpg,377,500,078.Gray_Kingbird,99,20,310,491,204,255,211,471
../../CUB_200_2011/images\078.Gray_Kingbird/Gray_Kingbird_0049_795022.jpg,372,290,078.Gray_Kingbird,32,102,279,251,155,176,247,149
../../CUB_200_2011/images\078.Gray_Kingbird/Gray_Kingbird_0009_795023.jpg,500,375,078.Gray_Kingbird,92,63,444,351,268,207,352,288
../../CUB_200_2011/images\078.Gray_Kingbird/Gray_Kingbird_0018_70241.jpg,479,311,078.Gray_Kingbird,28,59,368,265,198,162,340,206
../../CUB_200_2011/images\078.Gray_Kingbird/Gray_Kingbird_0062_795026.jpg,320,480,078.Gray_Kingbird,64,139,290,468,177,303,226,329
../../CUB_200_2011/images\078.Gray_Kingbird/Gray_Kingbird_0045_70256.jpg,500,275,078.Gray_Kingbird,145,15,442,212,293,113,297,197
../../CUB_200_2011/images\078.Gray_Kingbird/Gray_Kingbird_0054_70264.jpg,350,500,078.Gray_Kingbird,85,23,268,490,176,256,183,467
../../CUB_200_2011/images\078.Gray_Kingbird/Gray_Kingbird_0006_70268.jpg,375,500,078.Gray_Kingbird,39,115,200,469,119,292,161,354
../../CUB_200_2011/images\078.Gray_Kingbird/Gray_Kingbird_0081_70276.jpg,331,500,078.Gray_Kingbird,23,112,235,352,129,232,212,240
../../CUB_200_2011/images\078.Gray_Kingbird/Gray_Kingbird_0019_795013.jpg,500,424,078.Gray_Kingbird,0,72,384,336,192,204,384,264
../../CUB_200_2011/images\078.Gray_Kingbird/Gray_Kingbird_0082_795014.jpg,380,253,078.Gray_Kingbird,171,53,351,245,261,149,180,192
../../CUB_200_2011/images\078.Gray_Kingbird/Gray_Kingbird_0029_795015.jpg,500,395,078.Gray_Kingbird,124,48,459,394,291,221,335,346
../../CUB_200_2011/images\078.Gray_Kingbird/Gray_Kingbird_0008_70282.jpg,500,332,078.Gray_Kingbird,209,95,379,268,294,181,170,173
../../CUB_200_2011/images\078.Gray_Kingbird/Gray_Kingbird_0060_795021.jpg,500,332,078.Gray_Kingbird,248,16,408,323,328,169,160,307
../../CUB_200_2011/images\078.Gray_Kingbird/Gray_Kingbird_0063_70287.jpg,500,332,078.Gray_Kingbird,54,79,278,217,166,148,224,138
../../CUB_200_2011/images\078.Gray_Kingbird/Gray_Kingbird_0016_70288.jpg,500,334,078.Gray_Kingbird,184,126,286,238,235,182,102,112
../../CUB_200_2011/images\078.Gray_Kingbird/Gray_Kingbird_0055_70290.jpg,500,333,078.Gray_Kingbird,48,55,292,209,170,132,244,154
../../CUB_200_2011/images\078.Gray_Kingbird/Gray_Kingbird_0035_795027.jpg,500,333,078.Gray_Kingbird,117,19,394,322,255,170,277,303
../../CUB_200_2011/images\078.Gray_Kingbird/Gray_Kingbird_0068_70292.jpg,500,399,078.Gray_Kingbird,109,55,334,394,221,224,225,339
../../CUB_200_2011/images\078.Gray_Kingbird/Gray_Kingbird_0004_70293.jpg,500,396,078.Gray_Kingbird,148,91,278,374,213,232,130,283
../../CUB_200_2011/images\078.Gray_Kingbird/Gray_Kingbird_0059_795030.jpg,500,333,078.Gray_Kingbird,145,58,399,287,272,172,254,229
../../CUB_200_2011/images\078.Gray_Kingbird/Gray_Kingbird_0043_795032.jpg,408,272,078.Gray_Kingbird,91,85,239,229,165,157,148,144
../../CUB_200_2011/images\078.Gray_Kingbird/Gray_Kingbird_0023_795035.jpg,180,180,078.Gray_Kingbird,12,39,171,150,91,94,159,111
../../CUB_200_2011/images\078.Gray_Kingbird/Gray_Kingbird_0028_70303.jpg,500,354,078.Gray_Kingbird,160,76,470,290,315,183,310,214
../../CUB_200_2011/images\078.Gray_Kingbird/Gray_Kingbird_0003_70305.jpg,375,500,078.Gray_Kingbird,18,57,332,472,175,264,314,415
../../CUB_200_2011/images\078.Gray_Kingbird/Gray_Kingbird_0037_70050.jpg,375,500,078.Gray_Kingbird,59,142,227,453,143,297,168,311
../../CUB_200_2011/images\078.Gray_Kingbird/Gray_Kingbird_0070_70051.jpg,500,407,078.Gray_Kingbird,108,119,319,368,213,243,211,249
../../CUB_200_2011/images\078.Gray_Kingbird/Gray_Kingbird_0031_70308.jpg,500,375,078.Gray_Kingbird,153,99,374,327,263,213,221,228
../../CUB_200_2011/images\078.Gray_Kingbird/Gray_Kingbird_0050_70056.jpg,333,500,078.Gray_Kingbird,83,93,244,442,163,267,161,349
../../CUB_200_2011/images\078.Gray_Kingbird/Gray_Kingbird_0010_70057.jpg,337,500,078.Gray_Kingbird,81,125,253,410,167,267,172,285
../../CUB_200_2011/images\078.Gray_Kingbird/Gray_Kingbird_0044_70322.jpg,500,334,078.Gray_Kingbird,164,72,288,265,226,168,124,193
../../CUB_200_2011/images\078.Gray_Kingbird/Gray_Kingbird_0034_70069.jpg,375,500,078.Gray_Kingbird,67,99,294,469,180,284,227,370
../../CUB_200_2011/images\078.Gray_Kingbird/Gray_Kingbird_0076_70070.jpg,500,362,078.Gray_Kingbird,23,39,419,330,221,184,396,291
../../CUB_200_2011/images\078.Gray_Kingbird/Gray_Kingbird_0080_70077.jpg,500,326,078.Gray_Kingbird,218,101,356,242,287,171,138,141
../../CUB_200_2011/images\078.Gray_Kingbird/Gray_Kingbird_0069_70082.jpg,334,500,078.Gray_Kingbird,81,112,221,436,151,274,140,324
../../CUB_200_2011/images\078.Gray_Kingbird/Gray_Kingbird_0042_70083.jpg,500,350,078.Gray_Kingbird,2,74,397,316,199,195,395,242
../../CUB_200_2011/images\078.Gray_Kingbird/Gray_Kingbird_0026_70089.jpg,500,281,078.Gray_Kingbird,158,105,314,251,236,178,156,146
../../CUB_200_2011/images\078.Gray_Kingbird/Gray_Kingbird_0013_70135.jpg,477,432,078.Gray_Kingbird,134,72,335,344,234,208,201,272
../../CUB_200_2011/images\078.Gray_Kingbird/Gray_Kingbird_0071_70100.jpg,500,492,078.Gray_Kingbird,247,244,434,445,340,344,187,201
../../CUB_200_2011/images\078.Gray_Kingbird/Gray_Kingbird_0005_70103.jpg,500,357,078.Gray_Kingbird,99,97,367,288,233,192,268,191
../../CUB_200_2011/images\078.Gray_Kingbird/Gray_Kingbird_0030_70110.jpg,339,500,078.Gray_Kingbird,51,78,307,320,179,199,256,242
../../CUB_200_2011/images\078.Gray_Kingbird/Gray_Kingbird_0032_70111.jpg,500,475,078.Gray_Kingbird,65,61,401,461,233,261,336,400
../../CUB_200_2011/images\078.Gray_Kingbird/Gray_Kingbird_0038_70118.jpg,500,360,078.Gray_Kingbird,147,131,314,259,230,195,167,128
../../CUB_200_2011/images\078.Gray_Kingbird/Gray_Kingbird_0041_70119.jpg,500,398,078.Gray_Kingbird,190,122,387,325,288,223,197,203
../../CUB_200_2011/images\078.Gray_Kingbird/Gray_Kingbird_0052_795024.jpg,470,472,078.Gray_Kingbird,91,163,304,420,197,291,213,257
../../CUB_200_2011/images\078.Gray_Kingbird/Gray_Kingbird_0040_70313.jpg,500,344,078.Gray_Kingbird,150,36,446,207,298,121,296,171
../../CUB_200_2011/images\078.Gray_Kingbird/Gray_Kingbird_0051_70139.jpg,302,358,078.Gray_Kingbird,35,47,245,316,140,181,210,269
../../CUB_200_2011/images\079.Belted_Kingfisher/Belted_Kingfisher_0020_70922.jpg,500,400,079.Belted_Kingfisher,118,98,340,278,229,188,222,180
../../CUB_200_2011/images\079.Belted_Kingfisher/Belted_Kingfisher_0011_70923.jpg,500,367,079.Belted_Kingfisher,112,71,421,271,266,171,309,200
../../CUB_200_2011/images\079.Belted_Kingfisher/Belted_Kingfisher_0008_70668.jpg,500,400,079.Belted_Kingfisher,274,96,413,215,343,155,139,119
../../CUB_200_2011/images\079.Belted_Kingfisher/Belted_Kingfisher_0075_70873.jpg,500,317,079.Belted_Kingfisher,100,44,221,249,160,146,121,205
../../CUB_200_2011/images\079.Belted_Kingfisher/Belted_Kingfisher_0054_70424.jpg,333,500,079.Belted_Kingfisher,5,43,264,215,134,129,259,172
../../CUB_200_2011/images\079.Belted_Kingfisher/Belted_Kingfisher_0040_70432.jpg,500,464,079.Belted_Kingfisher,43,127,380,337,211,232,337,210
../../CUB_200_2011/images\079.Belted_Kingfisher/Belted_Kingfisher_0099_70449.jpg,500,341,079.Belted_Kingfisher,63,53,332,207,197,130,269,154
../../CUB_200_2011/images\079.Belted_Kingfisher/Belted_Kingfisher_0094_70698.jpg,500,354,079.Belted_Kingfisher,73,15,361,294,217,154,288,279
../../CUB_200_2011/images\079.Belted_Kingfisher/Belted_Kingfisher_0047_70705.jpg,500,333,079.Belted_Kingfisher,213,95,452,248,332,171,239,153
../../CUB_200_2011/images\079.Belted_Kingfisher/Belted_Kingfisher_0082_70711.jpg,500,375,079.Belted_Kingfisher,151,149,283,278,217,213,132,129
../../CUB_200_2011/images\079.Belted_Kingfisher/Belted_Kingfisher_0087_70724.jpg,500,463,079.Belted_Kingfisher,100,169,299,359,199,264,199,190
../../CUB_200_2011/images\079.Belted_Kingfisher/Belted_Kingfisher_0080_70725.jpg,500,400,079.Belted_Kingfisher,68,61,237,175,152,118,169,114
../../CUB_200_2011/images\079.Belted_Kingfisher/Belted_Kingfisher_0072_70924.jpg,333,500,079.Belted_Kingfisher,122,114,306,361,214,237,184,247
../../CUB_200_2011/images\079.Belted_Kingfisher/Belted_Kingfisher_0019_70744.jpg,469,500,079.Belted_Kingfisher,85,117,426,396,255,256,341,279
../../CUB_200_2011/images\079.Belted_Kingfisher/Belted_Kingfisher_0043_70492.jpg,360,335,079.Belted_Kingfisher,112,93,264,197,188,145,152,104
../../CUB_200_2011/images\079.Belted_Kingfisher/Belted_Kingfisher_0044_70494.jpg,500,389,079.Belted_Kingfisher,230,140,414,303,322,221,184,163
../../CUB_200_2011/images\079.Belted_Kingfisher/Belted_Kingfisher_0016_70495.jpg,353,500,079.Belted_Kingfisher,46,151,324,409,185,280,278,258
../../CUB_200_2011/images\079.Belted_Kingfisher/Belted_Kingfisher_0013_70753.jpg,500,375,079.Belted_Kingfisher,120,127,307,240,213,183,187,113
../../CUB_200_2011/images\079.Belted_Kingfisher/Belted_Kingfisher_0025_70501.jpg,500,500,079.Belted_Kingfisher,121,102,377,303,249,202,256,201
../../CUB_200_2011/images\079.Belted_Kingfisher/Belted_Kingfisher_0085_70503.jpg,400,500,079.Belted_Kingfisher,88,88,359,418,223,253,271,330
../../CUB_200_2011/images\079.Belted_Kingfisher/Belted_Kingfisher_0031_70506.jpg,500,333,079.Belted_Kingfisher,182,103,443,248,312,175,261,145
../../CUB_200_2011/images\079.Belted_Kingfisher/Belted_Kingfisher_0056_70516.jpg,322,500,079.Belted_Kingfisher,101,173,248,465,174,319,147,292
../../CUB_200_2011/images\079.Belted_Kingfisher/Belted_Kingfisher_0055_70517.jpg,500,500,079.Belted_Kingfisher,126,101,328,289,227,195,202,188
../../CUB_200_2011/images\079.Belted_Kingfisher/Belted_Kingfisher_0057_70582.jpg,500,332,079.Belted_Kingfisher,223,44,367,237,295,140,144,193
../../CUB_200_2011/images\079.Belted_Kingfisher/Belted_Kingfisher_0079_70524.jpg,500,405,079.Belted_Kingfisher,158,106,302,311,230,208,144,205
../../CUB_200_2011/images\079.Belted_Kingfisher/Belted_Kingfisher_0048_70532.jpg,500,393,079.Belted_Kingfisher,281,146,394,277,337,211,113,131
../../CUB_200_2011/images\079.Belted_Kingfisher/Belted_Kingfisher_0009_70536.jpg,334,500,079.Belted_Kingfisher,40,177,187,320,113,248,147,143
../../CUB_200_2011/images\079.Belted_Kingfisher/Belted_Kingfisher_0024_70538.jpg,500,333,079.Belted_Kingfisher,238,50,433,276,335,163,195,226
../../CUB_200_2011/images\079.Belted_Kingfisher/Belted_Kingfisher_0041_70595.jpg,333,500,079.Belted_Kingfisher,89,40,251,394,170,217,162,354
../../CUB_200_2011/images\079.Belted_Kingfisher/Belted_Kingfisher_0105_70550.jpg,500,258,079.Belted_Kingfisher,89,45,327,231,208,138,238,186
../../CUB_200_2011/images\079.Belted_Kingfisher/Belted_Kingfisher_0104_70596.jpg,500,500,079.Belted_Kingfisher,37,34,486,396,261,215,449,362
../../CUB_200_2011/images\079.Belted_Kingfisher/Belted_Kingfisher_0108_70554.jpg,357,500,079.Belted_Kingfisher,116,205,308,332,212,268,192,127
../../CUB_200_2011/images\079.Belted_Kingfisher/Belted_Kingfisher_0065_70560.jpg,500,400,079.Belted_Kingfisher,203,118,413,267,308,192,210,149
../../CUB_200_2011/images\079.Belted_Kingfisher/Belted_Kingfisher_0086_70569.jpg,500,354,079.Belted_Kingfisher,120,53,394,313,257,183,274,260
../../CUB_200_2011/images\079.Belted_Kingfisher/Belted_Kingfisher_0032_70573.jpg,500,426,079.Belted_Kingfisher,146,102,325,257,235,179,179,155
../../CUB_200_2011/images\079.Belted_Kingfisher/Belted_Kingfisher_0063_70835.jpg,500,384,079.Belted_Kingfisher,92,78,364,294,228,186,272,216
../../CUB_200_2011/images\079.Belted_Kingfisher/Belted_Kingfisher_0012_70325.jpg,395,500,079.Belted_Kingfisher,74,44,270,461,172,252,196,417
../../CUB_200_2011/images\079.Belted_Kingfisher/Belted_Kingfisher_0073_70326.jpg,500,379,079.Belted_Kingfisher,155,88,443,370,299,229,288,282
../../CUB_200_2011/images\079.Belted_Kingfisher/Belted_Kingfisher_0071_70584.jpg,500,357,079.Belted_Kingfisher,277,97,391,236,334,166,114,139
../../CUB_200_2011/images\079.Belted_Kingfisher/Belted_Kingfisher_0034_70329.jpg,500,333,079.Belted_Kingfisher,236,75,342,177,289,126,106,102
../../CUB_200_2011/images\079.Belted_Kingfisher/Belted_Kingfisher_0058_70848.jpg,500,491,079.Belted_Kingfisher,155,61,412,437,283,249,257,376
../../CUB_200_2011/images\079.Belted_Kingfisher/Belted_Kingfisher_0017_70342.jpg,400,500,079.Belted_Kingfisher,116,109,246,218,181,163,130,109
../../CUB_200_2011/images\079.Belted_Kingfisher/Belted_Kingfisher_0096_70347.jpg,500,313,079.Belted_Kingfisher,130,28,471,248,300,138,341,220
../../CUB_200_2011/images\079.Belted_Kingfisher/Belted_Kingfisher_0066_70356.jpg,500,396,079.Belted_Kingfisher,132,44,464,292,298,168,332,248
../../CUB_200_2011/images\079.Belted_Kingfisher/Belted_Kingfisher_0028_70358.jpg,420,500,079.Belted_Kingfisher,97,82,360,448,228,265,263,366
../../CUB_200_2011/images\079.Belted_Kingfisher/Belted_Kingfisher_0093_70360.jpg,500,341,079.Belted_Kingfisher,180,94,406,245,293,169,226,151
../../CUB_200_2011/images\079.Belted_Kingfisher/Belted_Kingfisher_0061_70363.jpg,500,336,079.Belted_Kingfisher,107,47,245,240,176,143,138,193
../../CUB_200_2011/images\079.Belted_Kingfisher/Belted_Kingfisher_0077_70620.jpg,500,500,079.Belted_Kingfisher,69,107,422,331,245,219,353,224
../../CUB_200_2011/images\079.Belted_Kingfisher/Belted_Kingfisher_0078_70366.jpg,500,334,079.Belted_Kingfisher,202,110,386,223,294,166,184,113
../../CUB_200_2011/images\079.Belted_Kingfisher/Belted_Kingfisher_0006_70625.jpg,406,500,079.Belted_Kingfisher,59,106,322,349,190,227,263,243
../../CUB_200_2011/images\079.Belted_Kingfisher/Belted_Kingfisher_0107_70883.jpg,500,400,079.Belted_Kingfisher,197,78,351,197,274,137,154,119
../../CUB_200_2011/images\079.Belted_Kingfisher/Belted_Kingfisher_0111_70375.jpg,500,333,079.Belted_Kingfisher,112,44,374,272,243,158,262,228
../../CUB_200_2011/images\079.Belted_Kingfisher/Belted_Kingfisher_0112_70634.jpg,500,500,079.Belted_Kingfisher,201,160,401,397,301,278,200,237
../../CUB_200_2011/images\079.Belted_Kingfisher/Belted_Kingfisher_0015_70638.jpg,500,315,079.Belted_Kingfisher,215,75,402,228,308,151,187,153
../../CUB_200_2011/images\079.Belted_Kingfisher/Belted_Kingfisher_0053_70899.jpg,484,500,079.Belted_Kingfisher,51,61,358,328,204,194,307,267
../../CUB_200_2011/images\079.Belted_Kingfisher/Belted_Kingfisher_0035_70644.jpg,500,332,079.Belted_Kingfisher,197,111,305,212,251,161,108,101
../../CUB_200_2011/images\079.Belted_Kingfisher/Belted_Kingfisher_0005_70389.jpg,500,357,079.Belted_Kingfisher,158,90,371,300,264,195,213,210
../../CUB_200_2011/images\079.Belted_Kingfisher/Belted_Kingfisher_0027_70397.jpg,500,338,079.Belted_Kingfisher,176,28,433,334,304,181,257,306
../../CUB_200_2011/images\079.Belted_Kingfisher/Belted_Kingfisher_0014_70910.jpg,355,500,079.Belted_Kingfisher,55,110,346,342,200,226,291,232
../../CUB_200_2011/images\079.Belted_Kingfisher/Belted_Kingfisher_0084_70399.jpg,500,400,079.Belted_Kingfisher,43,79,385,256,214,167,342,177
../../CUB_200_2011/images\080.Green_Kingfisher/Green_Kingfisher_0046_71178.jpg,500,391,080.Green_Kingfisher,62,77,458,326,260,201,396,249
../../CUB_200_2011/images\080.Green_Kingfisher/Green_Kingfisher_0011_71183.jpg,418,500,080.Green_Kingfisher,61,109,280,368,170,238,219,259
../../CUB_200_2011/images\080.Green_Kingfisher/Green_Kingfisher_0093_71185.jpg,500,375,080.Green_Kingfisher,205,118,442,280,323,199,237,162
../../CUB_200_2011/images\080.Green_Kingfisher/Green_Kingfisher_0018_71189.jpg,500,333,080.Green_Kingfisher,191,88,358,236,274,162,167,148
../../CUB_200_2011/images\080.Green_Kingfisher/Green_Kingfisher_0010_71191.jpg,500,376,080.Green_Kingfisher,163,138,301,250,232,194,138,112
../../CUB_200_2011/images\080.Green_Kingfisher/Green_Kingfisher_0060_66074.jpg,500,333,080.Green_Kingfisher,181,103,358,206,269,154,177,103
../../CUB_200_2011/images\080.Green_Kingfisher/Green_Kingfisher_0016_71198.jpg,350,500,080.Green_Kingfisher,122,198,335,376,228,287,213,178
../../CUB_200_2011/images\080.Green_Kingfisher/Green_Kingfisher_0066_71200.jpg,500,333,080.Green_Kingfisher,50,92,251,244,150,168,201,152
../../CUB_200_2011/images\080.Green_Kingfisher/Green_Kingfisher_0081_70953.jpg,500,334,080.Green_Kingfisher,106,119,294,227,200,173,188,108
../../CUB_200_2011/images\080.Green_Kingfisher/Green_Kingfisher_0043_71212.jpg,359,500,080.Green_Kingfisher,83,216,230,354,156,285,147,138
../../CUB_200_2011/images\080.Green_Kingfisher/Green_Kingfisher_0017_70957.jpg,500,335,080.Green_Kingfisher,84,92,288,247,186,169,204,155
../../CUB_200_2011/images\080.Green_Kingfisher/Green_Kingfisher_0074_71214.jpg,500,408,080.Green_Kingfisher,120,96,403,283,261,189,283,187
../../CUB_200_2011/images\080.Green_Kingfisher/Green_Kingfisher_0022_71223.jpg,500,333,080.Green_Kingfisher,171,39,465,281,318,160,294,242
../../CUB_200_2011/images\080.Green_Kingfisher/Green_Kingfisher_0003_70970.jpg,500,334,080.Green_Kingfisher,17,73,334,256,175,164,317,183
../../CUB_200_2011/images\080.Green_Kingfisher/Green_Kingfisher_0056_70972.jpg,500,333,080.Green_Kingfisher,18,85,299,246,158,165,281,161
../../CUB_200_2011/images\080.Green_Kingfisher/Green_Kingfisher_0031_71229.jpg,500,436,080.Green_Kingfisher,40,69,398,294,219,181,358,225
../../CUB_200_2011/images\080.Green_Kingfisher/Green_Kingfisher_0067_71093.jpg,500,333,080.Green_Kingfisher,53,82,205,332,129,207,152,250
../../CUB_200_2011/images\080.Green_Kingfisher/Green_Kingfisher_0028_70981.jpg,500,375,080.Green_Kingfisher,39,72,365,248,202,160,326,176
../../CUB_200_2011/images\080.Green_Kingfisher/Green_Kingfisher_0062_70985.jpg,500,349,080.Green_Kingfisher,89,89,373,260,231,174,284,171
../../CUB_200_2011/images\080.Green_Kingfisher/Green_Kingfisher_0091_71248.jpg,500,336,080.Green_Kingfisher,199,98,425,249,312,173,226,151
../../CUB_200_2011/images\080.Green_Kingfisher/Green_Kingfisher_0057_71096.jpg,372,500,080.Green_Kingfisher,47,182,312,417,179,299,265,235
../../CUB_200_2011/images\080.Green_Kingfisher/Green_Kingfisher_0058_70998.jpg,500,375,080.Green_Kingfisher,160,101,443,271,301,186,283,170
../../CUB_200_2011/images\080.Green_Kingfisher/Green_Kingfisher_0071_71255.jpg,500,364,080.Green_Kingfisher,27,41,485,320,256,180,458,279
../../CUB_200_2011/images\080.Green_Kingfisher/Green_Kingfisher_0021_71009.jpg,500,377,080.Green_Kingfisher,61,151,293,272,177,211,232,121
../../CUB_200_2011/images\080.Green_Kingfisher/Green_Kingfisher_0079_71267.jpg,500,374,080.Green_Kingfisher,221,126,429,253,325,189,208,127
../../CUB_200_2011/images\080.Green_Kingfisher/Green_Kingfisher_0026_71059.jpg,500,375,080.Green_Kingfisher,60,108,421,273,240,190,361,165
../../CUB_200_2011/images\080.Green_Kingfisher/Green_Kingfisher_0042_71028.jpg,500,333,080.Green_Kingfisher,155,111,318,220,236,165,163,109
../../CUB_200_2011/images\080.Green_Kingfisher/Green_Kingfisher_0092_71106.jpg,500,319,080.Green_Kingfisher,120,45,398,274,259,159,278,229
../../CUB_200_2011/images\080.Green_Kingfisher/Green_Kingfisher_0013_71293.jpg,500,339,080.Green_Kingfisher,210,99,403,240,306,169,193,141
../../CUB_200_2011/images\080.Green_Kingfisher/Green_Kingfisher_0009_70933.jpg,500,406,080.Green_Kingfisher,110,63,410,242,260,152,300,179
../../CUB_200_2011/images\080.Green_Kingfisher/Green_Kingfisher_0006_71297.jpg,500,383,080.Green_Kingfisher,76,111,305,247,190,179,229,136
../../CUB_200_2011/images\080.Green_Kingfisher/Green_Kingfisher_0015_71042.jpg,500,333,080.Green_Kingfisher,120,31,459,254,289,142,339,223
../../CUB_200_2011/images\080.Green_Kingfisher/Green_Kingfisher_0027_71048.jpg,500,435,080.Green_Kingfisher,0,42,465,375,232,208,465,333
../../CUB_200_2011/images\080.Green_Kingfisher/Green_Kingfisher_0032_71050.jpg,500,333,080.Green_Kingfisher,100,71,398,298,249,184,298,227
../../CUB_200_2011/images\080.Green_Kingfisher/Green_Kingfisher_0069_71053.jpg,500,334,080.Green_Kingfisher,138,135,481,328,309,231,343,193
../../CUB_200_2011/images\080.Green_Kingfisher/Green_Kingfisher_0002_71055.jpg,500,333,080.Green_Kingfisher,147,32,411,229,279,130,264,197
../../CUB_200_2011/images\080.Green_Kingfisher/Green_Kingfisher_0053_71319.jpg,500,333,080.Green_Kingfisher,63,50,309,210,186,130,246,160
../../CUB_200_2011/images\080.Green_Kingfisher/Green_Kingfisher_0045_71064.jpg,500,332,080.Green_Kingfisher,93,87,214,272,153,179,121,185
../../CUB_200_2011/images\080.Green_Kingfisher/Green_Kingfisher_0089_71325.jpg,500,375,080.Green_Kingfisher,154,132,358,251,256,191,204,119
../../CUB_200_2011/images\080.Green_Kingfisher/Green_Kingfisher_0034_71075.jpg,500,297,080.Green_Kingfisher,78,94,207,210,142,152,129,116
../../CUB_200_2011/images\080.Green_Kingfisher/Green_Kingfisher_0004_71076.jpg,500,361,080.Green_Kingfisher,207,72,335,239,271,155,128,167
../../CUB_200_2011/images\080.Green_Kingfisher/Green_Kingfisher_0096_71080.jpg,500,375,080.Green_Kingfisher,156,96,454,288,305,192,298,192
../../CUB_200_2011/images\080.Green_Kingfisher/Green_Kingfisher_0063_71345.jpg,500,333,080.Green_Kingfisher,152,77,430,243,291,160,278,166
../../CUB_200_2011/images\080.Green_Kingfisher/Green_Kingfisher_0099_70942.jpg,333,500,080.Green_Kingfisher,60,126,299,382,179,254,239,256
../../CUB_200_2011/images\080.Green_Kingfisher/Green_Kingfisher_0005_71352.jpg,500,375,080.Green_Kingfisher,110,75,300,330,205,202,190,255
../../CUB_200_2011/images\080.Green_Kingfisher/Green_Kingfisher_0097_71102.jpg,414,500,080.Green_Kingfisher,41,225,309,396,175,310,268,171
../../CUB_200_2011/images\080.Green_Kingfisher/Green_Kingfisher_0094_71112.jpg,456,500,080.Green_Kingfisher,115,82,389,257,252,169,274,175
../../CUB_200_2011/images\080.Green_Kingfisher/Green_Kingfisher_0037_71113.jpg,500,414,080.Green_Kingfisher,97,51,336,302,216,176,239,251
../../CUB_200_2011/images\080.Green_Kingfisher/Green_Kingfisher_0059_71119.jpg,500,500,080.Green_Kingfisher,70,135,424,357,247,246,354,222
../../CUB_200_2011/images\080.Green_Kingfisher/Green_Kingfisher_0088_71122.jpg,500,333,080.Green_Kingfisher,162,79,354,281,258,180,192,202
../../CUB_200_2011/images\080.Green_Kingfisher/Green_Kingfisher_0077_71129.jpg,444,500,080.Green_Kingfisher,42,25,428,479,235,252,386,454
../../CUB_200_2011/images\080.Green_Kingfisher/Green_Kingfisher_0070_71387.jpg,500,335,080.Green_Kingfisher,127,117,305,243,216,180,178,126
../../CUB_200_2011/images\080.Green_Kingfisher/Green_Kingfisher_0065_71132.jpg,500,346,080.Green_Kingfisher,205,77,352,240,278,158,147,163
../../CUB_200_2011/images\080.Green_Kingfisher/Green_Kingfisher_0035_71133.jpg,500,333,080.Green_Kingfisher,98,80,391,256,244,168,293,176
../../CUB_200_2011/images\080.Green_Kingfisher/Green_Kingfisher_0001_71138.jpg,500,323,080.Green_Kingfisher,142,123,461,276,301,199,319,153
../../CUB_200_2011/images\080.Green_Kingfisher/Green_Kingfisher_0039_71037.jpg,500,333,080.Green_Kingfisher,254,154,390,299,322,226,136,145
../../CUB_200_2011/images\080.Green_Kingfisher/Green_Kingfisher_0020_71155.jpg,362,500,080.Green_Kingfisher,85,131,320,438,202,284,235,307
../../CUB_200_2011/images\080.Green_Kingfisher/Green_Kingfisher_0036_71156.jpg,500,281,080.Green_Kingfisher,141,15,340,149,240,82,199,134
../../CUB_200_2011/images\080.Green_Kingfisher/Green_Kingfisher_0007_71163.jpg,500,376,080.Green_Kingfisher,37,136,245,251,141,193,208,115
../../CUB_200_2011/images\080.Green_Kingfisher/Green_Kingfisher_0048_71164.jpg,500,353,080.Green_Kingfisher,118,129,249,232,183,180,131,103
../../CUB_200_2011/images\081.Pied_Kingfisher/Pied_Kingfisher_0132_72706.jpg,500,334,081.Pied_Kingfisher,181,56,356,298,268,177,175,242
../../CUB_200_2011/images\081.Pied_Kingfisher/Pied_Kingfisher_0080_72199.jpg,399,500,081.Pied_Kingfisher,113,76,358,337,235,206,245,261
../../CUB_200_2011/images\081.Pied_Kingfisher/Pied_Kingfisher_0002_71698.jpg,333,500,081.Pied_Kingfisher,57,105,325,339,191,222,268,234
../../CUB_200_2011/images\081.Pied_Kingfisher/Pied_Kingfisher_0028_72221.jpg,500,333,081.Pied_Kingfisher,82,100,458,281,270,190,376,181
../../CUB_200_2011/images\081.Pied_Kingfisher/Pied_Kingfisher_0040_72739.jpg,500,334,081.Pied_Kingfisher,167,108,308,248,237,178,141,140
../../CUB_200_2011/images\081.Pied_Kingfisher/Pied_Kingfisher_0022_72247.jpg,500,448,081.Pied_Kingfisher,178,188,397,327,287,257,219,139
../../CUB_200_2011/images\081.Pied_Kingfisher/Pied_Kingfisher_0053_72761.jpg,500,333,081.Pied_Kingfisher,180,80,300,208,240,144,120,128
../../CUB_200_2011/images\081.Pied_Kingfisher/Pied_Kingfisher_0128_72775.jpg,500,333,081.Pied_Kingfisher,123,80,333,236,228,158,210,156
../../CUB_200_2011/images\081.Pied_Kingfisher/Pied_Kingfisher_0036_72275.jpg,500,333,081.Pied_Kingfisher,166,115,319,216,242,165,153,101
../../CUB_200_2011/images\081.Pied_Kingfisher/Pied_Kingfisher_0068_72278.jpg,500,354,081.Pied_Kingfisher,81,111,280,234,180,172,199,123
../../CUB_200_2011/images\081.Pied_Kingfisher/Pied_Kingfisher_0016_72280.jpg,500,429,081.Pied_Kingfisher,118,39,243,237,180,138,125,198
../../CUB_200_2011/images\081.Pied_Kingfisher/Pied_Kingfisher_0054_72296.jpg,500,348,081.Pied_Kingfisher,38,46,368,282,203,164,330,236
../../CUB_200_2011/images\081.Pied_Kingfisher/Pied_Kingfisher_0015_72299.jpg,500,415,081.Pied_Kingfisher,51,141,299,264,175,202,248,123
../../CUB_200_2011/images\081.Pied_Kingfisher/Pied_Kingfisher_0122_71789.jpg,500,374,081.Pied_Kingfisher,28,68,386,338,207,203,358,270
../../CUB_200_2011/images\081.Pied_Kingfisher/Pied_Kingfisher_0032_71792.jpg,500,337,081.Pied_Kingfisher,197,97,355,225,276,161,158,128
../../CUB_200_2011/images\081.Pied_Kingfisher/Pied_Kingfisher_0017_72316.jpg,500,375,081.Pied_Kingfisher,95,61,354,288,224,174,259,227
../../CUB_200_2011/images\081.Pied_Kingfisher/Pied_Kingfisher_0031_71829.jpg,333,500,081.Pied_Kingfisher,14,134,291,344,152,239,277,210
../../CUB_200_2011/images\081.Pied_Kingfisher/Pied_Kingfisher_0102_72349.jpg,373,500,081.Pied_Kingfisher,67,105,344,338,205,221,277,233
../../CUB_200_2011/images\081.Pied_Kingfisher/Pied_Kingfisher_0121_72378.jpg,500,333,081.Pied_Kingfisher,15,10,467,323,241,166,452,313
../../CUB_200_2011/images\081.Pied_Kingfisher/Pied_Kingfisher_0062_72379.jpg,500,335,081.Pied_Kingfisher,190,64,348,304,269,184,158,240
../../CUB_200_2011/images\081.Pied_Kingfisher/Pied_Kingfisher_0065_71871.jpg,500,333,081.Pied_Kingfisher,125,157,464,277,294,217,339,120
../../CUB_200_2011/images\081.Pied_Kingfisher/Pied_Kingfisher_0026_71875.jpg,500,363,081.Pied_Kingfisher,233,79,471,252,352,165,238,173
../../CUB_200_2011/images\081.Pied_Kingfisher/Pied_Kingfisher_0033_71883.jpg,500,248,081.Pied_Kingfisher,235,31,448,161,341,96,213,130
../../CUB_200_2011/images\081.Pied_Kingfisher/Pied_Kingfisher_0047_72401.jpg,500,413,081.Pied_Kingfisher,98,109,382,307,240,208,284,198
../../CUB_200_2011/images\081.Pied_Kingfisher/Pied_Kingfisher_0097_71895.jpg,400,266,081.Pied_Kingfisher,60,33,309,176,184,104,249,143
../../CUB_200_2011/images\081.Pied_Kingfisher/Pied_Kingfisher_0116_71900.jpg,500,333,081.Pied_Kingfisher,232,42,445,205,338,123,213,163
../../CUB_200_2011/images\081.Pied_Kingfisher/Pied_Kingfisher_0106_71404.jpg,500,476,081.Pied_Kingfisher,68,87,462,389,265,238,394,302
../../CUB_200_2011/images\081.Pied_Kingfisher/Pied_Kingfisher_0083_72430.jpg,500,341,081.Pied_Kingfisher,160,121,309,236,234,178,149,115
../../CUB_200_2011/images\081.Pied_Kingfisher/Pied_Kingfisher_0061_72193.jpg,374,500,081.Pied_Kingfisher,72,170,260,334,166,252,188,164
../../CUB_200_2011/images\081.Pied_Kingfisher/Pied_Kingfisher_0029_72440.jpg,500,333,081.Pied_Kingfisher,41,57,356,287,198,172,315,230
../../CUB_200_2011/images\081.Pied_Kingfisher/Pied_Kingfisher_0051_71429.jpg,500,421,081.Pied_Kingfisher,10,90,441,316,225,203,431,226
../../CUB_200_2011/images\081.Pied_Kingfisher/Pied_Kingfisher_0027_71434.jpg,500,379,081.Pied_Kingfisher,165,88,399,277,282,182,234,189
../../CUB_200_2011/images\081.Pied_Kingfisher/Pied_Kingfisher_0117_71947.jpg,500,334,081.Pied_Kingfisher,61,81,374,302,217,191,313,221
../../CUB_200_2011/images\081.Pied_Kingfisher/Pied_Kingfisher_0093_72465.jpg,500,375,081.Pied_Kingfisher,46,86,368,265,207,175,322,179
../../CUB_200_2011/images\081.Pied_Kingfisher/Pied_Kingfisher_0025_72469.jpg,500,344,081.Pied_Kingfisher,137,37,363,196,250,116,226,159
../../CUB_200_2011/images\081.Pied_Kingfisher/Pied_Kingfisher_0075_72581.jpg,500,276,081.Pied_Kingfisher,85,87,333,218,209,152,248,131
../../CUB_200_2011/images\081.Pied_Kingfisher/Pied_Kingfisher_0059_72492.jpg,500,375,081.Pied_Kingfisher,189,117,351,232,270,174,162,115
../../CUB_200_2011/images\081.Pied_Kingfisher/Pied_Kingfisher_0078_71985.jpg,500,333,081.Pied_Kingfisher,193,50,406,316,299,183,213,266
../../CUB_200_2011/images\081.Pied_Kingfisher/Pied_Kingfisher_0021_72498.jpg,500,375,081.Pied_Kingfisher,58,126,333,247,195,186,275,121
../../CUB_200_2011/images\081.Pied_Kingfisher/Pied_Kingfisher_0107_71987.jpg,333,500,081.Pied_Kingfisher,91,83,227,287,159,185,136,204
../../CUB_200_2011/images\081.Pied_Kingfisher/Pied_Kingfisher_0073_72508.jpg,500,394,081.Pied_Kingfisher,96,93,345,347,220,220,249,254
../../CUB_200_2011/images\081.Pied_Kingfisher/Pied_Kingfisher_0063_71999.jpg,500,322,081.Pied_Kingfisher,31,42,266,231,148,136,235,189
../../CUB_200_2011/images\081.Pied_Kingfisher/Pied_Kingfisher_0095_72008.jpg,500,333,081.Pied_Kingfisher,87,67,382,230,234,148,295,163
../../CUB_200_2011/images\081.Pied_Kingfisher/Pied_Kingfisher_0071_72576.jpg,322,352,081.Pied_Kingfisher,82,35,248,291,165,163,166,256
../../CUB_200_2011/images\081.Pied_Kingfisher/Pied_Kingfisher_0074_71830.jpg,500,345,081.Pied_Kingfisher,138,45,318,165,228,105,180,120
../../CUB_200_2011/images\081.Pied_Kingfisher/Pied_Kingfisher_0024_71560.jpg,500,375,081.Pied_Kingfisher,191,116,336,258,263,187,145,142
../../CUB_200_2011/images\081.Pied_Kingfisher/Pied_Kingfisher_0109_72082.jpg,500,333,081.Pied_Kingfisher,148,9,439,327,293,168,291,318
../../CUB_200_2011/images\081.Pied_Kingfisher/Pied_Kingfisher_0030_72603.jpg,500,375,081.Pied_Kingfisher,54,47,423,313,238,180,369,266
../../CUB_200_2011/images\081.Pied_Kingfisher/Pied_Kingfisher_0013_72114.jpg,500,342,081.Pied_Kingfisher,167,98,373,203,270,150,206,105
../../CUB_200_2011/images\081.Pied_Kingfisher/Pied_Kingfisher_0118_72115.jpg,500,406,081.Pied_Kingfisher,38,15,428,287,233,151,390,272
../../CUB_200_2011/images\081.Pied_Kingfisher/Pied_Kingfisher_0014_72119.jpg,500,375,081.Pied_Kingfisher,15,64,471,266,243,165,456,202
../../CUB_200_2011/images\081.Pied_Kingfisher/Pied_Kingfisher_0007_72438.jpg,500,450,081.Pied_Kingfisher,218,154,429,410,323,282,211,256
../../CUB_200_2011/images\081.Pied_Kingfisher/Pied_Kingfisher_0004_72135.jpg,500,333,081.Pied_Kingfisher,109,79,373,284,241,181,264,205
../../CUB_200_2011/images\081.Pied_Kingfisher/Pied_Kingfisher_0011_72143.jpg,500,375,081.Pied_Kingfisher,169,72,430,274,299,173,261,202
../../CUB_200_2011/images\081.Pied_Kingfisher/Pied_Kingfisher_0019_72659.jpg,500,375,081.Pied_Kingfisher,94,98,345,269,219,183,251,171
../../CUB_200_2011/images\081.Pied_Kingfisher/Pied_Kingfisher_0067_71641.jpg,500,333,081.Pied_Kingfisher,113,40,389,297,251,168,276,257
../../CUB_200_2011/images\081.Pied_Kingfisher/Pied_Kingfisher_0046_72156.jpg,500,420,081.Pied_Kingfisher,37,100,402,300,219,200,365,200
../../CUB_200_2011/images\081.Pied_Kingfisher/Pied_Kingfisher_0045_71143.jpg,500,415,081.Pied_Kingfisher,216,119,468,286,342,202,252,167
../../CUB_200_2011/images\081.Pied_Kingfisher/Pied_Kingfisher_0018_71657.jpg,500,373,081.Pied_Kingfisher,12,47,440,281,226,164,428,234
../../CUB_200_2011/images\081.Pied_Kingfisher/Pied_Kingfisher_0085_71557.jpg,500,374,081.Pied_Kingfisher,83,94,288,232,185,163,205,138
../../CUB_200_2011/images\082.Ringed_Kingfisher/Ringed_Kingfisher_0079_72961.jpg,500,374,082.Ringed_Kingfisher,195,107,443,271,319,189,248,164
../../CUB_200_2011/images\082.Ringed_Kingfisher/Ringed_Kingfisher_0004_72966.jpg,373,500,082.Ringed_Kingfisher,42,60,346,363,194,211,304,303
../../CUB_200_2011/images\082.Ringed_Kingfisher/Ringed_Kingfisher_0012_72974.jpg,500,375,082.Ringed_Kingfisher,177,72,318,290,247,181,141,218
../../CUB_200_2011/images\082.Ringed_Kingfisher/Ringed_Kingfisher_0033_73133.jpg,500,333,082.Ringed_Kingfisher,159,132,291,241,225,186,132,109
../../CUB_200_2011/images\082.Ringed_Kingfisher/Ringed_Kingfisher_0044_72976.jpg,500,375,082.Ringed_Kingfisher,44,106,281,285,162,195,237,179
../../CUB_200_2011/images\082.Ringed_Kingfisher/Ringed_Kingfisher_0011_72982.jpg,500,324,082.Ringed_Kingfisher,120,73,342,285,231,179,222,212
../../CUB_200_2011/images\082.Ringed_Kingfisher/Ringed_Kingfisher_0107_72983.jpg,500,336,082.Ringed_Kingfisher,137,73,391,297,264,185,254,224
../../CUB_200_2011/images\082.Ringed_Kingfisher/Ringed_Kingfisher_0075_73135.jpg,500,361,082.Ringed_Kingfisher,176,46,329,330,252,188,153,284
../../CUB_200_2011/images\082.Ringed_Kingfisher/Ringed_Kingfisher_0003_72994.jpg,500,375,082.Ringed_Kingfisher,175,58,327,350,251,204,152,292
../../CUB_200_2011/images\082.Ringed_Kingfisher/Ringed_Kingfisher_0051_72997.jpg,500,332,082.Ringed_Kingfisher,107,117,275,222,191,169,168,105
../../CUB_200_2011/images\082.Ringed_Kingfisher/Ringed_Kingfisher_0094_72998.jpg,500,342,082.Ringed_Kingfisher,130,70,335,262,232,166,205,192
../../CUB_200_2011/images\082.Ringed_Kingfisher/Ringed_Kingfisher_0050_73002.jpg,500,333,082.Ringed_Kingfisher,39,62,483,284,261,173,444,222
../../CUB_200_2011/images\082.Ringed_Kingfisher/Ringed_Kingfisher_0076_73095.jpg,300,450,082.Ringed_Kingfisher,57,71,200,186,128,128,143,115
../../CUB_200_2011/images\082.Ringed_Kingfisher/Ringed_Kingfisher_0035_73012.jpg,500,349,082.Ringed_Kingfisher,174,81,394,235,284,158,220,154
../../CUB_200_2011/images\082.Ringed_Kingfisher/Ringed_Kingfisher_0028_73018.jpg,500,354,082.Ringed_Kingfisher,101,127,240,269,170,198,139,142
../../CUB_200_2011/images\082.Ringed_Kingfisher/Ringed_Kingfisher_0016_73029.jpg,500,375,082.Ringed_Kingfisher,166,162,383,282,274,222,217,120
../../CUB_200_2011/images\082.Ringed_Kingfisher/Ringed_Kingfisher_0039_71052.jpg,357,500,082.Ringed_Kingfisher,13,102,318,353,165,227,305,251
../../CUB_200_2011/images\082.Ringed_Kingfisher/Ringed_Kingfisher_0038_73041.jpg,500,375,082.Ringed_Kingfisher,81,65,322,311,201,188,241,246
../../CUB_200_2011/images\082.Ringed_Kingfisher/Ringed_Kingfisher_0009_72786.jpg,500,333,082.Ringed_Kingfisher,132,48,341,264,236,156,209,216
../../CUB_200_2011/images\082.Ringed_Kingfisher/Ringed_Kingfisher_0001_73048.jpg,500,500,082.Ringed_Kingfisher,83,97,421,274,252,185,338,177
../../CUB_200_2011/images\082.Ringed_Kingfisher/Ringed_Kingfisher_0087_72794.jpg,500,333,082.Ringed_Kingfisher,214,27,446,279,330,153,232,252
../../CUB_200_2011/images\082.Ringed_Kingfisher/Ringed_Kingfisher_0025_72795.jpg,500,324,082.Ringed_Kingfisher,77,29,487,316,282,172,410,287
../../CUB_200_2011/images\082.Ringed_Kingfisher/Ringed_Kingfisher_0083_73053.jpg,500,375,082.Ringed_Kingfisher,119,118,316,271,217,194,197,153
../../CUB_200_2011/images\082.Ringed_Kingfisher/Ringed_Kingfisher_0014_72798.jpg,500,371,082.Ringed_Kingfisher,142,103,403,344,272,223,261,241
../../CUB_200_2011/images\082.Ringed_Kingfisher/Ringed_Kingfisher_0057_72812.jpg,500,335,082.Ringed_Kingfisher,238,88,447,233,342,160,209,145
../../CUB_200_2011/images\082.Ringed_Kingfisher/Ringed_Kingfisher_0078_72826.jpg,500,333,082.Ringed_Kingfisher,120,76,398,278,259,177,278,202
../../CUB_200_2011/images\082.Ringed_Kingfisher/Ringed_Kingfisher_0005_73086.jpg,500,357,082.Ringed_Kingfisher,165,67,327,282,246,174,162,215
../../CUB_200_2011/images\082.Ringed_Kingfisher/Ringed_Kingfisher_0015_72835.jpg,500,417,082.Ringed_Kingfisher,142,154,405,294,273,224,263,140
../../CUB_200_2011/images\082.Ringed_Kingfisher/Ringed_Kingfisher_0091_72839.jpg,500,355,082.Ringed_Kingfisher,29,27,423,333,226,180,394,306
../../CUB_200_2011/images\082.Ringed_Kingfisher/Ringed_Kingfisher_0021_72848.jpg,500,334,082.Ringed_Kingfisher,207,95,348,298,277,196,141,203
../../CUB_200_2011/images\082.Ringed_Kingfisher/Ringed_Kingfisher_0040_72852.jpg,500,332,082.Ringed_Kingfisher,87,104,302,287,194,195,215,183
../../CUB_200_2011/images\082.Ringed_Kingfisher/Ringed_Kingfisher_0041_72853.jpg,500,370,082.Ringed_Kingfisher,156,128,392,244,274,186,236,116
../../CUB_200_2011/images\082.Ringed_Kingfisher/Ringed_Kingfisher_0098_73110.jpg,344,500,082.Ringed_Kingfisher,74,107,248,390,161,248,174,283
../../CUB_200_2011/images\082.Ringed_Kingfisher/Ringed_Kingfisher_0073_73118.jpg,390,487,082.Ringed_Kingfisher,131,45,387,344,259,194,256,299
../../CUB_200_2011/images\082.Ringed_Kingfisher/Ringed_Kingfisher_0056_72863.jpg,500,333,082.Ringed_Kingfisher,185,46,430,277,307,161,245,231
../../CUB_200_2011/images\082.Ringed_Kingfisher/Ringed_Kingfisher_0026_72867.jpg,500,333,082.Ringed_Kingfisher,97,43,225,319,161,181,128,276
../../CUB_200_2011/images\082.Ringed_Kingfisher/Ringed_Kingfisher_0052_72871.jpg,500,375,082.Ringed_Kingfisher,146,130,319,324,232,227,173,194
../../CUB_200_2011/images\082.Ringed_Kingfisher/Ringed_Kingfisher_0077_72872.jpg,500,374,082.Ringed_Kingfisher,122,48,349,333,235,190,227,285
../../CUB_200_2011/images\082.Ringed_Kingfisher/Ringed_Kingfisher_0074_73130.jpg,500,334,082.Ringed_Kingfisher,273,38,429,247,351,142,156,209
../../CUB_200_2011/images\082.Ringed_Kingfisher/Ringed_Kingfisher_0053_72875.jpg,500,333,082.Ringed_Kingfisher,214,24,480,329,347,176,266,305
../../CUB_200_2011/images\082.Ringed_Kingfisher/Ringed_Kingfisher_0060_73132.jpg,404,500,082.Ringed_Kingfisher,102,64,275,453,188,258,173,389
../../CUB_200_2011/images\082.Ringed_Kingfisher/Ringed_Kingfisher_0043_72877.jpg,500,333,082.Ringed_Kingfisher,169,44,320,295,244,169,151,251
../../CUB_200_2011/images\082.Ringed_Kingfisher/Ringed_Kingfisher_0020_72888.jpg,500,333,082.Ringed_Kingfisher,28,32,369,295,198,163,341,263
../../CUB_200_2011/images\082.Ringed_Kingfisher/Ringed_Kingfisher_0017_73145.jpg,500,333,082.Ringed_Kingfisher,208,114,316,248,262,181,108,134
../../CUB_200_2011/images\082.Ringed_Kingfisher/Ringed_Kingfisher_0103_72894.jpg,357,500,082.Ringed_Kingfisher,67,125,276,305,171,215,209,180
../../CUB_200_2011/images\082.Ringed_Kingfisher/Ringed_Kingfisher_0023_72910.jpg,400,500,082.Ringed_Kingfisher,124,138,387,340,255,239,263,202
../../CUB_200_2011/images\082.Ringed_Kingfisher/Ringed_Kingfisher_0029_73165.jpg,500,375,082.Ringed_Kingfisher,121,118,348,325,234,221,227,207
../../CUB_200_2011/images\082.Ringed_Kingfisher/Ringed_Kingfisher_0042_72913.jpg,500,310,082.Ringed_Kingfisher,215,51,405,189,310,120,190,138
../../CUB_200_2011/images\082.Ringed_Kingfisher/Ringed_Kingfisher_0101_72919.jpg,500,394,082.Ringed_Kingfisher,168,125,365,254,266,189,197,129
../../CUB_200_2011/images\082.Ringed_Kingfisher/Ringed_Kingfisher_0024_73178.jpg,500,333,082.Ringed_Kingfisher,105,77,433,270,269,173,328,193
../../CUB_200_2011/images\082.Ringed_Kingfisher/Ringed_Kingfisher_0080_72923.jpg,333,500,082.Ringed_Kingfisher,104,96,211,331,157,213,107,235
../../CUB_200_2011/images\082.Ringed_Kingfisher/Ringed_Kingfisher_0108_73169.jpg,500,392,082.Ringed_Kingfisher,154,123,300,227,227,175,146,104
../../CUB_200_2011/images\082.Ringed_Kingfisher/Ringed_Kingfisher_0102_72941.jpg,500,375,082.Ringed_Kingfisher,178,136,300,243,239,189,122,107
../../CUB_200_2011/images\082.Ringed_Kingfisher/Ringed_Kingfisher_0008_72943.jpg,317,500,082.Ringed_Kingfisher,35,63,221,336,128,199,186,273
../../CUB_200_2011/images\082.Ringed_Kingfisher/Ringed_Kingfisher_0089_72947.jpg,500,333,082.Ringed_Kingfisher,26,128,305,298,165,213,279,170
../../CUB_200_2011/images\082.Ringed_Kingfisher/Ringed_Kingfisher_0027_72948.jpg,461,500,082.Ringed_Kingfisher,48,75,403,416,225,245,355,341
../../CUB_200_2011/images\082.Ringed_Kingfisher/Ringed_Kingfisher_0072_72954.jpg,410,500,082.Ringed_Kingfisher,119,112,309,423,214,267,190,311
../../CUB_200_2011/images\082.Ringed_Kingfisher/Ringed_Kingfisher_0082_72955.jpg,500,394,082.Ringed_Kingfisher,180,121,429,308,304,214,249,187
../../CUB_200_2011/images\082.Ringed_Kingfisher/Ringed_Kingfisher_0018_72957.jpg,500,334,082.Ringed_Kingfisher,156,68,338,309,247,188,182,241
../../CUB_200_2011/images\082.Ringed_Kingfisher/Ringed_Kingfisher_0071_72958.jpg,466,338,082.Ringed_Kingfisher,100,46,353,297,226,171,253,251
../../CUB_200_2011/images\083.White_breasted_Kingfisher/White_Breasted_Kingfisher_0037_73220.jpg,364,500,083.White_breasted_Kingfisher,33,107,325,408,179,257,292,301
../../CUB_200_2011/images\083.White_breasted_Kingfisher/White_Breasted_Kingfisher_0024_73736.jpg,500,442,083.White_breasted_Kingfisher,68,140,346,436,207,288,278,296
../../CUB_200_2011/images\083.White_breasted_Kingfisher/White_Breasted_Kingfisher_0098_73227.jpg,500,335,083.White_breasted_Kingfisher,36,35,351,317,193,176,315,282
../../CUB_200_2011/images\083.White_breasted_Kingfisher/White_Breasted_Kingfisher_0004_73741.jpg,500,282,083.White_breasted_Kingfisher,55,38,188,218,121,128,133,180
../../CUB_200_2011/images\083.White_breasted_Kingfisher/White_Breasted_Kingfisher_0023_73230.jpg,375,500,083.White_breasted_Kingfisher,128,139,237,332,182,235,109,193
../../CUB_200_2011/images\083.White_breasted_Kingfisher/White_Breasted_Kingfisher_0029_73233.jpg,500,333,083.White_breasted_Kingfisher,118,70,306,308,212,189,188,238
../../CUB_200_2011/images\083.White_breasted_Kingfisher/White_Breasted_Kingfisher_0002_73491.jpg,500,498,083.White_breasted_Kingfisher,207,178,332,340,269,259,125,162
../../CUB_200_2011/images\083.White_breasted_Kingfisher/White_Breasted_Kingfisher_0071_73236.jpg,469,298,083.White_breasted_Kingfisher,160,15,370,295,265,155,210,280
../../CUB_200_2011/images\083.White_breasted_Kingfisher/White_Breasted_Kingfisher_0053_73476.jpg,333,500,083.White_breasted_Kingfisher,88,98,275,447,181,272,187,349
../../CUB_200_2011/images\083.White_breasted_Kingfisher/White_Breasted_Kingfisher_0073_73498.jpg,500,274,083.White_breasted_Kingfisher,156,48,345,266,250,157,189,218
../../CUB_200_2011/images\083.White_breasted_Kingfisher/White_Breasted_Kingfisher_0084_73247.jpg,500,354,083.White_breasted_Kingfisher,172,113,362,328,267,220,190,215
../../CUB_200_2011/images\083.White_breasted_Kingfisher/White_Breasted_Kingfisher_0032_73248.jpg,500,365,083.White_breasted_Kingfisher,177,13,451,336,314,174,274,323
../../CUB_200_2011/images\083.White_breasted_Kingfisher/White_Breasted_Kingfisher_0047_73251.jpg,500,333,083.White_breasted_Kingfisher,175,117,333,237,254,177,158,120
../../CUB_200_2011/images\083.White_breasted_Kingfisher/White_Breasted_Kingfisher_0115_73252.jpg,500,398,083.White_breasted_Kingfisher,75,87,378,376,226,231,303,289
../../CUB_200_2011/images\083.White_breasted_Kingfisher/White_Breasted_Kingfisher_0121_73258.jpg,500,333,083.White_breasted_Kingfisher,227,70,448,259,337,164,221,189
../../CUB_200_2011/images\083.White_breasted_Kingfisher/White_Breasted_Kingfisher_0101_73261.jpg,500,425,083.White_breasted_Kingfisher,48,191,203,333,125,262,155,142
../../CUB_200_2011/images\083.White_breasted_Kingfisher/White_Breasted_Kingfisher_0087_73264.jpg,500,383,083.White_breasted_Kingfisher,289,67,442,253,365,160,153,186
../../CUB_200_2011/images\083.White_breasted_Kingfisher/White_Breasted_Kingfisher_0107_73265.jpg,500,400,083.White_breasted_Kingfisher,17,105,419,336,218,220,402,231
../../CUB_200_2011/images\083.White_breasted_Kingfisher/White_Breasted_Kingfisher_0040_73266.jpg,500,347,083.White_breasted_Kingfisher,49,61,328,302,188,181,279,241
../../CUB_200_2011/images\083.White_breasted_Kingfisher/White_Breasted_Kingfisher_0011_73267.jpg,500,333,083.White_breasted_Kingfisher,37,37,372,262,204,149,335,225
../../CUB_200_2011/images\083.White_breasted_Kingfisher/White_Breasted_Kingfisher_0117_73283.jpg,463,500,083.White_breasted_Kingfisher,109,63,400,453,254,258,291,390
../../CUB_200_2011/images\083.White_breasted_Kingfisher/White_Breasted_Kingfisher_0035_73290.jpg,500,383,083.White_breasted_Kingfisher,85,99,235,349,160,224,150,250
../../CUB_200_2011/images\083.White_breasted_Kingfisher/White_Breasted_Kingfisher_0048_73292.jpg,500,313,083.White_breasted_Kingfisher,255,129,442,272,348,200,187,143
../../CUB_200_2011/images\083.White_breasted_Kingfisher/White_Breasted_Kingfisher_0116_73295.jpg,500,380,083.White_breasted_Kingfisher,44,50,235,329,139,189,191,279
../../CUB_200_2011/images\083.White_breasted_Kingfisher/White_Breasted_Kingfisher_0096_73552.jpg,500,386,083.White_breasted_Kingfisher,88,123,294,344,191,233,206,221
../../CUB_200_2011/images\083.White_breasted_Kingfisher/White_Breasted_Kingfisher_0067_73300.jpg,428,500,083.White_breasted_Kingfisher,179,153,360,423,269,288,181,270
../../CUB_200_2011/images\083.White_breasted_Kingfisher/White_Breasted_Kingfisher_0019_73306.jpg,500,327,083.White_breasted_Kingfisher,80,89,231,283,155,186,151,194
../../CUB_200_2011/images\083.White_breasted_Kingfisher/White_Breasted_Kingfisher_0093_73311.jpg,500,385,083.White_breasted_Kingfisher,196,89,312,326,254,207,116,237
../../CUB_200_2011/images\083.White_breasted_Kingfisher/White_Breasted_Kingfisher_0103_73316.jpg,500,391,083.White_breasted_Kingfisher,172,113,439,339,305,226,267,226
../../CUB_200_2011/images\083.White_breasted_Kingfisher/White_Breasted_Kingfisher_0054_73587.jpg,500,334,083.White_breasted_Kingfisher,125,43,348,293,236,168,223,250
../../CUB_200_2011/images\083.White_breasted_Kingfisher/White_Breasted_Kingfisher_0030_73335.jpg,500,376,083.White_breasted_Kingfisher,150,79,303,243,226,161,153,164
../../CUB_200_2011/images\083.White_breasted_Kingfisher/White_Breasted_Kingfisher_0003_73195.jpg,500,375,083.White_breasted_Kingfisher,182,69,350,238,266,153,168,169
../../CUB_200_2011/images\083.White_breasted_Kingfisher/White_Breasted_Kingfisher_0045_73600.jpg,354,500,083.White_breasted_Kingfisher,29,51,224,472,126,261,195,421
../../CUB_200_2011/images\083.White_breasted_Kingfisher/White_Breasted_Kingfisher_0056_73353.jpg,500,375,083.White_breasted_Kingfisher,185,92,304,276,244,184,119,184
../../CUB_200_2011/images\083.White_breasted_Kingfisher/White_Breasted_Kingfisher_0017_73355.jpg,481,500,083.White_breasted_Kingfisher,115,133,333,398,224,265,218,265
../../CUB_200_2011/images\083.White_breasted_Kingfisher/White_Breasted_Kingfisher_0085_73363.jpg,500,367,083.White_breasted_Kingfisher,38,80,275,329,156,204,237,249
../../CUB_200_2011/images\083.White_breasted_Kingfisher/White_Breasted_Kingfisher_0063_73365.jpg,500,375,083.White_breasted_Kingfisher,178,36,437,371,307,203,259,335
../../CUB_200_2011/images\083.White_breasted_Kingfisher/White_Breasted_Kingfisher_0012_73367.jpg,375,500,083.White_breasted_Kingfisher,81,82,370,458,225,270,289,376
../../CUB_200_2011/images\083.White_breasted_Kingfisher/White_Breasted_Kingfisher_0111_73369.jpg,360,500,083.White_breasted_Kingfisher,121,111,282,275,201,193,161,164
../../CUB_200_2011/images\083.White_breasted_Kingfisher/White_Breasted_Kingfisher_0089_73371.jpg,500,332,083.White_breasted_Kingfisher,174,99,380,318,277,208,206,219
../../CUB_200_2011/images\083.White_breasted_Kingfisher/White_Breasted_Kingfisher_0065_73372.jpg,375,500,083.White_breasted_Kingfisher,108,104,306,419,207,261,198,315
../../CUB_200_2011/images\083.White_breasted_Kingfisher/White_Breasted_Kingfisher_0078_73373.jpg,500,313,083.White_breasted_Kingfisher,181,25,321,236,251,130,140,211
../../CUB_200_2011/images\083.White_breasted_Kingfisher/White_Breasted_Kingfisher_0088_73386.jpg,333,500,083.White_breasted_Kingfisher,42,70,311,305,176,187,269,235
../../CUB_200_2011/images\083.White_breasted_Kingfisher/White_Breasted_Kingfisher_0104_73398.jpg,468,331,083.White_breasted_Kingfisher,164,80,359,279,261,179,195,199
../../CUB_200_2011/images\083.White_breasted_Kingfisher/White_Breasted_Kingfisher_0119_73401.jpg,500,357,083.White_breasted_Kingfisher,135,83,456,309,295,196,321,226
../../CUB_200_2011/images\083.White_breasted_Kingfisher/White_Breasted_Kingfisher_0036_73403.jpg,500,375,083.White_breasted_Kingfisher,69,98,348,276,208,187,279,178
../../CUB_200_2011/images\083.White_breasted_Kingfisher/White_Breasted_Kingfisher_0109_73683.jpg,353,500,083.White_breasted_Kingfisher,118,173,271,356,194,264,153,183
../../CUB_200_2011/images\083.White_breasted_Kingfisher/White_Breasted_Kingfisher_0074_73408.jpg,500,334,083.White_breasted_Kingfisher,178,139,285,282,231,210,107,143
../../CUB_200_2011/images\083.White_breasted_Kingfisher/White_Breasted_Kingfisher_0049_73420.jpg,500,375,083.White_breasted_Kingfisher,141,67,320,310,230,188,179,243
../../CUB_200_2011/images\083.White_breasted_Kingfisher/White_Breasted_Kingfisher_0062_73425.jpg,317,500,083.White_breasted_Kingfisher,87,57,275,330,181,193,188,273
../../CUB_200_2011/images\083.White_breasted_Kingfisher/White_Breasted_Kingfisher_0050_73682.jpg,500,347,083.White_breasted_Kingfisher,138,117,269,269,203,193,131,152
../../CUB_200_2011/images\083.White_breasted_Kingfisher/White_Breasted_Kingfisher_0120_73439.jpg,500,319,083.White_breasted_Kingfisher,175,94,303,239,239,166,128,145
../../CUB_200_2011/images\083.White_breasted_Kingfisher/White_Breasted_Kingfisher_0018_71137.jpg,500,375,083.White_breasted_Kingfisher,62,56,438,350,250,203,376,294
../../CUB_200_2011/images\083.White_breasted_Kingfisher/White_Breasted_Kingfisher_0052_73446.jpg,500,333,083.White_breasted_Kingfisher,203,64,366,313,284,188,163,249
../../CUB_200_2011/images\083.White_breasted_Kingfisher/White_Breasted_Kingfisher_0015_73192.jpg,362,500,083.White_breasted_Kingfisher,155,140,276,411,215,275,121,271
../../CUB_200_2011/images\083.White_breasted_Kingfisher/White_Breasted_Kingfisher_0118_73511.jpg,500,338,083.White_breasted_Kingfisher,204,99,430,246,317,172,226,147
../../CUB_200_2011/images\083.White_breasted_Kingfisher/White_Breasted_Kingfisher_0122_73199.jpg,356,500,083.White_breasted_Kingfisher,63,17,346,497,204,257,283,480
../../CUB_200_2011/images\083.White_breasted_Kingfisher/White_Breasted_Kingfisher_0026_73201.jpg,500,375,083.White_breasted_Kingfisher,52,84,429,336,240,210,377,252
../../CUB_200_2011/images\083.White_breasted_Kingfisher/White_Breasted_Kingfisher_0022_73459.jpg,500,339,083.White_breasted_Kingfisher,91,28,396,332,243,180,305,304
../../CUB_200_2011/images\083.White_breasted_Kingfisher/White_Breasted_Kingfisher_0123_73211.jpg,500,353,083.White_breasted_Kingfisher,137,61,339,318,238,189,202,257
../../CUB_200_2011/images\084.Red_legged_Kittiwake/Red_Legged_Kittiwake_0001_795394.jpg,500,333,084.Red_legged_Kittiwake,47,78,415,219,231,148,368,141
../../CUB_200_2011/images\084.Red_legged_Kittiwake/Red_Legged_Kittiwake_0033_795395.jpg,500,500,084.Red_legged_Kittiwake,86,117,447,442,266,279,361,325
../../CUB_200_2011/images\084.Red_legged_Kittiwake/Red_Legged_Kittiwake_0054_795396.jpg,500,353,084.Red_legged_Kittiwake,17,33,479,303,248,168,462,270
../../CUB_200_2011/images\084.Red_legged_Kittiwake/Red_Legged_Kittiwake_0050_795397.jpg,500,413,084.Red_legged_Kittiwake,159,44,419,357,289,200,260,313
../../CUB_200_2011/images\084.Red_legged_Kittiwake/Red_Legged_Kittiwake_0019_795398.jpg,350,350,084.Red_legged_Kittiwake,57,24,295,276,176,150,238,252
../../CUB_200_2011/images\084.Red_legged_Kittiwake/Red_Legged_Kittiwake_0032_795399.jpg,377,500,084.Red_legged_Kittiwake,126,85,355,377,240,231,229,292
../../CUB_200_2011/images\084.Red_legged_Kittiwake/Red_Legged_Kittiwake_0067_795401.jpg,395,350,084.Red_legged_Kittiwake,40,80,349,261,194,170,309,181
../../CUB_200_2011/images\084.Red_legged_Kittiwake/Red_Legged_Kittiwake_0007_795402.jpg,395,307,084.Red_legged_Kittiwake,38,56,346,236,192,146,308,180
../../CUB_200_2011/images\084.Red_legged_Kittiwake/Red_Legged_Kittiwake_0029_795403.jpg,500,375,084.Red_legged_Kittiwake,137,57,419,271,278,164,282,214
../../CUB_200_2011/images\084.Red_legged_Kittiwake/Red_Legged_Kittiwake_0051_795404.jpg,364,271,084.Red_legged_Kittiwake,26,34,358,246,192,140,332,212
../../CUB_200_2011/images\084.Red_legged_Kittiwake/Red_Legged_Kittiwake_0013_795413.jpg,500,357,084.Red_legged_Kittiwake,146,82,289,294,217,188,143,212
../../CUB_200_2011/images\084.Red_legged_Kittiwake/Red_Legged_Kittiwake_0060_795414.jpg,250,219,084.Red_legged_Kittiwake,27,35,220,194,123,114,193,159
../../CUB_200_2011/images\084.Red_legged_Kittiwake/Red_Legged_Kittiwake_0043_795416.jpg,334,500,084.Red_legged_Kittiwake,26,120,270,422,148,271,244,302
../../CUB_200_2011/images\084.Red_legged_Kittiwake/Red_Legged_Kittiwake_0058_795417.jpg,500,334,084.Red_legged_Kittiwake,152,67,434,301,293,184,282,234
../../CUB_200_2011/images\084.Red_legged_Kittiwake/Red_Legged_Kittiwake_0022_795418.jpg,350,304,084.Red_legged_Kittiwake,8,74,341,230,174,152,333,156
../../CUB_200_2011/images\084.Red_legged_Kittiwake/Red_Legged_Kittiwake_0066_795419.jpg,350,350,084.Red_legged_Kittiwake,6,54,301,278,153,166,295,224
../../CUB_200_2011/images\084.Red_legged_Kittiwake/Red_Legged_Kittiwake_0064_795422.jpg,500,387,084.Red_legged_Kittiwake,55,101,345,274,200,187,290,173
../../CUB_200_2011/images\084.Red_legged_Kittiwake/Red_Legged_Kittiwake_0059_795424.jpg,500,375,084.Red_legged_Kittiwake,58,95,320,305,189,200,262,210
../../CUB_200_2011/images\084.Red_legged_Kittiwake/Red_Legged_Kittiwake_0045_795426.jpg,400,266,084.Red_legged_Kittiwake,130,71,330,204,230,137,200,133
../../CUB_200_2011/images\084.Red_legged_Kittiwake/Red_Legged_Kittiwake_0039_795429.jpg,386,250,084.Red_legged_Kittiwake,118,38,296,181,207,109,178,143
../../CUB_200_2011/images\084.Red_legged_Kittiwake/Red_Legged_Kittiwake_0068_795430.jpg,499,333,084.Red_legged_Kittiwake,189,68,426,269,307,168,237,201
../../CUB_200_2011/images\084.Red_legged_Kittiwake/Red_Legged_Kittiwake_0014_795432.jpg,500,363,084.Red_legged_Kittiwake,112,75,396,315,254,195,284,240
../../CUB_200_2011/images\084.Red_legged_Kittiwake/Red_Legged_Kittiwake_0048_73770.jpg,500,432,084.Red_legged_Kittiwake,69,90,315,341,192,215,246,251
../../CUB_200_2011/images\084.Red_legged_Kittiwake/Red_Legged_Kittiwake_0069_795435.jpg,400,286,084.Red_legged_Kittiwake,51,73,264,219,157,146,213,146
../../CUB_200_2011/images\084.Red_legged_Kittiwake/Red_Legged_Kittiwake_0006_795436.jpg,500,331,084.Red_legged_Kittiwake,157,100,377,316,267,208,220,216
../../CUB_200_2011/images\084.Red_legged_Kittiwake/Red_Legged_Kittiwake_0072_795438.jpg,500,374,084.Red_legged_Kittiwake,169,80,428,300,298,190,259,220
../../CUB_200_2011/images\084.Red_legged_Kittiwake/Red_Legged_Kittiwake_0020_795439.jpg,140,179,084.Red_legged_Kittiwake,4,5,137,173,70,89,133,168
../../CUB_200_2011/images\084.Red_legged_Kittiwake/Red_Legged_Kittiwake_0049_795440.jpg,500,375,084.Red_legged_Kittiwake,123,87,304,216,213,151,181,129
../../CUB_200_2011/images\084.Red_legged_Kittiwake/Red_Legged_Kittiwake_0024_795441.jpg,500,333,084.Red_legged_Kittiwake,204,126,325,281,264,203,121,155
../../CUB_200_2011/images\084.Red_legged_Kittiwake/Red_Legged_Kittiwake_0031_795442.jpg,400,290,084.Red_legged_Kittiwake,11,40,343,224,177,132,332,184
../../CUB_200_2011/images\084.Red_legged_Kittiwake/Red_Legged_Kittiwake_0047_795445.jpg,363,500,084.Red_legged_Kittiwake,18,1,309,316,163,158,291,315
../../CUB_200_2011/images\084.Red_legged_Kittiwake/Red_Legged_Kittiwake_0028_795450.jpg,500,333,084.Red_legged_Kittiwake,80,16,414,283,247,149,334,267
../../CUB_200_2011/images\084.Red_legged_Kittiwake/Red_Legged_Kittiwake_0017_795451.jpg,500,375,084.Red_legged_Kittiwake,24,77,320,305,172,191,296,228
../../CUB_200_2011/images\084.Red_legged_Kittiwake/Red_Legged_Kittiwake_0002_73788.jpg,500,375,084.Red_legged_Kittiwake,38,79,319,228,178,153,281,149
../../CUB_200_2011/images\084.Red_legged_Kittiwake/Red_Legged_Kittiwake_0010_73789.jpg,375,500,084.Red_legged_Kittiwake,39,64,374,499,206,281,335,435
../../CUB_200_2011/images\084.Red_legged_Kittiwake/Red_Legged_Kittiwake_0040_795455.jpg,500,393,084.Red_legged_Kittiwake,30,32,417,329,223,180,387,297
../../CUB_200_2011/images\084.Red_legged_Kittiwake/Red_Legged_Kittiwake_0015_73792.jpg,500,375,084.Red_legged_Kittiwake,68,46,479,332,273,189,411,286
../../CUB_200_2011/images\084.Red_legged_Kittiwake/Red_Legged_Kittiwake_0042_795457.jpg,392,500,084.Red_legged_Kittiwake,19,19,373,469,196,244,354,450
../../CUB_200_2011/images\084.Red_legged_Kittiwake/Red_Legged_Kittiwake_0009_795459.jpg,488,500,084.Red_legged_Kittiwake,73,32,487,475,280,253,414,443
../../CUB_200_2011/images\084.Red_legged_Kittiwake/Red_Legged_Kittiwake_0016_795460.jpg,500,320,084.Red_legged_Kittiwake,50,40,246,207,148,123,196,167
../../CUB_200_2011/images\084.Red_legged_Kittiwake/Red_Legged_Kittiwake_0071_73800.jpg,500,333,084.Red_legged_Kittiwake,139,49,449,317,294,183,310,268
../../CUB_200_2011/images\084.Red_legged_Kittiwake/Red_Legged_Kittiwake_0021_73808.jpg,500,328,084.Red_legged_Kittiwake,70,54,249,215,159,134,179,161
../../CUB_200_2011/images\084.Red_legged_Kittiwake/Red_Legged_Kittiwake_0004_73811.jpg,500,333,084.Red_legged_Kittiwake,65,43,495,330,280,186,430,287
../../CUB_200_2011/images\084.Red_legged_Kittiwake/Red_Legged_Kittiwake_0036_73814.jpg,500,332,084.Red_legged_Kittiwake,2,0,313,221,157,110,311,221
../../CUB_200_2011/images\084.Red_legged_Kittiwake/Red_Legged_Kittiwake_0030_73818.jpg,500,333,084.Red_legged_Kittiwake,82,54,278,320,180,187,196,266
../../CUB_200_2011/images\084.Red_legged_Kittiwake/Red_Legged_Kittiwake_0063_795453.jpg,400,300,084.Red_legged_Kittiwake,0,46,399,187,199,116,399,141
../../CUB_200_2011/images\084.Red_legged_Kittiwake/Red_Legged_Kittiwake_0027_795454.jpg,200,240,084.Red_legged_Kittiwake,28,36,198,203,113,119,170,167
../../CUB_200_2011/images\084.Red_legged_Kittiwake/Red_Legged_Kittiwake_0065_795456.jpg,500,333,084.Red_legged_Kittiwake,175,26,326,223,250,124,151,197
../../CUB_200_2011/images\084.Red_legged_Kittiwake/Red_Legged_Kittiwake_0037_73794.jpg,500,333,084.Red_legged_Kittiwake,161,100,296,267,228,183,135,167
../../CUB_200_2011/images\084.Red_legged_Kittiwake/Red_Legged_Kittiwake_0061_795420.jpg,500,438,084.Red_legged_Kittiwake,89,33,451,365,270,199,362,332
../../CUB_200_2011/images\084.Red_legged_Kittiwake/Red_Legged_Kittiwake_0003_795389.jpg,500,315,084.Red_legged_Kittiwake,121,47,429,226,275,136,308,179
../../CUB_200_2011/images\084.Red_legged_Kittiwake/Red_Legged_Kittiwake_0044_795388.jpg,500,341,084.Red_legged_Kittiwake,118,91,295,289,206,190,177,198
../../CUB_200_2011/images\084.Red_legged_Kittiwake/Red_Legged_Kittiwake_0062_795434.jpg,400,299,084.Red_legged_Kittiwake,83,15,323,248,203,131,240,233
../../CUB_200_2011/images\085.Horned_Lark/Horned_Lark_0067_75266.jpg,333,500,085.Horned_Lark,71,212,237,382,154,297,166,170
../../CUB_200_2011/images\085.Horned_Lark/Horned_Lark_0010_75291.jpg,500,364,085.Horned_Lark,41,47,365,331,203,189,324,284
../../CUB_200_2011/images\085.Horned_Lark/Horned_Lark_0115_74271.jpg,500,375,085.Horned_Lark,111,91,308,286,209,188,197,195
../../CUB_200_2011/images\085.Horned_Lark/Horned_Lark_0065_74279.jpg,500,395,085.Horned_Lark,88,53,414,328,251,190,326,275
../../CUB_200_2011/images\085.Horned_Lark/Horned_Lark_0066_74796.jpg,500,372,085.Horned_Lark,146,58,448,336,297,197,302,278
../../CUB_200_2011/images\085.Horned_Lark/Horned_Lark_0110_73826.jpg,393,500,085.Horned_Lark,138,101,337,288,237,194,199,187
../../CUB_200_2011/images\085.Horned_Lark/Horned_Lark_0015_74855.jpg,459,452,085.Horned_Lark,74,88,348,315,211,201,274,227
../../CUB_200_2011/images\085.Horned_Lark/Horned_Lark_0033_74344.jpg,500,342,085.Horned_Lark,96,77,342,296,219,186,246,219
../../CUB_200_2011/images\085.Horned_Lark/Horned_Lark_0082_73833.jpg,500,389,085.Horned_Lark,106,87,353,338,229,212,247,251
../../CUB_200_2011/images\085.Horned_Lark/Horned_Lark_0006_73836.jpg,500,455,085.Horned_Lark,158,98,397,358,277,228,239,260
../../CUB_200_2011/images\085.Horned_Lark/Horned_Lark_0116_73840.jpg,500,376,085.Horned_Lark,49,157,336,293,192,225,287,136
../../CUB_200_2011/images\085.Horned_Lark/Horned_Lark_0126_74354.jpg,479,500,085.Horned_Lark,2,99,451,465,226,282,449,366
../../CUB_200_2011/images\085.Horned_Lark/Horned_Lark_0001_73835.jpg,500,351,085.Horned_Lark,61,101,316,303,188,202,255,202
../../CUB_200_2011/images\085.Horned_Lark/Horned_Lark_0004_73861.jpg,500,434,085.Horned_Lark,124,112,355,354,239,233,231,242
../../CUB_200_2011/images\085.Horned_Lark/Horned_Lark_0013_74374.jpg,500,401,085.Horned_Lark,14,32,420,370,217,201,406,338
../../CUB_200_2011/images\085.Horned_Lark/Horned_Lark_0056_74896.jpg,500,332,085.Horned_Lark,115,82,338,250,226,166,223,168
../../CUB_200_2011/images\085.Horned_Lark/Horned_Lark_0089_74386.jpg,381,500,085.Horned_Lark,21,117,310,379,165,248,289,262
../../CUB_200_2011/images\085.Horned_Lark/Horned_Lark_0133_73882.jpg,500,347,085.Horned_Lark,116,44,465,263,290,153,349,219
../../CUB_200_2011/images\085.Horned_Lark/Horned_Lark_0141_74396.jpg,500,339,085.Horned_Lark,125,85,443,252,284,168,318,167
../../CUB_200_2011/images\085.Horned_Lark/Horned_Lark_0026_74910.jpg,500,333,085.Horned_Lark,182,81,408,270,295,175,226,189
../../CUB_200_2011/images\085.Horned_Lark/Horned_Lark_0064_74864.jpg,500,385,085.Horned_Lark,144,39,473,364,308,201,329,325
../../CUB_200_2011/images\085.Horned_Lark/Horned_Lark_0048_73894.jpg,500,368,085.Horned_Lark,115,82,321,285,218,183,206,203
../../CUB_200_2011/images\085.Horned_Lark/Horned_Lark_0094_74407.jpg,500,326,085.Horned_Lark,86,73,324,275,205,174,238,202
../../CUB_200_2011/images\085.Horned_Lark/Horned_Lark_0028_74408.jpg,500,369,085.Horned_Lark,223,62,424,303,323,182,201,241
../../CUB_200_2011/images\085.Horned_Lark/Horned_Lark_0127_74414.jpg,500,401,085.Horned_Lark,129,95,455,307,292,201,326,212
../../CUB_200_2011/images\085.Horned_Lark/Horned_Lark_0125_73910.jpg,500,376,085.Horned_Lark,147,99,368,268,257,183,221,169
../../CUB_200_2011/images\085.Horned_Lark/Horned_Lark_0020_73914.jpg,500,465,085.Horned_Lark,256,82,409,310,332,196,153,228
../../CUB_200_2011/images\085.Horned_Lark/Horned_Lark_0076_73931.jpg,500,361,085.Horned_Lark,109,158,275,302,192,230,166,144
../../CUB_200_2011/images\085.Horned_Lark/Horned_Lark_0083_74444.jpg,500,326,085.Horned_Lark,151,63,369,222,260,142,218,159
../../CUB_200_2011/images\085.Horned_Lark/Horned_Lark_0043_74450.jpg,500,500,085.Horned_Lark,47,138,440,375,243,256,393,237
../../CUB_200_2011/images\085.Horned_Lark/Horned_Lark_0034_73940.jpg,500,393,085.Horned_Lark,162,74,489,377,325,225,327,303
../../CUB_200_2011/images\085.Horned_Lark/Horned_Lark_0046_73950.jpg,500,357,085.Horned_Lark,176,53,479,241,327,147,303,188
../../CUB_200_2011/images\085.Horned_Lark/Horned_Lark_0079_73958.jpg,400,500,085.Horned_Lark,106,94,338,402,222,248,232,308
../../CUB_200_2011/images\085.Horned_Lark/Horned_Lark_0014_74963.jpg,485,352,085.Horned_Lark,111,47,421,275,266,161,310,228
../../CUB_200_2011/images\085.Horned_Lark/Horned_Lark_0139_74492.jpg,386,500,085.Horned_Lark,23,125,294,406,158,265,271,281
../../CUB_200_2011/images\085.Horned_Lark/Horned_Lark_0097_74496.jpg,500,333,085.Horned_Lark,52,132,305,278,178,205,253,146
../../CUB_200_2011/images\085.Horned_Lark/Horned_Lark_0087_73989.jpg,500,435,085.Horned_Lark,32,56,472,356,252,206,440,300
../../CUB_200_2011/images\085.Horned_Lark/Horned_Lark_0019_73996.jpg,500,375,085.Horned_Lark,139,135,313,280,226,207,174,145
../../CUB_200_2011/images\085.Horned_Lark/Horned_Lark_0012_74511.jpg,500,375,085.Horned_Lark,125,59,488,328,306,193,363,269
../../CUB_200_2011/images\085.Horned_Lark/Horned_Lark_0130_74001.jpg,500,333,085.Horned_Lark,267,111,397,251,332,181,130,140
../../CUB_200_2011/images\085.Horned_Lark/Horned_Lark_0035_74555.jpg,500,333,085.Horned_Lark,171,107,450,272,310,189,279,165
../../CUB_200_2011/images\085.Horned_Lark/Horned_Lark_0049_74574.jpg,500,428,085.Horned_Lark,118,153,334,307,226,230,216,154
../../CUB_200_2011/images\085.Horned_Lark/Horned_Lark_0072_74067.jpg,500,382,085.Horned_Lark,218,154,434,323,326,238,216,169
../../CUB_200_2011/images\085.Horned_Lark/Horned_Lark_0075_74126.jpg,500,363,085.Horned_Lark,43,82,464,321,253,201,421,239
../../CUB_200_2011/images\085.Horned_Lark/Horned_Lark_0096_74075.jpg,500,374,085.Horned_Lark,28,74,474,289,251,181,446,215
../../CUB_200_2011/images\085.Horned_Lark/Horned_Lark_0088_74590.jpg,500,401,085.Horned_Lark,67,63,378,333,222,198,311,270
../../CUB_200_2011/images\085.Horned_Lark/Horned_Lark_0138_74083.jpg,500,442,085.Horned_Lark,42,106,383,289,212,197,341,183
../../CUB_200_2011/images\085.Horned_Lark/Horned_Lark_0091_74087.jpg,500,334,085.Horned_Lark,138,80,388,255,263,167,250,175
../../CUB_200_2011/images\085.Horned_Lark/Horned_Lark_0069_74093.jpg,403,500,085.Horned_Lark,110,84,324,337,217,210,214,253
../../CUB_200_2011/images\085.Horned_Lark/Horned_Lark_0113_74613.jpg,500,400,085.Horned_Lark,144,91,361,298,252,194,217,207
../../CUB_200_2011/images\085.Horned_Lark/Horned_Lark_0095_74640.jpg,500,393,085.Horned_Lark,170,106,448,315,309,210,278,209
../../CUB_200_2011/images\085.Horned_Lark/Horned_Lark_0009_74646.jpg,500,353,085.Horned_Lark,132,95,330,227,231,161,198,132
../../CUB_200_2011/images\085.Horned_Lark/Horned_Lark_0104_74142.jpg,500,357,085.Horned_Lark,93,45,452,289,272,167,359,244
../../CUB_200_2011/images\085.Horned_Lark/Horned_Lark_0059_74144.jpg,500,333,085.Horned_Lark,68,55,346,274,207,164,278,219
../../CUB_200_2011/images\085.Horned_Lark/Horned_Lark_0112_73971.jpg,500,363,085.Horned_Lark,45,71,408,283,226,177,363,212
../../CUB_200_2011/images\085.Horned_Lark/Horned_Lark_0134_74689.jpg,500,337,085.Horned_Lark,24,68,382,306,203,187,358,238
../../CUB_200_2011/images\085.Horned_Lark/Horned_Lark_0037_74696.jpg,500,333,085.Horned_Lark,125,128,352,236,238,182,227,108
../../CUB_200_2011/images\085.Horned_Lark/Horned_Lark_0108_74193.jpg,500,403,085.Horned_Lark,29,63,417,373,223,218,388,310
../../CUB_200_2011/images\085.Horned_Lark/Horned_Lark_0025_75003.jpg,500,401,085.Horned_Lark,143,58,483,387,313,222,340,329
../../CUB_200_2011/images\085.Horned_Lark/Horned_Lark_0040_74214.jpg,500,473,085.Horned_Lark,32,141,380,422,206,281,348,281
../../CUB_200_2011/images\086.Pacific_Loon/Pacific_Loon_0001_75521.jpg,500,336,086.Pacific_Loon,113,75,437,181,275,128,324,106
../../CUB_200_2011/images\086.Pacific_Loon/Pacific_Loon_0048_75524.jpg,500,333,086.Pacific_Loon,169,99,330,224,249,161,161,125
../../CUB_200_2011/images\086.Pacific_Loon/Pacific_Loon_0038_75526.jpg,500,383,086.Pacific_Loon,168,93,411,228,289,160,243,135
../../CUB_200_2011/images\086.Pacific_Loon/Pacific_Loon_0013_75530.jpg,500,500,086.Pacific_Loon,150,186,326,290,238,238,176,104
../../CUB_200_2011/images\086.Pacific_Loon/Pacific_Loon_0031_75531.jpg,500,405,086.Pacific_Loon,26,126,464,273,245,199,438,147
../../CUB_200_2011/images\086.Pacific_Loon/Pacific_Loon_0064_75532.jpg,500,390,086.Pacific_Loon,9,115,398,266,203,190,389,151
../../CUB_200_2011/images\086.Pacific_Loon/Pacific_Loon_0036_75539.jpg,500,357,086.Pacific_Loon,123,90,402,214,262,152,279,124
../../CUB_200_2011/images\086.Pacific_Loon/Pacific_Loon_0027_75542.jpg,500,333,086.Pacific_Loon,88,102,372,208,230,155,284,106
../../CUB_200_2011/images\086.Pacific_Loon/Pacific_Loon_0054_75543.jpg,500,333,086.Pacific_Loon,28,27,455,284,241,155,427,257
../../CUB_200_2011/images\086.Pacific_Loon/Pacific_Loon_0037_75800.jpg,500,356,086.Pacific_Loon,50,87,432,296,241,191,382,209
../../CUB_200_2011/images\086.Pacific_Loon/Pacific_Loon_0049_75780.jpg,500,387,086.Pacific_Loon,160,114,358,230,259,172,198,116
../../CUB_200_2011/images\086.Pacific_Loon/Pacific_Loon_0066_75547.jpg,500,374,086.Pacific_Loon,67,153,466,281,266,217,399,128
../../CUB_200_2011/images\086.Pacific_Loon/Pacific_Loon_0024_75555.jpg,500,282,086.Pacific_Loon,46,64,464,191,255,127,418,127
../../CUB_200_2011/images\086.Pacific_Loon/Pacific_Loon_0041_75782.jpg,333,500,086.Pacific_Loon,13,186,324,301,168,243,311,115
../../CUB_200_2011/images\086.Pacific_Loon/Pacific_Loon_0004_75815.jpg,500,425,086.Pacific_Loon,197,129,469,237,333,183,272,108
../../CUB_200_2011/images\086.Pacific_Loon/Pacific_Loon_0010_75818.jpg,500,332,086.Pacific_Loon,21,94,445,199,233,146,424,105
../../CUB_200_2011/images\086.Pacific_Loon/Pacific_Loon_0018_75564.jpg,500,352,086.Pacific_Loon,195,116,410,227,302,171,215,111
../../CUB_200_2011/images\086.Pacific_Loon/Pacific_Loon_0033_75571.jpg,500,350,086.Pacific_Loon,74,57,451,277,262,167,377,220
../../CUB_200_2011/images\086.Pacific_Loon/Pacific_Loon_0005_75829.jpg,455,341,086.Pacific_Loon,82,85,392,229,237,157,310,144
../../CUB_200_2011/images\086.Pacific_Loon/Pacific_Loon_0017_75835.jpg,430,500,086.Pacific_Loon,69,46,286,377,177,211,217,331
../../CUB_200_2011/images\086.Pacific_Loon/Pacific_Loon_0068_75836.jpg,500,375,086.Pacific_Loon,89,121,386,265,237,193,297,144
../../CUB_200_2011/images\086.Pacific_Loon/Pacific_Loon_0062_75587.jpg,500,422,086.Pacific_Loon,146,152,384,262,265,207,238,110
../../CUB_200_2011/images\086.Pacific_Loon/Pacific_Loon_0065_75588.jpg,500,319,086.Pacific_Loon,17,76,364,227,190,151,347,151
../../CUB_200_2011/images\086.Pacific_Loon/Pacific_Loon_0045_75589.jpg,500,369,086.Pacific_Loon,207,111,424,250,315,180,217,139
../../CUB_200_2011/images\086.Pacific_Loon/Pacific_Loon_0026_75593.jpg,500,333,086.Pacific_Loon,150,68,465,246,307,157,315,178
../../CUB_200_2011/images\086.Pacific_Loon/Pacific_Loon_0020_75596.jpg,420,280,086.Pacific_Loon,121,57,316,220,218,138,195,163
../../CUB_200_2011/images\086.Pacific_Loon/Pacific_Loon_0057_75854.jpg,500,375,086.Pacific_Loon,120,170,396,297,258,233,276,127
../../CUB_200_2011/images\086.Pacific_Loon/Pacific_Loon_0021_75859.jpg,500,374,086.Pacific_Loon,122,132,366,239,244,185,244,107
../../CUB_200_2011/images\086.Pacific_Loon/Pacific_Loon_0063_75865.jpg,478,500,086.Pacific_Loon,76,94,370,331,223,212,294,237
../../CUB_200_2011/images\086.Pacific_Loon/Pacific_Loon_0053_77673.jpg,500,341,086.Pacific_Loon,113,90,383,237,248,163,270,147
../../CUB_200_2011/images\086.Pacific_Loon/Pacific_Loon_0042_75385.jpg,500,386,086.Pacific_Loon,28,136,372,246,200,191,344,110
../../CUB_200_2011/images\086.Pacific_Loon/Pacific_Loon_0009_75642.jpg,500,375,086.Pacific_Loon,130,137,382,288,256,212,252,151
../../CUB_200_2011/images\086.Pacific_Loon/Pacific_Loon_0050_75388.jpg,500,333,086.Pacific_Loon,4,79,458,185,231,132,454,106
../../CUB_200_2011/images\086.Pacific_Loon/Pacific_Loon_0047_75393.jpg,333,500,086.Pacific_Loon,53,130,297,376,175,253,244,246
../../CUB_200_2011/images\086.Pacific_Loon/Pacific_Loon_0035_75395.jpg,500,333,086.Pacific_Loon,75,110,361,253,218,181,286,143
../../CUB_200_2011/images\086.Pacific_Loon/Pacific_Loon_0022_75405.jpg,458,500,086.Pacific_Loon,92,134,386,289,239,211,294,155
../../CUB_200_2011/images\086.Pacific_Loon/Pacific_Loon_0040_75414.jpg,500,358,086.Pacific_Loon,215,86,364,188,289,137,149,102
../../CUB_200_2011/images\086.Pacific_Loon/Pacific_Loon_0019_75422.jpg,500,333,086.Pacific_Loon,176,75,344,194,260,134,168,119
../../CUB_200_2011/images\086.Pacific_Loon/Pacific_Loon_0067_75423.jpg,500,278,086.Pacific_Loon,117,82,436,184,276,133,319,102
../../CUB_200_2011/images\086.Pacific_Loon/Pacific_Loon_0008_75428.jpg,500,408,086.Pacific_Loon,114,179,413,302,263,240,299,123
../../CUB_200_2011/images\086.Pacific_Loon/Pacific_Loon_0025_75436.jpg,500,333,086.Pacific_Loon,60,87,461,227,260,157,401,140
../../CUB_200_2011/images\086.Pacific_Loon/Pacific_Loon_0034_75438.jpg,500,333,086.Pacific_Loon,34,33,472,359,253,196,438,326
../../CUB_200_2011/images\086.Pacific_Loon/Pacific_Loon_0046_75439.jpg,500,333,086.Pacific_Loon,66,82,381,208,223,145,315,126
../../CUB_200_2011/images\086.Pacific_Loon/Pacific_Loon_0032_75441.jpg,500,336,086.Pacific_Loon,76,93,470,238,273,165,394,145
../../CUB_200_2011/images\086.Pacific_Loon/Pacific_Loon_0003_75442.jpg,500,403,086.Pacific_Loon,40,95,489,305,264,200,449,210
../../CUB_200_2011/images\086.Pacific_Loon/Pacific_Loon_0015_75443.jpg,500,363,086.Pacific_Loon,131,105,476,251,303,178,345,146
../../CUB_200_2011/images\086.Pacific_Loon/Pacific_Loon_0069_75446.jpg,350,277,086.Pacific_Loon,49,22,331,180,190,101,282,158
../../CUB_200_2011/images\086.Pacific_Loon/Pacific_Loon_0059_75706.jpg,500,317,086.Pacific_Loon,170,104,292,210,231,157,122,106
../../CUB_200_2011/images\086.Pacific_Loon/Pacific_Loon_0052_75451.jpg,500,401,086.Pacific_Loon,40,73,340,201,190,137,300,128
../../CUB_200_2011/images\086.Pacific_Loon/Pacific_Loon_0044_75467.jpg,500,487,086.Pacific_Loon,5,133,330,436,167,284,325,303
../../CUB_200_2011/images\086.Pacific_Loon/Pacific_Loon_0014_75468.jpg,500,311,086.Pacific_Loon,182,112,419,214,300,163,237,102
../../CUB_200_2011/images\086.Pacific_Loon/Pacific_Loon_0011_75726.jpg,500,375,086.Pacific_Loon,152,79,409,211,280,145,257,132
../../CUB_200_2011/images\086.Pacific_Loon/Pacific_Loon_0023_75476.jpg,500,375,086.Pacific_Loon,226,133,450,246,338,189,224,113
../../CUB_200_2011/images\086.Pacific_Loon/Pacific_Loon_0012_75736.jpg,500,334,086.Pacific_Loon,147,100,351,216,249,158,204,116
../../CUB_200_2011/images\086.Pacific_Loon/Pacific_Loon_0006_75386.jpg,500,430,086.Pacific_Loon,64,50,399,260,231,155,335,210
../../CUB_200_2011/images\086.Pacific_Loon/Pacific_Loon_0043_75747.jpg,500,331,086.Pacific_Loon,114,62,449,179,281,120,335,117
../../CUB_200_2011/images\086.Pacific_Loon/Pacific_Loon_0029_75495.jpg,500,356,086.Pacific_Loon,5,80,440,240,222,160,435,160
../../CUB_200_2011/images\086.Pacific_Loon/Pacific_Loon_0051_75514.jpg,500,331,086.Pacific_Loon,35,50,379,278,207,164,344,228
../../CUB_200_2011/images\086.Pacific_Loon/Pacific_Loon_0039_75517.jpg,500,333,086.Pacific_Loon,3,37,356,309,179,173,353,272
../../CUB_200_2011/images\086.Pacific_Loon/Pacific_Loon_0002_75775.jpg,500,376,086.Pacific_Loon,240,156,454,258,347,207,214,102
../../CUB_200_2011/images\087.Mallard/Mallard_0131_76296.jpg,500,400,087.Mallard,5,102,457,253,231,177,452,151
../../CUB_200_2011/images\087.Mallard/Mallard_0016_76315.jpg,500,375,087.Mallard,52,43,481,354,266,198,429,311
../../CUB_200_2011/images\087.Mallard/Mallard_0044_76317.jpg,500,340,087.Mallard,83,26,473,314,278,170,390,288
../../CUB_200_2011/images\087.Mallard/Mallard_0130_76836.jpg,485,500,087.Mallard,170,54,407,466,288,260,237,412
../../CUB_200_2011/images\087.Mallard/Mallard_0025_76465.jpg,500,375,087.Mallard,86,16,363,280,224,148,277,264
../../CUB_200_2011/images\087.Mallard/Mallard_0115_76840.jpg,500,363,087.Mallard,22,38,452,361,237,199,430,323
../../CUB_200_2011/images\087.Mallard/Mallard_0082_75954.jpg,500,305,087.Mallard,200,78,363,252,281,165,163,174
../../CUB_200_2011/images\087.Mallard/Mallard_0026_76725.jpg,500,375,087.Mallard,121,36,403,326,262,181,282,290
../../CUB_200_2011/images\087.Mallard/Mallard_0128_77396.jpg,500,332,087.Mallard,21,54,439,237,230,145,418,183
../../CUB_200_2011/images\087.Mallard/Mallard_0061_76378.jpg,374,500,087.Mallard,18,140,319,388,168,264,301,248
../../CUB_200_2011/images\087.Mallard/Mallard_0038_76902.jpg,500,375,087.Mallard,16,88,473,248,244,168,457,160
../../CUB_200_2011/images\087.Mallard/Mallard_0093_77419.jpg,333,500,087.Mallard,30,96,313,303,171,199,283,207
../../CUB_200_2011/images\087.Mallard/Mallard_0114_76924.jpg,500,354,087.Mallard,90,85,339,322,214,203,249,237
../../CUB_200_2011/images\087.Mallard/Mallard_0119_76925.jpg,500,399,087.Mallard,16,12,477,394,246,203,461,382
../../CUB_200_2011/images\087.Mallard/Mallard_0069_76926.jpg,500,333,087.Mallard,27,9,356,332,191,170,329,323
../../CUB_200_2011/images\087.Mallard/Mallard_0033_76565.jpg,500,352,087.Mallard,17,23,329,198,173,110,312,175
../../CUB_200_2011/images\087.Mallard/Mallard_0077_75911.jpg,450,403,087.Mallard,69,2,345,400,207,201,276,398
../../CUB_200_2011/images\087.Mallard/Mallard_0071_76940.jpg,500,333,087.Mallard,247,68,437,287,342,177,190,219
../../CUB_200_2011/images\087.Mallard/Mallard_0052_76946.jpg,469,500,087.Mallard,52,32,385,467,218,249,333,435
../../CUB_200_2011/images\087.Mallard/Mallard_0064_76654.jpg,500,333,087.Mallard,94,66,435,332,264,199,341,266
../../CUB_200_2011/images\087.Mallard/Mallard_0024_75932.jpg,500,375,087.Mallard,155,40,364,317,259,178,209,277
../../CUB_200_2011/images\087.Mallard/Mallard_0141_76977.jpg,500,332,087.Mallard,55,34,439,326,247,180,384,292
../../CUB_200_2011/images\087.Mallard/Mallard_0098_77490.jpg,500,333,087.Mallard,136,89,383,292,259,190,247,203
../../CUB_200_2011/images\087.Mallard/Mallard_0048_76995.jpg,500,334,087.Mallard,90,28,455,234,272,131,365,206
../../CUB_200_2011/images\087.Mallard/Mallard_0053_75985.jpg,500,317,087.Mallard,96,9,441,248,268,128,345,239
../../CUB_200_2011/images\087.Mallard/Mallard_0107_76498.jpg,500,333,087.Mallard,65,116,394,238,229,177,329,122
../../CUB_200_2011/images\087.Mallard/Mallard_0121_77434.jpg,500,340,087.Mallard,15,41,485,257,250,149,470,216
../../CUB_200_2011/images\087.Mallard/Mallard_0018_76511.jpg,500,279,087.Mallard,96,8,497,249,296,128,401,241
../../CUB_200_2011/images\087.Mallard/Mallard_0050_76519.jpg,500,351,087.Mallard,51,65,421,219,236,142,370,154
../../CUB_200_2011/images\087.Mallard/Mallard_0028_76010.jpg,500,434,087.Mallard,32,17,486,382,259,199,454,365
../../CUB_200_2011/images\087.Mallard/Mallard_0043_77038.jpg,500,293,087.Mallard,204,57,493,216,348,136,289,159
../../CUB_200_2011/images\087.Mallard/Mallard_0112_77046.jpg,500,332,087.Mallard,95,59,401,282,248,170,306,223
../../CUB_200_2011/images\087.Mallard/Mallard_0005_76026.jpg,500,400,087.Mallard,11,66,456,359,233,212,445,293
../../CUB_200_2011/images\087.Mallard/Mallard_0083_77052.jpg,500,375,087.Mallard,13,29,487,340,250,184,474,311
../../CUB_200_2011/images\087.Mallard/Mallard_0106_77568.jpg,500,333,087.Mallard,162,61,482,273,322,167,320,212
../../CUB_200_2011/images\087.Mallard/Mallard_0089_77068.jpg,500,330,087.Mallard,9,44,466,309,237,176,457,265
../../CUB_200_2011/images\087.Mallard/Mallard_0070_77588.jpg,417,500,087.Mallard,136,87,328,302,232,194,192,215
../../CUB_200_2011/images\087.Mallard/Mallard_0086_76567.jpg,500,359,087.Mallard,78,66,416,310,247,188,338,244
../../CUB_200_2011/images\087.Mallard/Mallard_0136_76593.jpg,500,375,087.Mallard,81,32,390,324,235,178,309,292
../../CUB_200_2011/images\087.Mallard/Mallard_0095_76080.jpg,500,330,087.Mallard,46,34,476,292,261,163,430,258
../../CUB_200_2011/images\087.Mallard/Mallard_0035_77095.jpg,500,333,087.Mallard,67,71,406,183,236,127,339,112
../../CUB_200_2011/images\087.Mallard/Mallard_0055_77102.jpg,500,376,087.Mallard,46,48,438,342,242,195,392,294
../../CUB_200_2011/images\087.Mallard/Mallard_0103_77105.jpg,500,333,087.Mallard,29,16,461,323,245,169,432,307
../../CUB_200_2011/images\087.Mallard/Mallard_0013_77619.jpg,500,375,087.Mallard,56,67,402,376,229,221,346,309
../../CUB_200_2011/images\087.Mallard/Mallard_0109_76616.jpg,500,272,087.Mallard,45,24,489,252,267,138,444,228
../../CUB_200_2011/images\087.Mallard/Mallard_0045_77129.jpg,500,330,087.Mallard,106,33,400,254,253,143,294,221
../../CUB_200_2011/images\087.Mallard/Mallard_0067_77623.jpg,500,375,087.Mallard,183,34,436,366,309,200,253,332
../../CUB_200_2011/images\087.Mallard/Mallard_0030_77143.jpg,500,463,087.Mallard,87,34,385,408,236,221,298,374
../../CUB_200_2011/images\087.Mallard/Mallard_0087_77499.jpg,500,375,087.Mallard,114,49,423,374,268,211,309,325
../../CUB_200_2011/images\087.Mallard/Mallard_0123_76653.jpg,500,361,087.Mallard,52,58,398,335,225,196,346,277
../../CUB_200_2011/images\087.Mallard/Mallard_0022_77166.jpg,500,353,087.Mallard,147,94,419,220,283,157,272,126
../../CUB_200_2011/images\087.Mallard/Mallard_0006_77171.jpg,500,376,087.Mallard,27,29,419,345,223,187,392,316
../../CUB_200_2011/images\087.Mallard/Mallard_0046_76165.jpg,500,381,087.Mallard,55,20,404,316,229,168,349,296
../../CUB_200_2011/images\087.Mallard/Mallard_0014_76166.jpg,500,385,087.Mallard,163,81,434,253,298,167,271,172
../../CUB_200_2011/images\087.Mallard/Mallard_0111_76722.jpg,500,375,087.Mallard,78,22,371,331,224,176,293,309
../../CUB_200_2011/images\087.Mallard/Mallard_0138_76735.jpg,500,333,087.Mallard,71,48,390,294,230,171,319,246
../../CUB_200_2011/images\087.Mallard/Mallard_0078_76238.jpg,444,500,087.Mallard,34,36,385,455,209,245,351,419
../../CUB_200_2011/images\087.Mallard/Mallard_0020_76239.jpg,500,333,087.Mallard,82,85,439,274,260,179,357,189
../../CUB_200_2011/images\087.Mallard/Mallard_0081_76266.jpg,500,375,087.Mallard,56,37,310,372,183,204,254,335
../../CUB_200_2011/images\087.Mallard/Mallard_0004_76958.jpg,500,333,087.Mallard,32,62,407,323,219,192,375,261
../../CUB_200_2011/images\088.Western_Meadowlark/Western_Meadowlark_0079_78856.jpg,357,500,088.Western_Meadowlark,111,167,235,302,173,234,124,135
../../CUB_200_2011/images\088.Western_Meadowlark/Western_Meadowlark_0120_77834.jpg,500,333,088.Western_Meadowlark,185,122,359,295,272,208,174,173
../../CUB_200_2011/images\088.Western_Meadowlark/Western_Meadowlark_0003_78864.jpg,500,375,088.Western_Meadowlark,142,86,404,305,273,195,262,219
../../CUB_200_2011/images\088.Western_Meadowlark/Western_Meadowlark_0048_78354.jpg,332,500,088.Western_Meadowlark,42,112,245,436,143,274,203,324
../../CUB_200_2011/images\088.Western_Meadowlark/Western_Meadowlark_0034_78869.jpg,461,500,088.Western_Meadowlark,185,148,355,316,270,232,170,168
../../CUB_200_2011/images\088.Western_Meadowlark/Western_Meadowlark_0038_77785.jpg,500,351,088.Western_Meadowlark,44,41,400,328,222,184,356,287
../../CUB_200_2011/images\088.Western_Meadowlark/Western_Meadowlark_0104_78105.jpg,500,468,088.Western_Meadowlark,158,110,462,407,310,258,304,297
../../CUB_200_2011/images\088.Western_Meadowlark/Western_Meadowlark_0125_77850.jpg,500,405,088.Western_Meadowlark,117,132,288,321,202,226,171,189
../../CUB_200_2011/images\088.Western_Meadowlark/Western_Meadowlark_0060_78368.jpg,500,402,088.Western_Meadowlark,77,50,204,192,140,121,127,142
../../CUB_200_2011/images\088.Western_Meadowlark/Western_Meadowlark_0116_77862.jpg,500,476,088.Western_Meadowlark,146,189,298,335,222,262,152,146
../../CUB_200_2011/images\088.Western_Meadowlark/Western_Meadowlark_0050_77864.jpg,500,400,088.Western_Meadowlark,68,108,385,296,226,202,317,188
../../CUB_200_2011/images\088.Western_Meadowlark/Western_Meadowlark_0032_78633.jpg,500,349,088.Western_Meadowlark,34,41,357,251,195,146,323,210
../../CUB_200_2011/images\088.Western_Meadowlark/Western_Meadowlark_0086_78636.jpg,309,432,088.Western_Meadowlark,80,84,246,393,163,238,166,309
../../CUB_200_2011/images\088.Western_Meadowlark/Western_Meadowlark_0098_78382.jpg,500,338,088.Western_Meadowlark,16,27,479,337,247,182,463,310
../../CUB_200_2011/images\088.Western_Meadowlark/Western_Meadowlark_0019_77876.jpg,500,414,088.Western_Meadowlark,257,151,436,393,346,272,179,242
../../CUB_200_2011/images\088.Western_Meadowlark/Western_Meadowlark_0018_77880.jpg,500,500,088.Western_Meadowlark,53,99,250,387,151,243,197,288
../../CUB_200_2011/images\088.Western_Meadowlark/Western_Meadowlark_0115_77882.jpg,500,439,088.Western_Meadowlark,165,53,364,344,264,198,199,291
../../CUB_200_2011/images\088.Western_Meadowlark/Western_Meadowlark_0099_78176.jpg,500,347,088.Western_Meadowlark,65,63,223,295,144,179,158,232
../../CUB_200_2011/images\088.Western_Meadowlark/Western_Meadowlark_0121_78402.jpg,500,328,088.Western_Meadowlark,183,131,336,268,259,199,153,137
../../CUB_200_2011/images\088.Western_Meadowlark/Western_Meadowlark_0022_78410.jpg,400,500,088.Western_Meadowlark,84,70,356,370,220,220,272,300
../../CUB_200_2011/images\088.Western_Meadowlark/Western_Meadowlark_0108_78155.jpg,500,375,088.Western_Meadowlark,38,117,297,329,167,223,259,212
../../CUB_200_2011/images\088.Western_Meadowlark/Western_Meadowlark_0096_77901.jpg,500,469,088.Western_Meadowlark,172,178,324,315,248,246,152,137
../../CUB_200_2011/images\088.Western_Meadowlark/Western_Meadowlark_0111_78674.jpg,500,459,088.Western_Meadowlark,107,95,377,371,242,233,270,276
../../CUB_200_2011/images\088.Western_Meadowlark/Western_Meadowlark_0001_78676.jpg,500,334,088.Western_Meadowlark,257,70,370,279,313,174,113,209
../../CUB_200_2011/images\088.Western_Meadowlark/Western_Meadowlark_0014_78421.jpg,331,500,088.Western_Meadowlark,111,215,253,381,182,298,142,166
../../CUB_200_2011/images\088.Western_Meadowlark/Western_Meadowlark_0017_78940.jpg,500,333,088.Western_Meadowlark,163,91,355,270,259,180,192,179
../../CUB_200_2011/images\088.Western_Meadowlark/Western_Meadowlark_0024_78432.jpg,463,500,088.Western_Meadowlark,190,110,351,289,270,199,161,179
../../CUB_200_2011/images\088.Western_Meadowlark/Western_Meadowlark_0107_78608.jpg,384,500,088.Western_Meadowlark,110,91,306,392,208,241,196,301
../../CUB_200_2011/images\088.Western_Meadowlark/Western_Meadowlark_0042_78180.jpg,500,336,088.Western_Meadowlark,262,75,391,264,326,169,129,189
../../CUB_200_2011/images\088.Western_Meadowlark/Western_Meadowlark_0026_78438.jpg,498,500,088.Western_Meadowlark,23,142,312,498,167,320,289,356
../../CUB_200_2011/images\088.Western_Meadowlark/Western_Meadowlark_0040_77823.jpg,500,400,088.Western_Meadowlark,122,66,454,381,288,223,332,315
../../CUB_200_2011/images\088.Western_Meadowlark/Western_Meadowlark_0015_78610.jpg,479,429,088.Western_Meadowlark,154,116,403,316,278,216,249,200
../../CUB_200_2011/images\088.Western_Meadowlark/Western_Meadowlark_0033_78312.jpg,500,333,088.Western_Meadowlark,50,115,240,315,145,215,190,200
../../CUB_200_2011/images\088.Western_Meadowlark/Western_Meadowlark_0083_78197.jpg,499,500,088.Western_Meadowlark,87,50,482,498,284,274,395,448
../../CUB_200_2011/images\088.Western_Meadowlark/Western_Meadowlark_0063_77946.jpg,334,500,088.Western_Meadowlark,71,108,286,321,178,214,215,213
../../CUB_200_2011/images\088.Western_Meadowlark/Western_Meadowlark_0013_77712.jpg,333,500,088.Western_Meadowlark,43,71,252,233,147,152,209,162
../../CUB_200_2011/images\088.Western_Meadowlark/Western_Meadowlark_0028_78487.jpg,420,280,088.Western_Meadowlark,61,45,366,236,213,140,305,191
../../CUB_200_2011/images\088.Western_Meadowlark/Western_Meadowlark_0097_78239.jpg,325,450,088.Western_Meadowlark,49,36,281,359,165,197,232,323
../../CUB_200_2011/images\088.Western_Meadowlark/Western_Meadowlark_0101_78899.jpg,500,334,088.Western_Meadowlark,175,55,459,283,317,169,284,228
../../CUB_200_2011/images\088.Western_Meadowlark/Western_Meadowlark_0103_78500.jpg,500,344,088.Western_Meadowlark,72,143,222,249,147,196,150,106
../../CUB_200_2011/images\088.Western_Meadowlark/Western_Meadowlark_0109_77990.jpg,353,500,088.Western_Meadowlark,117,144,263,392,190,268,146,248
../../CUB_200_2011/images\088.Western_Meadowlark/Western_Meadowlark_0058_78247.jpg,500,375,088.Western_Meadowlark,95,180,243,311,169,245,148,131
../../CUB_200_2011/images\088.Western_Meadowlark/Western_Meadowlark_0112_78760.jpg,500,400,088.Western_Meadowlark,126,9,397,392,261,200,271,383
../../CUB_200_2011/images\088.Western_Meadowlark/Western_Meadowlark_0081_77798.jpg,433,500,088.Western_Meadowlark,77,90,413,456,245,273,336,366
../../CUB_200_2011/images\088.Western_Meadowlark/Western_Meadowlark_0085_77745.jpg,500,377,088.Western_Meadowlark,259,63,410,295,334,179,151,232
../../CUB_200_2011/images\088.Western_Meadowlark/Western_Meadowlark_0044_77758.jpg,357,500,088.Western_Meadowlark,52,100,244,305,148,202,192,205
../../CUB_200_2011/images\088.Western_Meadowlark/Western_Meadowlark_0037_77759.jpg,334,500,088.Western_Meadowlark,8,75,262,435,135,255,254,360
../../CUB_200_2011/images\088.Western_Meadowlark/Western_Meadowlark_0067_78529.jpg,500,333,088.Western_Meadowlark,190,98,300,250,245,174,110,152
../../CUB_200_2011/images\088.Western_Meadowlark/Western_Meadowlark_0064_78027.jpg,500,333,088.Western_Meadowlark,115,35,335,309,225,172,220,274
../../CUB_200_2011/images\088.Western_Meadowlark/Western_Meadowlark_0053_77774.jpg,429,500,088.Western_Meadowlark,23,52,272,262,147,157,249,210
../../CUB_200_2011/images\088.Western_Meadowlark/Western_Meadowlark_0100_78037.jpg,500,450,088.Western_Meadowlark,176,77,363,331,269,204,187,254
../../CUB_200_2011/images\088.Western_Meadowlark/Western_Meadowlark_0029_78832.jpg,500,333,088.Western_Meadowlark,150,97,276,250,213,173,126,153
../../CUB_200_2011/images\088.Western_Meadowlark/Western_Meadowlark_0118_78820.jpg,500,428,088.Western_Meadowlark,73,123,279,270,176,196,206,147
../../CUB_200_2011/images\088.Western_Meadowlark/Western_Meadowlark_0095_78568.jpg,380,295,088.Western_Meadowlark,59,25,373,240,216,132,314,215
../../CUB_200_2011/images\088.Western_Meadowlark/Western_Meadowlark_0091_78576.jpg,500,386,088.Western_Meadowlark,66,90,387,302,226,196,321,212
../../CUB_200_2011/images\088.Western_Meadowlark/Western_Meadowlark_0076_77811.jpg,500,366,088.Western_Meadowlark,86,94,302,319,194,206,216,225
../../CUB_200_2011/images\088.Western_Meadowlark/Western_Meadowlark_0077_77814.jpg,500,354,088.Western_Meadowlark,125,64,313,295,219,179,188,231
../../CUB_200_2011/images\088.Western_Meadowlark/Western_Meadowlark_0021_78841.jpg,333,500,088.Western_Meadowlark,98,42,240,161,169,101,142,119
../../CUB_200_2011/images\088.Western_Meadowlark/Western_Meadowlark_0069_78587.jpg,500,281,088.Western_Meadowlark,25,27,490,280,257,153,465,253
../../CUB_200_2011/images\088.Western_Meadowlark/Western_Meadowlark_0052_77781.jpg,500,438,088.Western_Meadowlark,37,8,418,417,227,212,381,409
../../CUB_200_2011/images\089.Hooded_Merganser/Hooded_Merganser_0056_79112.jpg,500,375,089.Hooded_Merganser,106,117,408,245,257,181,302,128
../../CUB_200_2011/images\089.Hooded_Merganser/Hooded_Merganser_0015_79132.jpg,428,500,089.Hooded_Merganser,147,95,280,210,213,152,133,115
../../CUB_200_2011/images\089.Hooded_Merganser/Hooded_Merganser_0049_79136.jpg,500,333,089.Hooded_Merganser,21,40,442,260,231,150,421,220
../../CUB_200_2011/images\089.Hooded_Merganser/Hooded_Merganser_0085_79146.jpg,333,500,089.Hooded_Merganser,51,193,283,401,167,297,232,208
../../CUB_200_2011/images\089.Hooded_Merganser/Hooded_Merganser_0022_79153.jpg,500,333,089.Hooded_Merganser,112,75,397,226,254,150,285,151
../../CUB_200_2011/images\089.Hooded_Merganser/Hooded_Merganser_0061_796723.jpg,500,333,089.Hooded_Merganser,22,54,428,225,225,139,406,171
../../CUB_200_2011/images\089.Hooded_Merganser/Hooded_Merganser_0073_796726.jpg,500,371,089.Hooded_Merganser,40,40,495,339,267,189,455,299
../../CUB_200_2011/images\089.Hooded_Merganser/Hooded_Merganser_0053_796728.jpg,500,334,089.Hooded_Merganser,112,71,488,219,300,145,376,148
../../CUB_200_2011/images\089.Hooded_Merganser/Hooded_Merganser_0037_796731.jpg,500,240,089.Hooded_Merganser,25,24,417,193,221,108,392,169
../../CUB_200_2011/images\089.Hooded_Merganser/Hooded_Merganser_0021_796732.jpg,500,332,089.Hooded_Merganser,188,44,457,208,322,126,269,164
../../CUB_200_2011/images\089.Hooded_Merganser/Hooded_Merganser_0007_79157.jpg,500,333,089.Hooded_Merganser,139,102,395,228,267,165,256,126
../../CUB_200_2011/images\089.Hooded_Merganser/Hooded_Merganser_0014_796739.jpg,400,400,089.Hooded_Merganser,115,122,320,223,217,172,205,101
../../CUB_200_2011/images\089.Hooded_Merganser/Hooded_Merganser_0089_796740.jpg,500,318,089.Hooded_Merganser,91,28,431,216,261,122,340,188
../../CUB_200_2011/images\089.Hooded_Merganser/Hooded_Merganser_0057_796742.jpg,400,265,089.Hooded_Merganser,7,48,297,199,152,123,290,151
../../CUB_200_2011/images\089.Hooded_Merganser/Hooded_Merganser_0012_796748.jpg,484,460,089.Hooded_Merganser,210,221,422,356,316,288,212,135
../../CUB_200_2011/images\089.Hooded_Merganser/Hooded_Merganser_0048_796749.jpg,447,500,089.Hooded_Merganser,106,98,359,422,232,260,253,324
../../CUB_200_2011/images\089.Hooded_Merganser/Hooded_Merganser_0011_796750.jpg,500,318,089.Hooded_Merganser,26,13,422,286,224,149,396,273
../../CUB_200_2011/images\089.Hooded_Merganser/Hooded_Merganser_0013_796754.jpg,400,267,089.Hooded_Merganser,85,23,322,201,203,112,237,178
../../CUB_200_2011/images\089.Hooded_Merganser/Hooded_Merganser_0066_796755.jpg,500,500,089.Hooded_Merganser,18,90,481,237,249,163,463,147
../../CUB_200_2011/images\089.Hooded_Merganser/Hooded_Merganser_0076_796756.jpg,400,300,089.Hooded_Merganser,35,80,320,183,177,131,285,103
../../CUB_200_2011/images\089.Hooded_Merganser/Hooded_Merganser_0074_796757.jpg,432,288,089.Hooded_Merganser,65,28,410,210,237,119,345,182
../../CUB_200_2011/images\089.Hooded_Merganser/Hooded_Merganser_0071_796760.jpg,500,333,089.Hooded_Merganser,117,57,391,200,254,128,274,143
../../CUB_200_2011/images\089.Hooded_Merganser/Hooded_Merganser_0034_796762.jpg,500,320,089.Hooded_Merganser,2,30,493,241,247,135,491,211
../../CUB_200_2011/images\089.Hooded_Merganser/Hooded_Merganser_0046_796764.jpg,500,335,089.Hooded_Merganser,103,66,359,214,231,140,256,148
../../CUB_200_2011/images\089.Hooded_Merganser/Hooded_Merganser_0079_796768.jpg,500,332,089.Hooded_Merganser,93,41,485,204,289,122,392,163
../../CUB_200_2011/images\089.Hooded_Merganser/Hooded_Merganser_0058_796770.jpg,500,344,089.Hooded_Merganser,170,44,484,218,327,131,314,174
../../CUB_200_2011/images\089.Hooded_Merganser/Hooded_Merganser_0036_796771.jpg,500,375,089.Hooded_Merganser,49,37,493,264,271,150,444,227
../../CUB_200_2011/images\089.Hooded_Merganser/Hooded_Merganser_0083_796773.jpg,400,234,089.Hooded_Merganser,102,39,379,196,240,117,277,157
../../CUB_200_2011/images\089.Hooded_Merganser/Hooded_Merganser_0090_796774.jpg,500,333,089.Hooded_Merganser,107,76,395,242,251,159,288,166
../../CUB_200_2011/images\089.Hooded_Merganser/Hooded_Merganser_0006_796778.jpg,500,300,089.Hooded_Merganser,116,69,324,225,220,147,208,156
../../CUB_200_2011/images\089.Hooded_Merganser/Hooded_Merganser_0024_796779.jpg,500,375,089.Hooded_Merganser,26,48,387,339,206,193,361,291
../../CUB_200_2011/images\089.Hooded_Merganser/Hooded_Merganser_0086_796780.jpg,500,375,089.Hooded_Merganser,144,70,481,301,312,185,337,231
../../CUB_200_2011/images\089.Hooded_Merganser/Hooded_Merganser_0002_796781.jpg,450,339,089.Hooded_Merganser,56,76,443,238,249,157,387,162
../../CUB_200_2011/images\089.Hooded_Merganser/Hooded_Merganser_0026_796782.jpg,500,334,089.Hooded_Merganser,126,48,498,296,312,172,372,248
../../CUB_200_2011/images\089.Hooded_Merganser/Hooded_Merganser_0078_78959.jpg,500,500,089.Hooded_Merganser,129,179,368,279,248,229,239,100
../../CUB_200_2011/images\089.Hooded_Merganser/Hooded_Merganser_0023_796784.jpg,500,334,089.Hooded_Merganser,37,120,293,244,165,182,256,124
../../CUB_200_2011/images\089.Hooded_Merganser/Hooded_Merganser_0047_78962.jpg,500,334,089.Hooded_Merganser,70,91,499,289,284,190,429,198
../../CUB_200_2011/images\089.Hooded_Merganser/Hooded_Merganser_0087_78972.jpg,372,500,089.Hooded_Merganser,22,52,345,308,183,180,323,256
../../CUB_200_2011/images\089.Hooded_Merganser/Hooded_Merganser_0084_78954.jpg,500,346,089.Hooded_Merganser,24,98,418,234,221,166,394,136
../../CUB_200_2011/images\089.Hooded_Merganser/Hooded_Merganser_0075_78977.jpg,500,375,089.Hooded_Merganser,57,21,486,365,271,193,429,344
../../CUB_200_2011/images\089.Hooded_Merganser/Hooded_Merganser_0018_78979.jpg,500,400,089.Hooded_Merganser,77,87,415,270,246,178,338,183
../../CUB_200_2011/images\089.Hooded_Merganser/Hooded_Merganser_0040_78984.jpg,500,307,089.Hooded_Merganser,21,48,484,225,252,136,463,177
../../CUB_200_2011/images\089.Hooded_Merganser/Hooded_Merganser_0092_78989.jpg,500,302,089.Hooded_Merganser,65,46,433,249,249,147,368,203
../../CUB_200_2011/images\089.Hooded_Merganser/Hooded_Merganser_0025_78996.jpg,500,357,089.Hooded_Merganser,58,49,245,208,151,128,187,159
../../CUB_200_2011/images\089.Hooded_Merganser/Hooded_Merganser_0062_78998.jpg,500,312,089.Hooded_Merganser,11,55,455,250,233,152,444,195
../../CUB_200_2011/images\089.Hooded_Merganser/Hooded_Merganser_0043_796783.jpg,500,333,089.Hooded_Merganser,103,61,487,223,295,142,384,162
../../CUB_200_2011/images\089.Hooded_Merganser/Hooded_Merganser_0009_79012.jpg,500,375,089.Hooded_Merganser,142,84,412,275,277,179,270,191
../../CUB_200_2011/images\089.Hooded_Merganser/Hooded_Merganser_0010_796785.jpg,450,300,089.Hooded_Merganser,96,59,413,186,254,122,317,127
../../CUB_200_2011/images\089.Hooded_Merganser/Hooded_Merganser_0059_79016.jpg,500,375,089.Hooded_Merganser,153,131,484,294,318,212,331,163
../../CUB_200_2011/images\089.Hooded_Merganser/Hooded_Merganser_0094_796786.jpg,500,286,089.Hooded_Merganser,156,34,498,186,327,110,342,152
../../CUB_200_2011/images\089.Hooded_Merganser/Hooded_Merganser_0032_79032.jpg,500,348,089.Hooded_Merganser,157,59,292,177,224,118,135,118
../../CUB_200_2011/images\089.Hooded_Merganser/Hooded_Merganser_0016_79079.jpg,500,374,089.Hooded_Merganser,173,77,438,200,305,138,265,123
../../CUB_200_2011/images\089.Hooded_Merganser/Hooded_Merganser_0064_79040.jpg,500,400,089.Hooded_Merganser,65,45,427,237,246,141,362,192
../../CUB_200_2011/images\089.Hooded_Merganser/Hooded_Merganser_0020_79046.jpg,500,342,089.Hooded_Merganser,224,125,382,275,303,200,158,150
../../CUB_200_2011/images\089.Hooded_Merganser/Hooded_Merganser_0070_79054.jpg,500,375,089.Hooded_Merganser,41,63,418,252,229,157,377,189
../../CUB_200_2011/images\089.Hooded_Merganser/Hooded_Merganser_0068_79057.jpg,500,379,089.Hooded_Merganser,96,94,482,284,289,189,386,190
../../CUB_200_2011/images\089.Hooded_Merganser/Hooded_Merganser_0028_79061.jpg,500,338,089.Hooded_Merganser,50,57,442,239,246,148,392,182
../../CUB_200_2011/images\089.Hooded_Merganser/Hooded_Merganser_0063_79064.jpg,500,337,089.Hooded_Merganser,3,71,420,258,211,164,417,187
../../CUB_200_2011/images\089.Hooded_Merganser/Hooded_Merganser_0093_79075.jpg,500,375,089.Hooded_Merganser,125,71,440,237,282,154,315,166
../../CUB_200_2011/images\089.Hooded_Merganser/Hooded_Merganser_0072_78973.jpg,500,332,089.Hooded_Merganser,127,86,477,243,302,164,350,157
../../CUB_200_2011/images\090.Red_breasted_Merganser/Red_Breasted_Merganser_0080_79488.jpg,500,333,090.Red_breasted_Merganser,79,38,441,219,260,128,362,181
../../CUB_200_2011/images\090.Red_breasted_Merganser/Red_Breasted_Merganser_0031_79372.jpg,500,356,090.Red_breasted_Merganser,156,81,448,242,302,161,292,161
../../CUB_200_2011/images\090.Red_breasted_Merganser/Red_Breasted_Merganser_0071_79379.jpg,500,400,090.Red_breasted_Merganser,121,101,304,277,212,189,183,176
../../CUB_200_2011/images\090.Red_breasted_Merganser/Red_Breasted_Merganser_0043_79295.jpg,500,278,090.Red_breasted_Merganser,209,66,419,214,314,140,210,148
../../CUB_200_2011/images\090.Red_breasted_Merganser/Red_Breasted_Merganser_0078_79393.jpg,500,375,090.Red_breasted_Merganser,109,93,400,291,254,192,291,198
../../CUB_200_2011/images\090.Red_breasted_Merganser/Red_Breasted_Merganser_0081_79396.jpg,500,333,090.Red_breasted_Merganser,72,134,307,243,189,188,235,109
../../CUB_200_2011/images\090.Red_breasted_Merganser/Red_Breasted_Merganser_0055_79397.jpg,500,333,090.Red_breasted_Merganser,138,105,284,207,211,156,146,102
../../CUB_200_2011/images\090.Red_breasted_Merganser/Red_Breasted_Merganser_0030_79411.jpg,500,375,090.Red_breasted_Merganser,130,104,419,218,274,161,289,114
../../CUB_200_2011/images\090.Red_breasted_Merganser/Red_Breasted_Merganser_0067_79167.jpg,500,309,090.Red_breasted_Merganser,7,19,418,294,212,156,411,275
../../CUB_200_2011/images\090.Red_breasted_Merganser/Red_Breasted_Merganser_0021_79168.jpg,500,334,090.Red_breasted_Merganser,126,101,490,245,308,173,364,144
../../CUB_200_2011/images\090.Red_breasted_Merganser/Red_Breasted_Merganser_0012_79425.jpg,500,334,090.Red_breasted_Merganser,21,72,353,253,187,162,332,181
../../CUB_200_2011/images\090.Red_breasted_Merganser/Red_Breasted_Merganser_0049_79432.jpg,500,400,090.Red_breasted_Merganser,116,164,468,307,292,235,352,143
../../CUB_200_2011/images\090.Red_breasted_Merganser/Red_Breasted_Merganser_0052_79178.jpg,500,333,090.Red_breasted_Merganser,54,70,393,281,223,175,339,211
../../CUB_200_2011/images\090.Red_breasted_Merganser/Red_Breasted_Merganser_0077_79180.jpg,500,333,090.Red_breasted_Merganser,97,71,462,236,279,153,365,165
../../CUB_200_2011/images\090.Red_breasted_Merganser/Red_Breasted_Merganser_0042_79202.jpg,500,300,090.Red_breasted_Merganser,176,78,454,215,315,146,278,137
../../CUB_200_2011/images\090.Red_breasted_Merganser/Red_Breasted_Merganser_0075_79169.jpg,500,414,090.Red_breasted_Merganser,184,70,456,340,320,205,272,270
../../CUB_200_2011/images\090.Red_breasted_Merganser/Red_Breasted_Merganser_0002_79447.jpg,500,334,090.Red_breasted_Merganser,118,71,400,249,259,160,282,178
../../CUB_200_2011/images\090.Red_breasted_Merganser/Red_Breasted_Merganser_0061_79453.jpg,500,320,090.Red_breasted_Merganser,178,78,436,257,307,167,258,179
../../CUB_200_2011/images\090.Red_breasted_Merganser/Red_Breasted_Merganser_0001_79199.jpg,500,333,090.Red_breasted_Merganser,102,70,452,267,277,168,350,197
../../CUB_200_2011/images\090.Red_breasted_Merganser/Red_Breasted_Merganser_0035_79200.jpg,500,318,090.Red_breasted_Merganser,56,67,482,258,269,162,426,191
../../CUB_200_2011/images\090.Red_breasted_Merganser/Red_Breasted_Merganser_0008_79458.jpg,500,375,090.Red_breasted_Merganser,118,93,264,199,191,146,146,106
../../CUB_200_2011/images\090.Red_breasted_Merganser/Red_Breasted_Merganser_0068_79203.jpg,500,333,090.Red_breasted_Merganser,81,60,440,251,260,155,359,191
../../CUB_200_2011/images\090.Red_breasted_Merganser/Red_Breasted_Merganser_0069_79204.jpg,500,266,090.Red_breasted_Merganser,86,65,395,184,240,124,309,119
../../CUB_200_2011/images\090.Red_breasted_Merganser/Red_Breasted_Merganser_0014_79205.jpg,500,380,090.Red_breasted_Merganser,46,134,442,238,244,186,396,104
../../CUB_200_2011/images\090.Red_breasted_Merganser/Red_Breasted_Merganser_0040_79207.jpg,500,384,090.Red_breasted_Merganser,56,63,463,273,259,168,407,210
../../CUB_200_2011/images\090.Red_breasted_Merganser/Red_Breasted_Merganser_0062_79548.jpg,500,354,090.Red_breasted_Merganser,199,104,404,255,301,179,205,151
../../CUB_200_2011/images\090.Red_breasted_Merganser/Red_Breasted_Merganser_0082_79214.jpg,500,333,090.Red_breasted_Merganser,50,55,312,187,181,121,262,132
../../CUB_200_2011/images\090.Red_breasted_Merganser/Red_Breasted_Merganser_0006_79216.jpg,500,360,090.Red_breasted_Merganser,26,107,385,266,205,186,359,159
../../CUB_200_2011/images\090.Red_breasted_Merganser/Red_Breasted_Merganser_0051_79474.jpg,500,375,090.Red_breasted_Merganser,43,103,417,248,230,175,374,145
../../CUB_200_2011/images\090.Red_breasted_Merganser/Red_Breasted_Merganser_0016_79476.jpg,500,333,090.Red_breasted_Merganser,131,128,367,242,249,185,236,114
../../CUB_200_2011/images\090.Red_breasted_Merganser/Red_Breasted_Merganser_0023_79477.jpg,500,500,090.Red_breasted_Merganser,60,166,436,280,248,223,376,114
../../CUB_200_2011/images\090.Red_breasted_Merganser/Red_Breasted_Merganser_0017_79224.jpg,500,375,090.Red_breasted_Merganser,58,65,369,194,213,129,311,129
../../CUB_200_2011/images\090.Red_breasted_Merganser/Red_Breasted_Merganser_0024_79483.jpg,500,333,090.Red_breasted_Merganser,81,102,366,222,223,162,285,120
../../CUB_200_2011/images\090.Red_breasted_Merganser/Red_Breasted_Merganser_0047_79486.jpg,500,333,090.Red_breasted_Merganser,113,29,316,206,214,117,203,177
../../CUB_200_2011/images\090.Red_breasted_Merganser/Red_Breasted_Merganser_0004_79232.jpg,500,400,090.Red_breasted_Merganser,76,102,240,226,158,164,164,124
../../CUB_200_2011/images\090.Red_breasted_Merganser/Red_Breasted_Merganser_0063_79238.jpg,500,456,090.Red_breasted_Merganser,11,145,491,329,251,237,480,184
../../CUB_200_2011/images\090.Red_breasted_Merganser/Red_Breasted_Merganser_0074_79497.jpg,500,379,090.Red_breasted_Merganser,114,69,345,226,229,147,231,157
../../CUB_200_2011/images\090.Red_breasted_Merganser/Red_Breasted_Merganser_0079_79519.jpg,500,357,090.Red_breasted_Merganser,67,62,400,191,233,126,333,129
../../CUB_200_2011/images\090.Red_breasted_Merganser/Red_Breasted_Merganser_0022_79274.jpg,500,335,090.Red_breasted_Merganser,134,63,477,239,305,151,343,176
../../CUB_200_2011/images\090.Red_breasted_Merganser/Red_Breasted_Merganser_0066_79275.jpg,500,365,090.Red_breasted_Merganser,55,64,343,234,199,149,288,170
../../CUB_200_2011/images\090.Red_breasted_Merganser/Red_Breasted_Merganser_0032_79280.jpg,500,333,090.Red_breasted_Merganser,24,103,269,214,146,158,245,111
../../CUB_200_2011/images\090.Red_breasted_Merganser/Red_Breasted_Merganser_0027_79284.jpg,500,400,090.Red_breasted_Merganser,72,140,458,322,265,231,386,182
../../CUB_200_2011/images\090.Red_breasted_Merganser/Red_Breasted_Merganser_0085_79285.jpg,500,333,090.Red_breasted_Merganser,79,90,497,227,288,158,418,137
../../CUB_200_2011/images\090.Red_breasted_Merganser/Red_Breasted_Merganser_0054_79542.jpg,500,333,090.Red_breasted_Merganser,128,103,424,257,276,180,296,154
../../CUB_200_2011/images\090.Red_breasted_Merganser/Red_Breasted_Merganser_0034_79292.jpg,500,334,090.Red_breasted_Merganser,101,37,459,204,280,120,358,167
../../CUB_200_2011/images\090.Red_breasted_Merganser/Red_Breasted_Merganser_0013_79301.jpg,500,343,090.Red_breasted_Merganser,198,114,442,221,320,167,244,107
../../CUB_200_2011/images\090.Red_breasted_Merganser/Red_Breasted_Merganser_0003_79303.jpg,500,304,090.Red_breasted_Merganser,257,29,462,195,359,112,205,166
../../CUB_200_2011/images\090.Red_breasted_Merganser/Red_Breasted_Merganser_0083_79562.jpg,500,321,090.Red_breasted_Merganser,74,30,488,218,281,124,414,188
../../CUB_200_2011/images\090.Red_breasted_Merganser/Red_Breasted_Merganser_0064_79563.jpg,500,309,090.Red_breasted_Merganser,88,79,380,190,234,134,292,111
../../CUB_200_2011/images\090.Red_breasted_Merganser/Red_Breasted_Merganser_0010_79567.jpg,500,378,090.Red_breasted_Merganser,67,114,403,239,235,176,336,125
../../CUB_200_2011/images\090.Red_breasted_Merganser/Red_Breasted_Merganser_0076_79312.jpg,500,400,090.Red_breasted_Merganser,123,68,368,227,245,147,245,159
../../CUB_200_2011/images\090.Red_breasted_Merganser/Red_Breasted_Merganser_0070_79570.jpg,500,340,090.Red_breasted_Merganser,5,96,418,236,211,166,413,140
../../CUB_200_2011/images\090.Red_breasted_Merganser/Red_Breasted_Merganser_0041_79574.jpg,500,386,090.Red_breasted_Merganser,163,81,327,299,245,190,164,218
../../CUB_200_2011/images\090.Red_breasted_Merganser/Red_Breasted_Merganser_0009_79576.jpg,500,334,090.Red_breasted_Merganser,66,66,380,184,223,125,314,118
../../CUB_200_2011/images\090.Red_breasted_Merganser/Red_Breasted_Merganser_0044_79321.jpg,500,323,090.Red_breasted_Merganser,80,47,442,238,261,142,362,191
../../CUB_200_2011/images\090.Red_breasted_Merganser/Red_Breasted_Merganser_0048_79323.jpg,500,375,090.Red_breasted_Merganser,219,123,413,255,316,189,194,132
../../CUB_200_2011/images\090.Red_breasted_Merganser/Red_Breasted_Merganser_0046_79330.jpg,500,278,090.Red_breasted_Merganser,159,58,445,204,302,131,286,146
../../CUB_200_2011/images\090.Red_breasted_Merganser/Red_Breasted_Merganser_0056_79348.jpg,500,333,090.Red_breasted_Merganser,71,43,244,165,157,104,173,122
../../CUB_200_2011/images\090.Red_breasted_Merganser/Red_Breasted_Merganser_0033_79353.jpg,500,333,090.Red_breasted_Merganser,63,85,325,239,194,162,262,154
../../CUB_200_2011/images\090.Red_breasted_Merganser/Red_Breasted_Merganser_0045_79358.jpg,500,375,090.Red_breasted_Merganser,93,99,350,200,221,149,257,101
../../CUB_200_2011/images\091.Mockingbird/Mockingbird_0030_79876.jpg,500,332,091.Mockingbird,96,46,455,293,275,169,359,247
../../CUB_200_2011/images\091.Mockingbird/Mockingbird_0096_79878.jpg,500,433,091.Mockingbird,115,48,452,297,283,172,337,249
../../CUB_200_2011/images\091.Mockingbird/Mockingbird_0024_79623.jpg,500,361,091.Mockingbird,130,59,427,330,278,194,297,271
../../CUB_200_2011/images\091.Mockingbird/Mockingbird_0085_81417.jpg,438,500,091.Mockingbird,51,59,436,429,243,244,385,370
../../CUB_200_2011/images\091.Mockingbird/Mockingbird_0015_80652.jpg,500,332,091.Mockingbird,39,48,347,304,193,176,308,256
../../CUB_200_2011/images\091.Mockingbird/Mockingbird_0035_79635.jpg,500,370,091.Mockingbird,36,56,401,312,218,184,365,256
../../CUB_200_2011/images\091.Mockingbird/Mockingbird_0006_79819.jpg,500,400,091.Mockingbird,11,59,429,336,220,197,418,277
../../CUB_200_2011/images\091.Mockingbird/Mockingbird_0095_81177.jpg,423,500,091.Mockingbird,117,126,350,382,233,254,233,256
../../CUB_200_2011/images\091.Mockingbird/Mockingbird_0084_80670.jpg,500,333,091.Mockingbird,247,78,465,302,356,190,218,224
../../CUB_200_2011/images\091.Mockingbird/Mockingbird_0018_81183.jpg,500,410,091.Mockingbird,223,140,418,334,320,237,195,194
../../CUB_200_2011/images\091.Mockingbird/Mockingbird_0054_81703.jpg,500,400,091.Mockingbird,29,59,412,331,220,195,383,272
../../CUB_200_2011/images\091.Mockingbird/Mockingbird_0078_80426.jpg,500,375,091.Mockingbird,186,82,403,374,294,228,217,292
../../CUB_200_2011/images\091.Mockingbird/Mockingbird_0103_79659.jpg,500,409,091.Mockingbird,81,48,482,400,281,224,401,352
../../CUB_200_2011/images\091.Mockingbird/Mockingbird_0050_80184.jpg,500,356,091.Mockingbird,172,74,314,174,243,124,142,100
../../CUB_200_2011/images\091.Mockingbird/Mockingbird_0048_80441.jpg,500,333,091.Mockingbird,178,114,366,292,272,203,188,178
../../CUB_200_2011/images\091.Mockingbird/Mockingbird_0077_81470.jpg,500,406,091.Mockingbird,196,94,406,250,301,172,210,156
../../CUB_200_2011/images\091.Mockingbird/Mockingbird_0076_79934.jpg,500,375,091.Mockingbird,4,95,444,303,224,199,440,208
../../CUB_200_2011/images\091.Mockingbird/Mockingbird_0025_79935.jpg,500,358,091.Mockingbird,48,39,451,317,249,178,403,278
../../CUB_200_2011/images\091.Mockingbird/Mockingbird_0012_81216.jpg,500,335,091.Mockingbird,207,70,471,297,339,183,264,227
../../CUB_200_2011/images\091.Mockingbird/Mockingbird_0056_81986.jpg,500,375,091.Mockingbird,183,50,500,375,341,212,317,325
../../CUB_200_2011/images\091.Mockingbird/Mockingbird_0004_81991.jpg,478,500,091.Mockingbird,41,87,339,302,190,194,298,215
../../CUB_200_2011/images\091.Mockingbird/Mockingbird_0008_81226.jpg,500,370,091.Mockingbird,162,130,328,271,245,200,166,141
../../CUB_200_2011/images\091.Mockingbird/Mockingbird_0097_79951.jpg,500,312,091.Mockingbird,112,43,340,266,226,154,228,223
../../CUB_200_2011/images\091.Mockingbird/Mockingbird_0010_79955.jpg,500,410,091.Mockingbird,210,172,362,274,286,223,152,102
../../CUB_200_2011/images\091.Mockingbird/Mockingbird_0027_80980.jpg,500,333,091.Mockingbird,100,55,416,277,258,166,316,222
../../CUB_200_2011/images\091.Mockingbird/Mockingbird_0013_82010.jpg,400,500,091.Mockingbird,98,114,299,428,198,271,201,314
../../CUB_200_2011/images\091.Mockingbird/Mockingbird_0069_79760.jpg,500,400,091.Mockingbird,89,30,432,359,260,194,343,329
../../CUB_200_2011/images\091.Mockingbird/Mockingbird_0060_79972.jpg,500,354,091.Mockingbird,29,98,345,327,187,212,316,229
../../CUB_200_2011/images\091.Mockingbird/Mockingbird_0106_81381.jpg,500,333,091.Mockingbird,167,110,289,221,228,165,122,111
../../CUB_200_2011/images\091.Mockingbird/Mockingbird_0094_80232.jpg,500,343,091.Mockingbird,144,82,383,239,263,160,239,157
../../CUB_200_2011/images\091.Mockingbird/Mockingbird_0026_81214.jpg,352,500,091.Mockingbird,53,47,245,480,149,263,192,433
../../CUB_200_2011/images\091.Mockingbird/Mockingbird_0072_80789.jpg,500,361,091.Mockingbird,186,39,457,234,321,136,271,195
../../CUB_200_2011/images\091.Mockingbird/Mockingbird_0042_81728.jpg,500,444,091.Mockingbird,97,123,354,288,225,205,257,165
../../CUB_200_2011/images\091.Mockingbird/Mockingbird_0067_79723.jpg,500,413,091.Mockingbird,29,127,289,276,159,201,260,149
../../CUB_200_2011/images\091.Mockingbird/Mockingbird_0109_79682.jpg,310,500,091.Mockingbird,15,20,257,482,136,251,242,462
../../CUB_200_2011/images\091.Mockingbird/Mockingbird_0040_79680.jpg,500,383,091.Mockingbird,76,71,334,348,205,209,258,277
../../CUB_200_2011/images\091.Mockingbird/Mockingbird_0019_81296.jpg,500,400,091.Mockingbird,121,68,476,297,298,182,355,229
../../CUB_200_2011/images\091.Mockingbird/Mockingbird_0038_81299.jpg,500,375,091.Mockingbird,24,13,420,374,222,193,396,361
../../CUB_200_2011/images\091.Mockingbird/Mockingbird_0083_79862.jpg,500,375,091.Mockingbird,1,19,359,341,180,180,358,322
../../CUB_200_2011/images\091.Mockingbird/Mockingbird_0057_79643.jpg,500,379,091.Mockingbird,44,44,456,330,250,187,412,286
../../CUB_200_2011/images\091.Mockingbird/Mockingbird_0022_80552.jpg,500,357,091.Mockingbird,162,83,483,320,322,201,321,237
../../CUB_200_2011/images\091.Mockingbird/Mockingbird_0064_81068.jpg,500,351,091.Mockingbird,19,40,384,282,201,161,365,242
../../CUB_200_2011/images\091.Mockingbird/Mockingbird_0047_80819.jpg,500,334,091.Mockingbird,167,116,393,253,280,184,226,137
../../CUB_200_2011/images\091.Mockingbird/Mockingbird_0082_80570.jpg,500,372,091.Mockingbird,17,120,331,306,174,213,314,186
../../CUB_200_2011/images\091.Mockingbird/Mockingbird_0046_81086.jpg,500,400,091.Mockingbird,24,66,384,320,204,193,360,254
../../CUB_200_2011/images\091.Mockingbird/Mockingbird_0003_80833.jpg,500,335,091.Mockingbird,140,52,378,298,259,175,238,246
../../CUB_200_2011/images\091.Mockingbird/Mockingbird_0001_79812.jpg,408,500,091.Mockingbird,25,54,369,475,197,264,344,421
../../CUB_200_2011/images\091.Mockingbird/Mockingbird_0086_81868.jpg,349,500,091.Mockingbird,97,69,260,458,178,263,163,389
../../CUB_200_2011/images\091.Mockingbird/Mockingbird_0059_82126.jpg,500,391,091.Mockingbird,28,44,391,330,209,187,363,286
../../CUB_200_2011/images\091.Mockingbird/Mockingbird_0049_80336.jpg,500,337,091.Mockingbird,112,45,304,256,208,150,192,211
../../CUB_200_2011/images\091.Mockingbird/Mockingbird_0021_80343.jpg,500,345,091.Mockingbird,149,43,382,304,265,173,233,261
../../CUB_200_2011/images\091.Mockingbird/Mockingbird_0089_80601.jpg,500,326,091.Mockingbird,281,52,491,215,386,133,210,163
../../CUB_200_2011/images\091.Mockingbird/Mockingbird_0098_81117.jpg,500,495,091.Mockingbird,155,185,378,424,266,304,223,239
../../CUB_200_2011/images\091.Mockingbird/Mockingbird_0071_80357.jpg,500,489,091.Mockingbird,98,79,462,268,280,173,364,189
../../CUB_200_2011/images\091.Mockingbird/Mockingbird_0009_81130.jpg,500,331,091.Mockingbird,157,88,395,305,276,196,238,217
../../CUB_200_2011/images\091.Mockingbird/Mockingbird_0051_79599.jpg,500,336,091.Mockingbird,61,55,492,329,276,192,431,274
../../CUB_200_2011/images\091.Mockingbird/Mockingbird_0087_79600.jpg,450,500,091.Mockingbird,134,64,374,459,254,261,240,395
../../CUB_200_2011/images\091.Mockingbird/Mockingbird_0108_81908.jpg,500,290,091.Mockingbird,212,147,351,281,281,214,139,134
../../CUB_200_2011/images\091.Mockingbird/Mockingbird_0016_79605.jpg,401,500,091.Mockingbird,172,55,345,247,258,151,173,192
../../CUB_200_2011/images\091.Mockingbird/Mockingbird_0023_80121.jpg,500,375,091.Mockingbird,6,81,359,295,182,188,353,214
../../CUB_200_2011/images\092.Nighthawk/Nighthawk_0078_795340.jpg,500,331,092.Nighthawk,12,56,375,272,193,164,363,216
../../CUB_200_2011/images\092.Nighthawk/Nighthawk_0041_82183.jpg,500,333,092.Nighthawk,15,85,344,266,179,175,329,181
../../CUB_200_2011/images\092.Nighthawk/Nighthawk_0016_84490.jpg,500,375,092.Nighthawk,44,75,496,288,270,181,452,213
../../CUB_200_2011/images\092.Nighthawk/Nighthawk_0017_84237.jpg,500,334,092.Nighthawk,19,46,404,241,211,143,385,195
../../CUB_200_2011/images\092.Nighthawk/Nighthawk_0064_82196.jpg,500,333,092.Nighthawk,173,18,460,310,316,164,287,292
../../CUB_200_2011/images\092.Nighthawk/Nighthawk_0029_83733.jpg,500,334,092.Nighthawk,26,74,367,263,196,168,341,189
../../CUB_200_2011/images\092.Nighthawk/Nighthawk_0084_84510.jpg,432,288,092.Nighthawk,8,32,372,241,190,136,364,209
../../CUB_200_2011/images\092.Nighthawk/Nighthawk_0004_84011.jpg,500,373,092.Nighthawk,169,135,482,307,325,221,313,172
../../CUB_200_2011/images\092.Nighthawk/Nighthawk_0088_82225.jpg,500,400,092.Nighthawk,41,151,468,352,254,251,427,201
../../CUB_200_2011/images\092.Nighthawk/Nighthawk_0059_82741.jpg,500,333,092.Nighthawk,94,43,437,274,265,158,343,231
../../CUB_200_2011/images\092.Nighthawk/Nighthawk_0066_82238.jpg,500,398,092.Nighthawk,14,46,478,380,246,213,464,334
../../CUB_200_2011/images\092.Nighthawk/Nighthawk_0024_83519.jpg,500,333,092.Nighthawk,70,88,320,230,195,159,250,142
../../CUB_200_2011/images\092.Nighthawk/Nighthawk_0082_82242.jpg,500,346,092.Nighthawk,248,68,369,293,308,180,121,225
../../CUB_200_2011/images\092.Nighthawk/Nighthawk_0046_82246.jpg,333,500,092.Nighthawk,64,209,323,350,193,279,259,141
../../CUB_200_2011/images\092.Nighthawk/Nighthawk_0043_84039.jpg,500,333,092.Nighthawk,11,114,285,305,148,209,274,191
../../CUB_200_2011/images\092.Nighthawk/Nighthawk_0061_82509.jpg,341,500,092.Nighthawk,73,170,340,390,206,280,267,220
../../CUB_200_2011/images\092.Nighthawk/Nighthawk_0073_83540.jpg,500,292,092.Nighthawk,181,68,475,218,328,143,294,150
../../CUB_200_2011/images\092.Nighthawk/Nighthawk_0062_84573.jpg,500,332,092.Nighthawk,180,101,318,211,249,156,138,110
../../CUB_200_2011/images\092.Nighthawk/Nighthawk_0087_82280.jpg,500,500,092.Nighthawk,196,177,415,280,305,228,219,103
../../CUB_200_2011/images\092.Nighthawk/Nighthawk_0035_84077.jpg,500,375,092.Nighthawk,50,28,467,372,258,200,417,344
../../CUB_200_2011/images\092.Nighthawk/Nighthawk_0005_84594.jpg,500,349,092.Nighthawk,100,55,277,278,188,166,177,223
../../CUB_200_2011/images\092.Nighthawk/Nighthawk_0042_83603.jpg,500,324,092.Nighthawk,129,75,494,296,311,185,365,221
../../CUB_200_2011/images\092.Nighthawk/Nighthawk_0045_82807.jpg,500,333,092.Nighthawk,76,116,276,233,176,174,200,117
../../CUB_200_2011/images\092.Nighthawk/Nighthawk_0025_82808.jpg,500,401,092.Nighthawk,87,37,252,311,169,174,165,274
../../CUB_200_2011/images\092.Nighthawk/Nighthawk_0050_84094.jpg,500,345,092.Nighthawk,110,87,358,249,234,168,248,162
../../CUB_200_2011/images\092.Nighthawk/Nighthawk_0014_82624.jpg,500,449,092.Nighthawk,56,87,394,318,225,202,338,231
../../CUB_200_2011/images\092.Nighthawk/Nighthawk_0021_82562.jpg,500,333,092.Nighthawk,58,51,457,228,257,139,399,177
../../CUB_200_2011/images\092.Nighthawk/Nighthawk_0047_82820.jpg,500,288,092.Nighthawk,236,89,357,200,296,144,121,111
../../CUB_200_2011/images\092.Nighthawk/Nighthawk_0019_83850.jpg,500,340,092.Nighthawk,37,76,303,285,170,180,266,209
../../CUB_200_2011/images\092.Nighthawk/Nighthawk_0003_82827.jpg,500,333,092.Nighthawk,85,70,469,266,277,168,384,196
../../CUB_200_2011/images\092.Nighthawk/Nighthawk_0012_84333.jpg,500,402,092.Nighthawk,215,88,430,305,322,196,215,217
../../CUB_200_2011/images\092.Nighthawk/Nighthawk_0034_82578.jpg,500,243,092.Nighthawk,3,35,425,212,214,123,422,177
../../CUB_200_2011/images\092.Nighthawk/Nighthawk_0090_82579.jpg,500,409,092.Nighthawk,181,66,420,301,300,183,239,235
../../CUB_200_2011/images\092.Nighthawk/Nighthawk_0068_82368.jpg,500,362,092.Nighthawk,63,32,416,332,239,182,353,300
../../CUB_200_2011/images\092.Nighthawk/Nighthawk_0055_83352.jpg,500,462,092.Nighthawk,10,150,478,306,244,228,468,156
../../CUB_200_2011/images\092.Nighthawk/Nighthawk_0020_83869.jpg,500,369,092.Nighthawk,131,48,424,247,277,147,293,199
../../CUB_200_2011/images\092.Nighthawk/Nighthawk_0058_83270.jpg,500,335,092.Nighthawk,23,8,285,325,154,166,262,317
../../CUB_200_2011/images\092.Nighthawk/Nighthawk_0026_83911.jpg,500,375,092.Nighthawk,152,103,497,250,324,176,345,147
../../CUB_200_2011/images\092.Nighthawk/Nighthawk_0031_83636.jpg,500,342,092.Nighthawk,50,119,361,266,205,192,311,147
../../CUB_200_2011/images\092.Nighthawk/Nighthawk_0069_82613.jpg,500,203,092.Nighthawk,169,8,346,186,257,97,177,178
../../CUB_200_2011/images\092.Nighthawk/Nighthawk_0018_83639.jpg,500,394,092.Nighthawk,42,46,454,369,248,207,412,323
../../CUB_200_2011/images\092.Nighthawk/Nighthawk_0051_82619.jpg,500,400,092.Nighthawk,238,136,416,330,327,233,178,194
../../CUB_200_2011/images\092.Nighthawk/Nighthawk_0083_83647.jpg,500,333,092.Nighthawk,43,118,360,297,201,207,317,179
../../CUB_200_2011/images\092.Nighthawk/Nighthawk_0048_83648.jpg,500,332,092.Nighthawk,162,95,394,201,278,148,232,106
../../CUB_200_2011/images\092.Nighthawk/Nighthawk_0032_795333.jpg,500,308,092.Nighthawk,39,29,367,295,203,162,328,266
../../CUB_200_2011/images\092.Nighthawk/Nighthawk_0067_795335.jpg,425,300,092.Nighthawk,62,58,317,249,189,153,255,191
../../CUB_200_2011/images\092.Nighthawk/Nighthawk_0072_795336.jpg,450,354,092.Nighthawk,28,9,409,317,218,163,381,308
../../CUB_200_2011/images\092.Nighthawk/Nighthawk_0054_795337.jpg,420,280,092.Nighthawk,181,16,361,246,271,131,180,230
../../CUB_200_2011/images\092.Nighthawk/Nighthawk_0030_795338.jpg,500,375,092.Nighthawk,115,24,415,353,265,188,300,329
../../CUB_200_2011/images\092.Nighthawk/Nighthawk_0063_795339.jpg,500,347,092.Nighthawk,215,64,366,280,290,172,151,216
../../CUB_200_2011/images\092.Nighthawk/Nighthawk_0028_82636.jpg,500,400,092.Nighthawk,215,136,401,355,308,245,186,219
../../CUB_200_2011/images\092.Nighthawk/Nighthawk_0065_82895.jpg,500,400,092.Nighthawk,82,79,465,294,273,186,383,215
../../CUB_200_2011/images\092.Nighthawk/Nighthawk_0057_82640.jpg,500,361,092.Nighthawk,40,91,467,278,253,184,427,187
../../CUB_200_2011/images\092.Nighthawk/Nighthawk_0053_84436.jpg,500,333,092.Nighthawk,35,138,424,306,229,222,389,168
../../CUB_200_2011/images\092.Nighthawk/Nighthawk_0013_83670.jpg,500,333,092.Nighthawk,13,119,387,285,200,202,374,166
../../CUB_200_2011/images\092.Nighthawk/Nighthawk_0022_84183.jpg,500,350,092.Nighthawk,185,71,389,215,287,143,204,144
../../CUB_200_2011/images\092.Nighthawk/Nighthawk_0027_84697.jpg,500,369,092.Nighthawk,186,107,441,268,313,187,255,161
../../CUB_200_2011/images\092.Nighthawk/Nighthawk_0007_83419.jpg,500,332,092.Nighthawk,78,124,285,237,181,180,207,113
../../CUB_200_2011/images\092.Nighthawk/Nighthawk_0070_82676.jpg,500,332,092.Nighthawk,119,115,463,277,291,196,344,162
../../CUB_200_2011/images\092.Nighthawk/Nighthawk_0076_82686.jpg,500,335,092.Nighthawk,21,55,390,313,205,184,369,258
../../CUB_200_2011/images\093.Clark_Nutcracker/Clark_Nutcracker_0096_84996.jpg,500,375,093.Clark_Nutcracker,98,73,477,310,287,191,379,237
../../CUB_200_2011/images\093.Clark_Nutcracker/Clark_Nutcracker_0089_85004.jpg,500,405,093.Clark_Nutcracker,65,34,344,266,204,150,279,232
../../CUB_200_2011/images\093.Clark_Nutcracker/Clark_Nutcracker_0104_85531.jpg,374,500,093.Clark_Nutcracker,71,129,230,332,150,230,159,203
../../CUB_200_2011/images\093.Clark_Nutcracker/Clark_Nutcracker_0134_85534.jpg,500,348,093.Clark_Nutcracker,95,49,343,249,219,149,248,200
../../CUB_200_2011/images\093.Clark_Nutcracker/Clark_Nutcracker_0076_85083.jpg,457,500,093.Clark_Nutcracker,36,55,339,457,187,256,303,402
../../CUB_200_2011/images\093.Clark_Nutcracker/Clark_Nutcracker_0102_85089.jpg,500,454,093.Clark_Nutcracker,178,103,489,453,333,278,311,350
../../CUB_200_2011/images\093.Clark_Nutcracker/Clark_Nutcracker_0105_85097.jpg,500,333,093.Clark_Nutcracker,107,54,392,307,249,180,285,253
../../CUB_200_2011/images\093.Clark_Nutcracker/Clark_Nutcracker_0020_85099.jpg,500,500,093.Clark_Nutcracker,191,119,454,343,322,231,263,224
../../CUB_200_2011/images\093.Clark_Nutcracker/Clark_Nutcracker_0098_85105.jpg,500,375,093.Clark_Nutcracker,134,33,368,334,251,183,234,301
../../CUB_200_2011/images\093.Clark_Nutcracker/Clark_Nutcracker_0090_85116.jpg,500,333,093.Clark_Nutcracker,25,22,409,328,217,175,384,306
../../CUB_200_2011/images\093.Clark_Nutcracker/Clark_Nutcracker_0138_85633.jpg,500,357,093.Clark_Nutcracker,139,66,467,329,303,197,328,263
../../CUB_200_2011/images\093.Clark_Nutcracker/Clark_Nutcracker_0071_85125.jpg,500,333,093.Clark_Nutcracker,16,11,381,326,198,168,365,315
../../CUB_200_2011/images\093.Clark_Nutcracker/Clark_Nutcracker_0124_85128.jpg,500,333,093.Clark_Nutcracker,55,58,226,250,140,154,171,192
../../CUB_200_2011/images\093.Clark_Nutcracker/Clark_Nutcracker_0126_85134.jpg,500,399,093.Clark_Nutcracker,83,104,492,373,287,238,409,269
../../CUB_200_2011/images\093.Clark_Nutcracker/Clark_Nutcracker_0101_85656.jpg,500,349,093.Clark_Nutcracker,116,25,471,328,293,176,355,303
../../CUB_200_2011/images\093.Clark_Nutcracker/Clark_Nutcracker_0084_85149.jpg,500,332,093.Clark_Nutcracker,114,60,329,331,221,195,215,271
../../CUB_200_2011/images\093.Clark_Nutcracker/Clark_Nutcracker_0107_85662.jpg,500,375,093.Clark_Nutcracker,105,104,244,252,174,178,139,148
../../CUB_200_2011/images\093.Clark_Nutcracker/Clark_Nutcracker_0018_85166.jpg,500,400,093.Clark_Nutcracker,96,41,446,399,271,220,350,358
../../CUB_200_2011/images\093.Clark_Nutcracker/Clark_Nutcracker_0137_85172.jpg,500,418,093.Clark_Nutcracker,71,101,429,397,250,249,358,296
../../CUB_200_2011/images\093.Clark_Nutcracker/Clark_Nutcracker_0011_85698.jpg,500,375,093.Clark_Nutcracker,211,121,434,300,322,210,223,179
../../CUB_200_2011/images\093.Clark_Nutcracker/Clark_Nutcracker_0131_85701.jpg,500,374,093.Clark_Nutcracker,102,66,327,304,214,185,225,238
../../CUB_200_2011/images\093.Clark_Nutcracker/Clark_Nutcracker_0005_85190.jpg,500,375,093.Clark_Nutcracker,95,49,451,368,273,208,356,319
../../CUB_200_2011/images\093.Clark_Nutcracker/Clark_Nutcracker_0075_85715.jpg,500,400,093.Clark_Nutcracker,152,84,458,350,305,217,306,266
../../CUB_200_2011/images\093.Clark_Nutcracker/Clark_Nutcracker_0099_85717.jpg,500,333,093.Clark_Nutcracker,160,62,325,261,242,161,165,199
../../CUB_200_2011/images\093.Clark_Nutcracker/Clark_Nutcracker_0024_85718.jpg,375,500,093.Clark_Nutcracker,19,126,311,444,165,285,292,318
../../CUB_200_2011/images\093.Clark_Nutcracker/Clark_Nutcracker_0072_85742.jpg,500,403,093.Clark_Nutcracker,22,17,498,399,260,208,476,382
../../CUB_200_2011/images\093.Clark_Nutcracker/Clark_Nutcracker_0047_85630.jpg,500,393,093.Clark_Nutcracker,29,49,476,329,252,189,447,280
../../CUB_200_2011/images\093.Clark_Nutcracker/Clark_Nutcracker_0027_85266.jpg,500,333,093.Clark_Nutcracker,130,37,499,332,314,184,369,295
../../CUB_200_2011/images\093.Clark_Nutcracker/Clark_Nutcracker_0069_84767.jpg,500,375,093.Clark_Nutcracker,152,134,330,267,241,200,178,133
../../CUB_200_2011/images\093.Clark_Nutcracker/Clark_Nutcracker_0060_84862.jpg,500,375,093.Clark_Nutcracker,151,102,331,277,241,189,180,175
../../CUB_200_2011/images\093.Clark_Nutcracker/Clark_Nutcracker_0017_84777.jpg,500,375,093.Clark_Nutcracker,19,41,479,352,249,196,460,311
../../CUB_200_2011/images\093.Clark_Nutcracker/Clark_Nutcracker_0003_85296.jpg,500,333,093.Clark_Nutcracker,53,67,391,290,222,178,338,223
../../CUB_200_2011/images\093.Clark_Nutcracker/Clark_Nutcracker_0067_85302.jpg,333,500,093.Clark_Nutcracker,41,74,324,319,182,196,283,245
../../CUB_200_2011/images\093.Clark_Nutcracker/Clark_Nutcracker_0013_84791.jpg,500,375,093.Clark_Nutcracker,161,52,341,321,251,186,180,269
../../CUB_200_2011/images\093.Clark_Nutcracker/Clark_Nutcracker_0130_85304.jpg,500,332,093.Clark_Nutcracker,86,83,334,331,210,207,248,248
../../CUB_200_2011/images\093.Clark_Nutcracker/Clark_Nutcracker_0110_85217.jpg,500,356,093.Clark_Nutcracker,127,92,382,303,254,197,255,211
../../CUB_200_2011/images\093.Clark_Nutcracker/Clark_Nutcracker_0093_84809.jpg,500,357,093.Clark_Nutcracker,140,61,375,319,257,190,235,258
../../CUB_200_2011/images\093.Clark_Nutcracker/Clark_Nutcracker_0142_85322.jpg,500,375,093.Clark_Nutcracker,114,101,316,309,215,205,202,208
../../CUB_200_2011/images\093.Clark_Nutcracker/Clark_Nutcracker_0073_85343.jpg,500,333,093.Clark_Nutcracker,91,66,498,275,294,170,407,209
../../CUB_200_2011/images\093.Clark_Nutcracker/Clark_Nutcracker_0112_85350.jpg,500,332,093.Clark_Nutcracker,8,22,430,331,219,176,422,309
../../CUB_200_2011/images\093.Clark_Nutcracker/Clark_Nutcracker_0033_85358.jpg,500,375,093.Clark_Nutcracker,158,92,352,233,255,162,194,141
../../CUB_200_2011/images\093.Clark_Nutcracker/Clark_Nutcracker_0043_84853.jpg,500,352,093.Clark_Nutcracker,139,31,478,329,308,180,339,298
../../CUB_200_2011/images\093.Clark_Nutcracker/Clark_Nutcracker_0106_84856.jpg,500,333,093.Clark_Nutcracker,65,76,308,319,186,197,243,243
../../CUB_200_2011/images\093.Clark_Nutcracker/Clark_Nutcracker_0063_84869.jpg,500,375,093.Clark_Nutcracker,119,91,355,328,237,209,236,237
../../CUB_200_2011/images\093.Clark_Nutcracker/Clark_Nutcracker_0058_85384.jpg,500,397,093.Clark_Nutcracker,58,52,337,306,197,179,279,254
../../CUB_200_2011/images\093.Clark_Nutcracker/Clark_Nutcracker_0014_85386.jpg,500,375,093.Clark_Nutcracker,163,112,377,275,270,193,214,163
../../CUB_200_2011/images\093.Clark_Nutcracker/Clark_Nutcracker_0066_85390.jpg,500,375,093.Clark_Nutcracker,174,108,372,285,273,196,198,177
../../CUB_200_2011/images\093.Clark_Nutcracker/Clark_Nutcracker_0087_84898.jpg,500,333,093.Clark_Nutcracker,133,50,430,323,281,186,297,273
../../CUB_200_2011/images\093.Clark_Nutcracker/Clark_Nutcracker_0078_85416.jpg,500,375,093.Clark_Nutcracker,90,140,289,287,189,213,199,147
../../CUB_200_2011/images\093.Clark_Nutcracker/Clark_Nutcracker_0116_84807.jpg,500,334,093.Clark_Nutcracker,181,75,405,286,293,180,224,211
../../CUB_200_2011/images\093.Clark_Nutcracker/Clark_Nutcracker_0117_84912.jpg,500,332,093.Clark_Nutcracker,110,40,440,326,275,183,330,286
../../CUB_200_2011/images\093.Clark_Nutcracker/Clark_Nutcracker_0121_85435.jpg,500,302,093.Clark_Nutcracker,150,59,403,253,276,156,253,194
../../CUB_200_2011/images\093.Clark_Nutcracker/Clark_Nutcracker_0139_84942.jpg,500,372,093.Clark_Nutcracker,33,28,491,368,262,198,458,340
../../CUB_200_2011/images\093.Clark_Nutcracker/Clark_Nutcracker_0026_84945.jpg,494,500,093.Clark_Nutcracker,179,143,456,365,317,254,277,222
../../CUB_200_2011/images\093.Clark_Nutcracker/Clark_Nutcracker_0051_84950.jpg,500,500,093.Clark_Nutcracker,34,119,432,368,233,243,398,249
../../CUB_200_2011/images\093.Clark_Nutcracker/Clark_Nutcracker_0062_85464.jpg,500,333,093.Clark_Nutcracker,146,82,374,253,260,167,228,171
../../CUB_200_2011/images\093.Clark_Nutcracker/Clark_Nutcracker_0082_85477.jpg,500,398,093.Clark_Nutcracker,128,61,389,345,258,203,261,284
../../CUB_200_2011/images\093.Clark_Nutcracker/Clark_Nutcracker_0083_85480.jpg,500,303,093.Clark_Nutcracker,30,96,356,250,193,173,326,154
../../CUB_200_2011/images\093.Clark_Nutcracker/Clark_Nutcracker_0136_85490.jpg,500,375,093.Clark_Nutcracker,136,100,317,303,226,201,181,203
../../CUB_200_2011/images\093.Clark_Nutcracker/Clark_Nutcracker_0113_85587.jpg,500,456,093.Clark_Nutcracker,30,110,356,394,193,252,326,284
../../CUB_200_2011/images\094.White_breasted_Nuthatch/White_Breasted_Nuthatch_0092_86016.jpg,400,500,094.White_breasted_Nuthatch,105,57,369,450,237,253,264,393
../../CUB_200_2011/images\094.White_breasted_Nuthatch/White_Breasted_Nuthatch_0014_86023.jpg,500,273,094.White_breasted_Nuthatch,20,71,374,254,197,162,354,183
../../CUB_200_2011/images\094.White_breasted_Nuthatch/White_Breasted_Nuthatch_0003_86029.jpg,500,400,094.White_breasted_Nuthatch,39,108,401,330,220,219,362,222
../../CUB_200_2011/images\094.White_breasted_Nuthatch/White_Breasted_Nuthatch_0060_86031.jpg,500,482,094.White_breasted_Nuthatch,87,107,436,386,261,246,349,279
../../CUB_200_2011/images\094.White_breasted_Nuthatch/White_Breasted_Nuthatch_0068_86033.jpg,400,500,094.White_breasted_Nuthatch,83,137,318,333,200,235,235,196
../../CUB_200_2011/images\094.White_breasted_Nuthatch/White_Breasted_Nuthatch_0110_86038.jpg,500,333,094.White_breasted_Nuthatch,30,101,482,282,256,191,452,181
../../CUB_200_2011/images\094.White_breasted_Nuthatch/White_Breasted_Nuthatch_0054_86551.jpg,500,333,094.White_breasted_Nuthatch,126,6,301,198,213,102,175,192
../../CUB_200_2011/images\094.White_breasted_Nuthatch/White_Breasted_Nuthatch_0086_86553.jpg,500,487,094.White_breasted_Nuthatch,49,85,452,325,250,205,403,240
../../CUB_200_2011/images\094.White_breasted_Nuthatch/White_Breasted_Nuthatch_0114_86554.jpg,500,375,094.White_breasted_Nuthatch,111,70,447,314,279,192,336,244
../../CUB_200_2011/images\094.White_breasted_Nuthatch/White_Breasted_Nuthatch_0018_85937.jpg,402,500,094.White_breasted_Nuthatch,61,134,340,378,200,256,279,244
../../CUB_200_2011/images\094.White_breasted_Nuthatch/White_Breasted_Nuthatch_0113_86057.jpg,500,375,094.White_breasted_Nuthatch,2,100,359,275,180,187,357,175
../../CUB_200_2011/images\094.White_breasted_Nuthatch/White_Breasted_Nuthatch_0063_86573.jpg,400,500,094.White_breasted_Nuthatch,84,110,366,425,225,267,282,315
../../CUB_200_2011/images\094.White_breasted_Nuthatch/White_Breasted_Nuthatch_0043_86196.jpg,500,471,094.White_breasted_Nuthatch,133,62,331,347,232,204,198,285
../../CUB_200_2011/images\094.White_breasted_Nuthatch/White_Breasted_Nuthatch_0055_86075.jpg,500,334,094.White_breasted_Nuthatch,96,2,340,269,218,135,244,267
../../CUB_200_2011/images\094.White_breasted_Nuthatch/White_Breasted_Nuthatch_0036_86596.jpg,500,375,094.White_breasted_Nuthatch,101,44,444,261,272,152,343,217
../../CUB_200_2011/images\094.White_breasted_Nuthatch/White_Breasted_Nuthatch_0111_86621.jpg,500,333,094.White_breasted_Nuthatch,24,91,422,323,223,207,398,232
../../CUB_200_2011/images\094.White_breasted_Nuthatch/White_Breasted_Nuthatch_0040_86127.jpg,500,375,094.White_breasted_Nuthatch,112,146,319,269,215,207,207,123
../../CUB_200_2011/images\094.White_breasted_Nuthatch/White_Breasted_Nuthatch_0096_86140.jpg,500,335,094.White_breasted_Nuthatch,167,27,318,187,242,107,151,160
../../CUB_200_2011/images\094.White_breasted_Nuthatch/White_Breasted_Nuthatch_0020_86143.jpg,500,495,094.White_breasted_Nuthatch,212,53,492,330,352,191,280,277
../../CUB_200_2011/images\094.White_breasted_Nuthatch/White_Breasted_Nuthatch_0094_86156.jpg,375,500,094.White_breasted_Nuthatch,15,173,294,309,154,241,279,136
../../CUB_200_2011/images\094.White_breasted_Nuthatch/White_Breasted_Nuthatch_0066_86159.jpg,500,312,094.White_breasted_Nuthatch,6,15,479,302,242,158,473,287
../../CUB_200_2011/images\094.White_breasted_Nuthatch/White_Breasted_Nuthatch_0039_86166.jpg,500,393,094.White_breasted_Nuthatch,19,139,366,326,192,232,347,187
../../CUB_200_2011/images\094.White_breasted_Nuthatch/White_Breasted_Nuthatch_0119_86182.jpg,400,500,094.White_breasted_Nuthatch,90,115,351,358,220,236,261,243
../../CUB_200_2011/images\094.White_breasted_Nuthatch/White_Breasted_Nuthatch_0049_86557.jpg,500,333,094.White_breasted_Nuthatch,29,34,483,303,256,168,454,269
../../CUB_200_2011/images\094.White_breasted_Nuthatch/White_Breasted_Nuthatch_0101_86708.jpg,402,259,094.White_breasted_Nuthatch,80,97,325,210,202,153,245,113
../../CUB_200_2011/images\094.White_breasted_Nuthatch/White_Breasted_Nuthatch_0024_86200.jpg,499,500,094.White_breasted_Nuthatch,69,72,414,463,241,267,345,391
../../CUB_200_2011/images\094.White_breasted_Nuthatch/White_Breasted_Nuthatch_0048_86207.jpg,500,362,094.White_breasted_Nuthatch,53,107,328,303,190,205,275,196
../../CUB_200_2011/images\094.White_breasted_Nuthatch/White_Breasted_Nuthatch_0115_86760.jpg,500,333,094.White_breasted_Nuthatch,135,162,253,296,194,229,118,134
../../CUB_200_2011/images\094.White_breasted_Nuthatch/White_Breasted_Nuthatch_0129_86761.jpg,500,375,094.White_breasted_Nuthatch,51,127,315,257,183,192,264,130
../../CUB_200_2011/images\094.White_breasted_Nuthatch/White_Breasted_Nuthatch_0002_86287.jpg,500,375,094.White_breasted_Nuthatch,0,108,419,318,209,213,419,210
../../CUB_200_2011/images\094.White_breasted_Nuthatch/White_Breasted_Nuthatch_0075_86289.jpg,308,500,094.White_breasted_Nuthatch,54,87,256,409,155,248,202,322
../../CUB_200_2011/images\094.White_breasted_Nuthatch/White_Breasted_Nuthatch_0142_86805.jpg,500,345,094.White_breasted_Nuthatch,38,89,447,306,242,197,409,217
../../CUB_200_2011/images\094.White_breasted_Nuthatch/White_Breasted_Nuthatch_0010_85783.jpg,500,333,094.White_breasted_Nuthatch,119,44,477,252,298,148,358,208
../../CUB_200_2011/images\094.White_breasted_Nuthatch/White_Breasted_Nuthatch_0108_86308.jpg,500,375,094.White_breasted_Nuthatch,50,27,431,327,240,177,381,300
../../CUB_200_2011/images\094.White_breasted_Nuthatch/White_Breasted_Nuthatch_0076_85801.jpg,500,429,094.White_breasted_Nuthatch,52,136,415,344,233,240,363,208
../../CUB_200_2011/images\094.White_breasted_Nuthatch/White_Breasted_Nuthatch_0025_85803.jpg,500,333,094.White_breasted_Nuthatch,131,103,363,259,247,181,232,156
../../CUB_200_2011/images\094.White_breasted_Nuthatch/White_Breasted_Nuthatch_0064_86324.jpg,500,333,094.White_breasted_Nuthatch,83,99,478,292,280,195,395,193
../../CUB_200_2011/images\094.White_breasted_Nuthatch/White_Breasted_Nuthatch_0050_85815.jpg,500,417,094.White_breasted_Nuthatch,79,151,463,328,271,239,384,177
../../CUB_200_2011/images\094.White_breasted_Nuthatch/White_Breasted_Nuthatch_0047_85819.jpg,500,387,094.White_breasted_Nuthatch,128,110,426,290,277,200,298,180
../../CUB_200_2011/images\094.White_breasted_Nuthatch/White_Breasted_Nuthatch_0030_85823.jpg,500,332,094.White_breasted_Nuthatch,90,95,384,251,237,173,294,156
../../CUB_200_2011/images\094.White_breasted_Nuthatch/White_Breasted_Nuthatch_0065_85829.jpg,500,375,094.White_breasted_Nuthatch,153,36,405,282,279,159,252,246
../../CUB_200_2011/images\094.White_breasted_Nuthatch/White_Breasted_Nuthatch_0090_86856.jpg,409,500,094.White_breasted_Nuthatch,209,51,327,299,268,175,118,248
../../CUB_200_2011/images\094.White_breasted_Nuthatch/White_Breasted_Nuthatch_0059_85903.jpg,500,357,094.White_breasted_Nuthatch,96,58,415,260,255,159,319,202
../../CUB_200_2011/images\094.White_breasted_Nuthatch/White_Breasted_Nuthatch_0132_86876.jpg,500,341,094.White_breasted_Nuthatch,124,153,319,258,221,205,195,105
../../CUB_200_2011/images\094.White_breasted_Nuthatch/White_Breasted_Nuthatch_0137_86910.jpg,500,259,094.White_breasted_Nuthatch,37,71,381,223,209,147,344,152
../../CUB_200_2011/images\094.White_breasted_Nuthatch/White_Breasted_Nuthatch_0120_85890.jpg,333,500,094.White_breasted_Nuthatch,26,11,300,384,163,197,274,373
../../CUB_200_2011/images\094.White_breasted_Nuthatch/White_Breasted_Nuthatch_0131_86416.jpg,333,500,094.White_breasted_Nuthatch,55,187,288,357,171,272,233,170
../../CUB_200_2011/images\094.White_breasted_Nuthatch/White_Breasted_Nuthatch_0027_85905.jpg,500,339,094.White_breasted_Nuthatch,111,133,468,288,289,210,357,155
../../CUB_200_2011/images\094.White_breasted_Nuthatch/White_Breasted_Nuthatch_0070_85983.jpg,500,333,094.White_breasted_Nuthatch,144,61,397,235,270,148,253,174
../../CUB_200_2011/images\094.White_breasted_Nuthatch/White_Breasted_Nuthatch_0095_86425.jpg,500,399,094.White_breasted_Nuthatch,207,102,429,354,318,228,222,252
../../CUB_200_2011/images\094.White_breasted_Nuthatch/White_Breasted_Nuthatch_0078_85828.jpg,333,500,094.White_breasted_Nuthatch,33,111,184,264,108,187,151,153
../../CUB_200_2011/images\094.White_breasted_Nuthatch/White_Breasted_Nuthatch_0082_86435.jpg,500,333,094.White_breasted_Nuthatch,78,71,448,266,263,168,370,195
../../CUB_200_2011/images\094.White_breasted_Nuthatch/White_Breasted_Nuthatch_0097_85940.jpg,500,400,094.White_breasted_Nuthatch,116,83,417,277,266,180,301,194
../../CUB_200_2011/images\094.White_breasted_Nuthatch/White_Breasted_Nuthatch_0004_86969.jpg,500,376,094.White_breasted_Nuthatch,115,55,470,354,292,204,355,299
../../CUB_200_2011/images\094.White_breasted_Nuthatch/White_Breasted_Nuthatch_0077_86462.jpg,500,473,094.White_breasted_Nuthatch,144,58,418,420,281,239,274,362
../../CUB_200_2011/images\094.White_breasted_Nuthatch/White_Breasted_Nuthatch_0106_85955.jpg,500,389,094.White_breasted_Nuthatch,115,24,344,332,229,178,229,308
../../CUB_200_2011/images\094.White_breasted_Nuthatch/White_Breasted_Nuthatch_0103_86470.jpg,500,332,094.White_breasted_Nuthatch,70,27,233,303,151,165,163,276
../../CUB_200_2011/images\094.White_breasted_Nuthatch/White_Breasted_Nuthatch_0104_85969.jpg,500,339,094.White_breasted_Nuthatch,91,42,395,278,243,160,304,236
../../CUB_200_2011/images\094.White_breasted_Nuthatch/White_Breasted_Nuthatch_0128_86947.jpg,500,333,094.White_breasted_Nuthatch,173,59,451,332,312,195,278,273
../../CUB_200_2011/images\094.White_breasted_Nuthatch/White_Breasted_Nuthatch_0042_86488.jpg,333,500,094.White_breasted_Nuthatch,66,133,273,322,169,227,207,189
../../CUB_200_2011/images\095.Baltimore_Oriole/Baltimore_Oriole_0127_87560.jpg,329,500,095.Baltimore_Oriole,63,133,318,348,190,240,255,215
../../CUB_200_2011/images\095.Baltimore_Oriole/Baltimore_Oriole_0027_87561.jpg,500,313,095.Baltimore_Oriole,60,19,484,285,272,152,424,266
../../CUB_200_2011/images\095.Baltimore_Oriole/Baltimore_Oriole_0090_87054.jpg,500,336,095.Baltimore_Oriole,111,129,314,248,212,188,203,119
../../CUB_200_2011/images\095.Baltimore_Oriole/Baltimore_Oriole_0060_89616.jpg,500,400,095.Baltimore_Oriole,219,118,443,308,331,213,224,190
../../CUB_200_2011/images\095.Baltimore_Oriole/Baltimore_Oriole_0108_87576.jpg,500,500,095.Baltimore_Oriole,175,99,375,400,275,249,200,301
../../CUB_200_2011/images\095.Baltimore_Oriole/Baltimore_Oriole_0020_87066.jpg,500,333,095.Baltimore_Oriole,88,4,499,332,293,168,411,328
../../CUB_200_2011/images\095.Baltimore_Oriole/Baltimore_Oriole_0038_87083.jpg,333,500,095.Baltimore_Oriole,142,71,312,401,227,236,170,330
../../CUB_200_2011/images\095.Baltimore_Oriole/Baltimore_Oriole_0021_87089.jpg,500,333,095.Baltimore_Oriole,77,46,385,306,231,176,308,260
../../CUB_200_2011/images\095.Baltimore_Oriole/Baltimore_Oriole_0133_87602.jpg,500,354,095.Baltimore_Oriole,125,83,368,192,246,137,243,109
../../CUB_200_2011/images\095.Baltimore_Oriole/Baltimore_Oriole_0126_89651.jpg,500,334,095.Baltimore_Oriole,201,125,319,248,260,186,118,123
../../CUB_200_2011/images\095.Baltimore_Oriole/Baltimore_Oriole_0071_89611.jpg,456,500,095.Baltimore_Oriole,131,90,276,453,203,271,145,363
../../CUB_200_2011/images\095.Baltimore_Oriole/Baltimore_Oriole_0106_89680.jpg,384,500,095.Baltimore_Oriole,78,45,290,436,184,240,212,391
../../CUB_200_2011/images\095.Baltimore_Oriole/Baltimore_Oriole_0084_89684.jpg,500,392,095.Baltimore_Oriole,118,95,291,341,204,218,173,246
../../CUB_200_2011/images\095.Baltimore_Oriole/Baltimore_Oriole_0047_89686.jpg,500,388,095.Baltimore_Oriole,65,103,417,372,241,237,352,269
../../CUB_200_2011/images\095.Baltimore_Oriole/Baltimore_Oriole_0076_89705.jpg,500,292,095.Baltimore_Oriole,15,99,261,291,138,195,246,192
../../CUB_200_2011/images\095.Baltimore_Oriole/Baltimore_Oriole_0083_89712.jpg,500,284,095.Baltimore_Oriole,185,65,439,238,312,151,254,173
../../CUB_200_2011/images\095.Baltimore_Oriole/Baltimore_Oriole_0045_88178.jpg,500,418,095.Baltimore_Oriole,55,152,276,358,165,255,221,206
../../CUB_200_2011/images\095.Baltimore_Oriole/Baltimore_Oriole_0024_89720.jpg,500,379,095.Baltimore_Oriole,236,143,478,356,357,249,242,213
../../CUB_200_2011/images\095.Baltimore_Oriole/Baltimore_Oriole_0019_88186.jpg,496,500,095.Baltimore_Oriole,269,137,386,305,327,221,117,168
../../CUB_200_2011/images\095.Baltimore_Oriole/Baltimore_Oriole_0087_89726.jpg,500,375,095.Baltimore_Oriole,141,24,411,299,276,161,270,275
../../CUB_200_2011/images\095.Baltimore_Oriole/Baltimore_Oriole_0014_87690.jpg,500,311,095.Baltimore_Oriole,17,27,466,293,241,160,449,266
../../CUB_200_2011/images\095.Baltimore_Oriole/Baltimore_Oriole_0073_87187.jpg,500,399,095.Baltimore_Oriole,39,54,364,373,201,213,325,319
../../CUB_200_2011/images\095.Baltimore_Oriole/Baltimore_Oriole_0101_87207.jpg,500,412,095.Baltimore_Oriole,109,121,281,337,195,229,172,216
../../CUB_200_2011/images\095.Baltimore_Oriole/Baltimore_Oriole_0074_87214.jpg,333,500,095.Baltimore_Oriole,76,116,314,481,195,298,238,365
../../CUB_200_2011/images\095.Baltimore_Oriole/Baltimore_Oriole_0042_87216.jpg,500,354,095.Baltimore_Oriole,178,70,365,264,271,167,187,194
../../CUB_200_2011/images\095.Baltimore_Oriole/Baltimore_Oriole_0051_89722.jpg,500,333,095.Baltimore_Oriole,157,144,378,300,267,222,221,156
../../CUB_200_2011/images\095.Baltimore_Oriole/Baltimore_Oriole_0054_89825.jpg,500,400,095.Baltimore_Oriole,159,68,488,310,323,189,329,242
../../CUB_200_2011/images\095.Baltimore_Oriole/Baltimore_Oriole_0018_87782.jpg,333,500,095.Baltimore_Oriole,35,60,307,498,171,279,272,438
../../CUB_200_2011/images\095.Baltimore_Oriole/Baltimore_Oriole_0102_88818.jpg,500,438,095.Baltimore_Oriole,49,85,313,313,181,199,264,228
../../CUB_200_2011/images\095.Baltimore_Oriole/Baltimore_Oriole_0128_87796.jpg,471,500,095.Baltimore_Oriole,38,77,357,451,197,264,319,374
../../CUB_200_2011/images\095.Baltimore_Oriole/Baltimore_Oriole_0037_87337.jpg,353,500,095.Baltimore_Oriole,148,182,292,390,220,286,144,208
../../CUB_200_2011/images\095.Baltimore_Oriole/Baltimore_Oriole_0058_87296.jpg,500,366,095.Baltimore_Oriole,164,13,478,234,321,123,314,221
../../CUB_200_2011/images\095.Baltimore_Oriole/Baltimore_Oriole_0065_87303.jpg,500,333,095.Baltimore_Oriole,195,121,295,256,245,188,100,135
../../CUB_200_2011/images\095.Baltimore_Oriole/Baltimore_Oriole_0114_89873.jpg,333,500,095.Baltimore_Oriole,95,154,231,499,163,326,136,345
../../CUB_200_2011/images\095.Baltimore_Oriole/Baltimore_Oriole_0033_88347.jpg,500,445,095.Baltimore_Oriole,162,147,401,381,281,264,239,234
../../CUB_200_2011/images\095.Baltimore_Oriole/Baltimore_Oriole_0016_89885.jpg,500,336,095.Baltimore_Oriole,74,81,313,228,193,154,239,147
../../CUB_200_2011/images\095.Baltimore_Oriole/Baltimore_Oriole_0082_87838.jpg,500,357,095.Baltimore_Oriole,170,61,310,328,240,194,140,267
../../CUB_200_2011/images\095.Baltimore_Oriole/Baltimore_Oriole_0069_87839.jpg,480,348,095.Baltimore_Oriole,55,79,372,301,213,190,317,222
../../CUB_200_2011/images\095.Baltimore_Oriole/Baltimore_Oriole_0056_88355.jpg,477,500,095.Baltimore_Oriole,92,95,347,455,219,275,255,360
../../CUB_200_2011/images\095.Baltimore_Oriole/Baltimore_Oriole_0100_89908.jpg,500,400,095.Baltimore_Oriole,68,179,287,300,177,239,219,121
../../CUB_200_2011/images\095.Baltimore_Oriole/Baltimore_Oriole_0086_88375.jpg,500,481,095.Baltimore_Oriole,46,83,328,470,187,276,282,387
../../CUB_200_2011/images\095.Baltimore_Oriole/Baltimore_Oriole_0041_87367.jpg,500,416,095.Baltimore_Oriole,22,73,315,353,168,213,293,280
../../CUB_200_2011/images\095.Baltimore_Oriole/Baltimore_Oriole_0006_89935.jpg,500,400,095.Baltimore_Oriole,136,74,345,286,240,180,209,212
../../CUB_200_2011/images\095.Baltimore_Oriole/Baltimore_Oriole_0120_88403.jpg,500,342,095.Baltimore_Oriole,110,73,290,245,200,159,180,172
../../CUB_200_2011/images\095.Baltimore_Oriole/Baltimore_Oriole_0066_87380.jpg,500,369,095.Baltimore_Oriole,6,94,331,302,168,198,325,208
../../CUB_200_2011/images\095.Baltimore_Oriole/Baltimore_Oriole_0109_87398.jpg,500,370,095.Baltimore_Oriole,30,104,254,338,142,221,224,234
../../CUB_200_2011/images\095.Baltimore_Oriole/Baltimore_Oriole_0125_88450.jpg,500,333,095.Baltimore_Oriole,167,63,331,289,249,176,164,226
../../CUB_200_2011/images\095.Baltimore_Oriole/Baltimore_Oriole_0050_89750.jpg,500,375,095.Baltimore_Oriole,226,186,407,303,316,244,181,117
../../CUB_200_2011/images\095.Baltimore_Oriole/Baltimore_Oriole_0092_87435.jpg,414,500,095.Baltimore_Oriole,69,110,305,372,187,241,236,262
../../CUB_200_2011/images\095.Baltimore_Oriole/Baltimore_Oriole_0112_87447.jpg,500,418,095.Baltimore_Oriole,21,90,293,345,157,217,272,255
../../CUB_200_2011/images\095.Baltimore_Oriole/Baltimore_Oriole_0111_87449.jpg,500,375,095.Baltimore_Oriole,49,125,337,286,193,205,288,161
../../CUB_200_2011/images\095.Baltimore_Oriole/Baltimore_Oriole_0091_88487.jpg,500,363,095.Baltimore_Oriole,207,106,469,310,338,208,262,204
../../CUB_200_2011/images\095.Baltimore_Oriole/Baltimore_Oriole_0104_86979.jpg,500,442,095.Baltimore_Oriole,24,60,458,412,241,236,434,352
../../CUB_200_2011/images\095.Baltimore_Oriole/Baltimore_Oriole_0052_89553.jpg,500,427,095.Baltimore_Oriole,37,107,398,378,217,242,361,271
../../CUB_200_2011/images\095.Baltimore_Oriole/Baltimore_Oriole_0064_89554.jpg,386,500,095.Baltimore_Oriole,100,120,367,464,233,292,267,344
../../CUB_200_2011/images\095.Baltimore_Oriole/Baltimore_Oriole_0119_88022.jpg,500,375,095.Baltimore_Oriole,170,108,389,310,279,209,219,202
../../CUB_200_2011/images\095.Baltimore_Oriole/Baltimore_Oriole_0039_88027.jpg,500,333,095.Baltimore_Oriole,34,84,348,285,191,184,314,201
../../CUB_200_2011/images\095.Baltimore_Oriole/Baltimore_Oriole_0007_88038.jpg,500,392,095.Baltimore_Oriole,66,37,370,173,218,105,304,136
../../CUB_200_2011/images\095.Baltimore_Oriole/Baltimore_Oriole_0131_87542.jpg,500,315,095.Baltimore_Oriole,149,110,250,270,199,190,101,160
../../CUB_200_2011/images\095.Baltimore_Oriole/Baltimore_Oriole_0130_89596.jpg,500,400,095.Baltimore_Oriole,53,109,321,350,187,229,268,241
../../CUB_200_2011/images\096.Hooded_Oriole/Hooded_Oriole_0050_90629.jpg,500,373,096.Hooded_Oriole,227,59,434,371,330,215,207,312
../../CUB_200_2011/images\096.Hooded_Oriole/Hooded_Oriole_0008_90118.jpg,500,357,096.Hooded_Oriole,104,80,300,257,202,168,196,177
../../CUB_200_2011/images\096.Hooded_Oriole/Hooded_Oriole_0047_90637.jpg,500,333,096.Hooded_Oriole,145,75,358,315,251,195,213,240
../../CUB_200_2011/images\096.Hooded_Oriole/Hooded_Oriole_0037_91156.jpg,425,310,096.Hooded_Oriole,21,68,337,257,179,162,316,189
../../CUB_200_2011/images\096.Hooded_Oriole/Hooded_Oriole_0024_90157.jpg,500,375,096.Hooded_Oriole,89,22,447,341,268,181,358,319
../../CUB_200_2011/images\096.Hooded_Oriole/Hooded_Oriole_0006_90685.jpg,500,325,096.Hooded_Oriole,151,114,399,252,275,183,248,138
../../CUB_200_2011/images\096.Hooded_Oriole/Hooded_Oriole_0034_90686.jpg,357,500,096.Hooded_Oriole,78,66,256,478,167,272,178,412
../../CUB_200_2011/images\096.Hooded_Oriole/Hooded_Oriole_0117_90464.jpg,357,500,096.Hooded_Oriole,141,96,291,455,216,275,150,359
../../CUB_200_2011/images\096.Hooded_Oriole/Hooded_Oriole_0127_90200.jpg,500,333,096.Hooded_Oriole,98,35,378,275,238,155,280,240
../../CUB_200_2011/images\096.Hooded_Oriole/Hooded_Oriole_0048_89957.jpg,500,341,096.Hooded_Oriole,110,76,277,282,193,179,167,206
../../CUB_200_2011/images\096.Hooded_Oriole/Hooded_Oriole_0041_90218.jpg,500,394,096.Hooded_Oriole,187,175,426,327,306,251,239,152
../../CUB_200_2011/images\096.Hooded_Oriole/Hooded_Oriole_0070_90221.jpg,500,334,096.Hooded_Oriole,154,84,429,264,291,174,275,180
../../CUB_200_2011/images\096.Hooded_Oriole/Hooded_Oriole_0056_89966.jpg,500,333,096.Hooded_Oriole,241,85,436,314,338,199,195,229
../../CUB_200_2011/images\096.Hooded_Oriole/Hooded_Oriole_0104_90264.jpg,500,400,096.Hooded_Oriole,139,14,354,230,246,122,215,216
../../CUB_200_2011/images\096.Hooded_Oriole/Hooded_Oriole_0072_90298.jpg,500,375,096.Hooded_Oriole,166,114,395,311,280,212,229,197
../../CUB_200_2011/images\096.Hooded_Oriole/Hooded_Oriole_0091_90821.jpg,477,500,096.Hooded_Oriole,40,116,450,421,245,268,410,305
../../CUB_200_2011/images\096.Hooded_Oriole/Hooded_Oriole_0096_90311.jpg,414,500,096.Hooded_Oriole,81,38,404,471,242,254,323,433
../../CUB_200_2011/images\096.Hooded_Oriole/Hooded_Oriole_0126_90319.jpg,500,333,096.Hooded_Oriole,216,89,333,281,274,185,117,192
../../CUB_200_2011/images\096.Hooded_Oriole/Hooded_Oriole_0035_90331.jpg,500,333,096.Hooded_Oriole,34,31,499,329,266,180,465,298
../../CUB_200_2011/images\096.Hooded_Oriole/Hooded_Oriole_0095_90337.jpg,432,389,096.Hooded_Oriole,64,45,386,319,225,182,322,274
../../CUB_200_2011/images\096.Hooded_Oriole/Hooded_Oriole_0055_90850.jpg,500,387,096.Hooded_Oriole,185,61,387,309,286,185,202,248
../../CUB_200_2011/images\096.Hooded_Oriole/Hooded_Oriole_0124_90350.jpg,500,333,096.Hooded_Oriole,160,107,302,303,231,205,142,196
../../CUB_200_2011/images\096.Hooded_Oriole/Hooded_Oriole_0088_90356.jpg,500,490,096.Hooded_Oriole,81,41,407,429,244,235,326,388
../../CUB_200_2011/images\096.Hooded_Oriole/Hooded_Oriole_0105_90875.jpg,500,333,096.Hooded_Oriole,46,95,365,291,205,193,319,196
../../CUB_200_2011/images\096.Hooded_Oriole/Hooded_Oriole_0060_90879.jpg,500,330,096.Hooded_Oriole,136,99,335,214,235,156,199,115
../../CUB_200_2011/images\096.Hooded_Oriole/Hooded_Oriole_0077_90886.jpg,500,399,096.Hooded_Oriole,107,42,267,319,187,180,160,277
../../CUB_200_2011/images\096.Hooded_Oriole/Hooded_Oriole_0125_90382.jpg,500,394,096.Hooded_Oriole,83,123,357,263,220,193,274,140
../../CUB_200_2011/images\096.Hooded_Oriole/Hooded_Oriole_0076_90895.jpg,500,356,096.Hooded_Oriole,94,33,261,312,177,172,167,279
../../CUB_200_2011/images\096.Hooded_Oriole/Hooded_Oriole_0053_90898.jpg,500,333,096.Hooded_Oriole,107,49,428,331,267,190,321,282
../../CUB_200_2011/images\096.Hooded_Oriole/Hooded_Oriole_0106_90899.jpg,500,440,096.Hooded_Oriole,84,50,446,364,265,207,362,314
../../CUB_200_2011/images\096.Hooded_Oriole/Hooded_Oriole_0068_90397.jpg,500,384,096.Hooded_Oriole,22,109,296,349,159,229,274,240
../../CUB_200_2011/images\096.Hooded_Oriole/Hooded_Oriole_0010_90413.jpg,500,318,096.Hooded_Oriole,42,76,429,286,235,181,387,210
../../CUB_200_2011/images\096.Hooded_Oriole/Hooded_Oriole_0045_90415.jpg,430,500,096.Hooded_Oriole,100,152,306,386,203,269,206,234
../../CUB_200_2011/images\096.Hooded_Oriole/Hooded_Oriole_0067_90416.jpg,500,377,096.Hooded_Oriole,119,175,349,376,234,275,230,201
../../CUB_200_2011/images\096.Hooded_Oriole/Hooded_Oriole_0130_90422.jpg,500,375,096.Hooded_Oriole,17,51,353,365,185,208,336,314
../../CUB_200_2011/images\096.Hooded_Oriole/Hooded_Oriole_0054_90849.jpg,500,324,096.Hooded_Oriole,38,121,384,292,211,206,346,171
../../CUB_200_2011/images\096.Hooded_Oriole/Hooded_Oriole_0129_90441.jpg,500,334,096.Hooded_Oriole,69,118,218,324,143,221,149,206
../../CUB_200_2011/images\096.Hooded_Oriole/Hooded_Oriole_0115_90442.jpg,305,448,096.Hooded_Oriole,40,30,269,398,154,214,229,368
../../CUB_200_2011/images\096.Hooded_Oriole/Hooded_Oriole_0013_90445.jpg,333,500,096.Hooded_Oriole,106,160,315,431,210,295,209,271
../../CUB_200_2011/images\096.Hooded_Oriole/Hooded_Oriole_0063_90976.jpg,500,333,096.Hooded_Oriole,156,50,335,301,245,175,179,251
../../CUB_200_2011/images\096.Hooded_Oriole/Hooded_Oriole_0049_89955.jpg,337,500,096.Hooded_Oriole,72,102,306,443,189,272,234,341
../../CUB_200_2011/images\096.Hooded_Oriole/Hooded_Oriole_0069_90981.jpg,496,500,096.Hooded_Oriole,49,159,384,350,216,254,335,191
../../CUB_200_2011/images\096.Hooded_Oriole/Hooded_Oriole_0029_90485.jpg,500,333,096.Hooded_Oriole,109,71,265,261,187,166,156,190
../../CUB_200_2011/images\096.Hooded_Oriole/Hooded_Oriole_0079_89978.jpg,500,313,096.Hooded_Oriole,156,121,367,245,261,183,211,124
../../CUB_200_2011/images\096.Hooded_Oriole/Hooded_Oriole_0107_89985.jpg,500,333,096.Hooded_Oriole,151,59,394,326,272,192,243,267
../../CUB_200_2011/images\096.Hooded_Oriole/Hooded_Oriole_0043_90499.jpg,500,469,096.Hooded_Oriole,106,73,342,192,224,132,236,119
../../CUB_200_2011/images\096.Hooded_Oriole/Hooded_Oriole_0111_89988.jpg,500,362,096.Hooded_Oriole,53,83,387,294,220,188,334,211
../../CUB_200_2011/images\096.Hooded_Oriole/Hooded_Oriole_0014_90594.jpg,280,420,096.Hooded_Oriole,53,56,267,200,160,128,214,144
../../CUB_200_2011/images\096.Hooded_Oriole/Hooded_Oriole_0002_91034.jpg,500,452,096.Hooded_Oriole,19,15,150,404,84,209,131,389
../../CUB_200_2011/images\096.Hooded_Oriole/Hooded_Oriole_0004_91057.jpg,367,500,096.Hooded_Oriole,93,116,302,433,197,274,209,317
../../CUB_200_2011/images\096.Hooded_Oriole/Hooded_Oriole_0087_90037.jpg,500,400,096.Hooded_Oriole,156,107,477,258,316,182,321,151
../../CUB_200_2011/images\096.Hooded_Oriole/Hooded_Oriole_0082_90045.jpg,372,500,096.Hooded_Oriole,83,67,328,437,205,252,245,370
../../CUB_200_2011/images\096.Hooded_Oriole/Hooded_Oriole_0118_90049.jpg,500,375,096.Hooded_Oriole,104,75,352,334,228,204,248,259
../../CUB_200_2011/images\096.Hooded_Oriole/Hooded_Oriole_0074_91081.jpg,500,375,096.Hooded_Oriole,149,62,353,348,251,205,204,286
../../CUB_200_2011/images\096.Hooded_Oriole/Hooded_Oriole_0038_90575.jpg,500,404,096.Hooded_Oriole,154,84,413,334,283,209,259,250
../../CUB_200_2011/images\096.Hooded_Oriole/Hooded_Oriole_0075_90788.jpg,500,326,096.Hooded_Oriole,192,51,371,320,281,185,179,269
../../CUB_200_2011/images\096.Hooded_Oriole/Hooded_Oriole_0044_90082.jpg,434,500,096.Hooded_Oriole,30,86,416,467,223,276,386,381
../../CUB_200_2011/images\096.Hooded_Oriole/Hooded_Oriole_0062_90089.jpg,500,333,096.Hooded_Oriole,237,28,401,332,319,180,164,304
../../CUB_200_2011/images\096.Hooded_Oriole/Hooded_Oriole_0084_90607.jpg,500,365,096.Hooded_Oriole,180,85,444,288,312,186,264,203
../../CUB_200_2011/images\096.Hooded_Oriole/Hooded_Oriole_0007_91133.jpg,500,333,096.Hooded_Oriole,142,110,251,266,196,188,109,156
../../CUB_200_2011/images\097.Orchard_Oriole/Orchard_Oriole_0077_91651.jpg,401,500,097.Orchard_Oriole,150,91,253,414,201,252,103,323
../../CUB_200_2011/images\097.Orchard_Oriole/Orchard_Oriole_0065_91397.jpg,334,500,097.Orchard_Oriole,87,121,226,291,156,206,139,170
../../CUB_200_2011/images\097.Orchard_Oriole/Orchard_Oriole_0082_91654.jpg,500,326,097.Orchard_Oriole,55,62,296,268,175,165,241,206
../../CUB_200_2011/images\097.Orchard_Oriole/Orchard_Oriole_0048_91393.jpg,500,395,097.Orchard_Oriole,118,141,343,294,230,217,225,153
../../CUB_200_2011/images\097.Orchard_Oriole/Orchard_Oriole_0098_91401.jpg,428,500,097.Orchard_Oriole,108,97,376,442,242,269,268,345
../../CUB_200_2011/images\097.Orchard_Oriole/Orchard_Oriole_0084_91658.jpg,500,406,097.Orchard_Oriole,39,72,371,334,205,203,332,262
../../CUB_200_2011/images\097.Orchard_Oriole/Orchard_Oriole_0085_91411.jpg,500,409,097.Orchard_Oriole,265,23,424,373,344,198,159,350
../../CUB_200_2011/images\097.Orchard_Oriole/Orchard_Oriole_0114_91412.jpg,500,341,097.Orchard_Oriole,45,59,439,298,242,178,394,239
../../CUB_200_2011/images\097.Orchard_Oriole/Orchard_Oriole_0054_91414.jpg,500,333,097.Orchard_Oriole,203,61,322,222,262,141,119,161
../../CUB_200_2011/images\097.Orchard_Oriole/Orchard_Oriole_0080_91417.jpg,500,377,097.Orchard_Oriole,68,133,200,310,134,221,132,177
../../CUB_200_2011/images\097.Orchard_Oriole/Orchard_Oriole_0042_91678.jpg,500,333,097.Orchard_Oriole,250,91,378,263,314,177,128,172
../../CUB_200_2011/images\097.Orchard_Oriole/Orchard_Oriole_0005_91682.jpg,500,362,097.Orchard_Oriole,176,96,353,270,264,183,177,174
../../CUB_200_2011/images\097.Orchard_Oriole/Orchard_Oriole_0013_91945.jpg,482,500,097.Orchard_Oriole,18,85,381,462,199,273,363,377
../../CUB_200_2011/images\097.Orchard_Oriole/Orchard_Oriole_0105_91186.jpg,500,469,097.Orchard_Oriole,138,81,396,376,267,228,258,295
../../CUB_200_2011/images\097.Orchard_Oriole/Orchard_Oriole_0026_91444.jpg,500,351,097.Orchard_Oriole,40,98,434,292,237,195,394,194
../../CUB_200_2011/images\097.Orchard_Oriole/Orchard_Oriole_0023_91705.jpg,316,500,097.Orchard_Oriole,32,148,202,337,117,242,170,189
../../CUB_200_2011/images\097.Orchard_Oriole/Orchard_Oriole_0032_91201.jpg,500,337,097.Orchard_Oriole,208,96,328,222,268,159,120,126
../../CUB_200_2011/images\097.Orchard_Oriole/Orchard_Oriole_0051_91787.jpg,417,500,097.Orchard_Oriole,180,99,326,322,253,210,146,223
../../CUB_200_2011/images\097.Orchard_Oriole/Orchard_Oriole_0045_91205.jpg,500,389,097.Orchard_Oriole,234,109,369,274,301,191,135,165
../../CUB_200_2011/images\097.Orchard_Oriole/Orchard_Oriole_0074_91979.jpg,500,375,097.Orchard_Oriole,161,36,353,343,257,189,192,307
../../CUB_200_2011/images\097.Orchard_Oriole/Orchard_Oriole_0006_91724.jpg,500,333,097.Orchard_Oriole,122,102,452,307,287,204,330,205
../../CUB_200_2011/images\097.Orchard_Oriole/Orchard_Oriole_0107_91472.jpg,333,500,097.Orchard_Oriole,87,73,307,408,197,240,220,335
../../CUB_200_2011/images\097.Orchard_Oriole/Orchard_Oriole_0035_92003.jpg,500,375,097.Orchard_Oriole,259,147,436,259,347,203,177,112
../../CUB_200_2011/images\097.Orchard_Oriole/Orchard_Oriole_0113_88407.jpg,405,500,097.Orchard_Oriole,109,95,401,416,255,255,292,321
../../CUB_200_2011/images\097.Orchard_Oriole/Orchard_Oriole_0101_91233.jpg,500,389,097.Orchard_Oriole,127,104,412,372,269,238,285,268
../../CUB_200_2011/images\097.Orchard_Oriole/Orchard_Oriole_0024_91755.jpg,500,400,097.Orchard_Oriole,105,79,405,310,255,194,300,231
../../CUB_200_2011/images\097.Orchard_Oriole/Orchard_Oriole_0093_92020.jpg,500,375,097.Orchard_Oriole,112,60,443,214,277,137,331,154
../../CUB_200_2011/images\097.Orchard_Oriole/Orchard_Oriole_0041_91258.jpg,439,500,097.Orchard_Oriole,146,67,418,440,282,253,272,373
../../CUB_200_2011/images\097.Orchard_Oriole/Orchard_Oriole_0055_91515.jpg,500,333,097.Orchard_Oriole,217,95,352,282,284,188,135,187
../../CUB_200_2011/images\097.Orchard_Oriole/Orchard_Oriole_0091_91774.jpg,500,333,097.Orchard_Oriole,109,69,266,221,187,145,157,152
../../CUB_200_2011/images\097.Orchard_Oriole/Orchard_Oriole_0027_91265.jpg,500,358,097.Orchard_Oriole,42,111,331,264,186,187,289,153
../../CUB_200_2011/images\097.Orchard_Oriole/Orchard_Oriole_0039_91267.jpg,500,433,097.Orchard_Oriole,123,128,458,255,290,191,335,127
../../CUB_200_2011/images\097.Orchard_Oriole/Orchard_Oriole_0092_92128.jpg,500,383,097.Orchard_Oriole,118,102,462,331,290,216,344,229
../../CUB_200_2011/images\097.Orchard_Oriole/Orchard_Oriole_0076_91527.jpg,500,337,097.Orchard_Oriole,35,50,464,304,249,177,429,254
../../CUB_200_2011/images\097.Orchard_Oriole/Orchard_Oriole_0108_91530.jpg,500,400,097.Orchard_Oriole,91,98,306,308,198,203,215,210
../../CUB_200_2011/images\097.Orchard_Oriole/Orchard_Oriole_0004_91275.jpg,500,357,097.Orchard_Oriole,80,96,322,238,201,167,242,142
../../CUB_200_2011/images\097.Orchard_Oriole/Orchard_Oriole_0033_91532.jpg,500,376,097.Orchard_Oriole,141,37,371,339,256,188,230,302
../../CUB_200_2011/images\097.Orchard_Oriole/Orchard_Oriole_0059_92046.jpg,375,500,097.Orchard_Oriole,49,204,335,424,192,314,286,220
../../CUB_200_2011/images\097.Orchard_Oriole/Orchard_Oriole_0106_91830.jpg,500,375,097.Orchard_Oriole,88,112,336,322,212,217,248,210
../../CUB_200_2011/images\097.Orchard_Oriole/Orchard_Oriole_0060_91536.jpg,500,375,097.Orchard_Oriole,118,81,351,355,234,218,233,274
../../CUB_200_2011/images\097.Orchard_Oriole/Orchard_Oriole_0061_91941.jpg,368,500,097.Orchard_Oriole,6,231,218,399,112,315,212,168
../../CUB_200_2011/images\097.Orchard_Oriole/Orchard_Oriole_0017_91801.jpg,500,435,097.Orchard_Oriole,74,38,431,345,252,191,357,307
../../CUB_200_2011/images\097.Orchard_Oriole/Orchard_Oriole_0036_91818.jpg,500,344,097.Orchard_Oriole,88,52,452,325,270,188,364,273
../../CUB_200_2011/images\097.Orchard_Oriole/Orchard_Oriole_0058_91819.jpg,500,381,097.Orchard_Oriole,104,108,468,291,286,199,364,183
../../CUB_200_2011/images\097.Orchard_Oriole/Orchard_Oriole_0015_91565.jpg,500,375,097.Orchard_Oriole,54,77,219,238,136,157,165,161
../../CUB_200_2011/images\097.Orchard_Oriole/Orchard_Oriole_0034_91825.jpg,500,365,097.Orchard_Oriole,76,66,364,303,220,184,288,237
../../CUB_200_2011/images\097.Orchard_Oriole/Orchard_Oriole_0088_92086.jpg,500,388,097.Orchard_Oriole,42,59,352,365,197,212,310,306
../../CUB_200_2011/images\097.Orchard_Oriole/Orchard_Oriole_0075_91847.jpg,500,375,097.Orchard_Oriole,72,106,379,234,225,170,307,128
../../CUB_200_2011/images\097.Orchard_Oriole/Orchard_Oriole_0011_91592.jpg,500,412,097.Orchard_Oriole,135,68,380,377,257,222,245,309
../../CUB_200_2011/images\097.Orchard_Oriole/Orchard_Oriole_0019_91338.jpg,500,333,097.Orchard_Oriole,18,25,429,313,223,169,411,288
../../CUB_200_2011/images\097.Orchard_Oriole/Orchard_Oriole_0095_91345.jpg,500,333,097.Orchard_Oriole,151,75,411,230,281,152,260,155
../../CUB_200_2011/images\097.Orchard_Oriole/Orchard_Oriole_0030_91612.jpg,500,487,097.Orchard_Oriole,81,92,408,431,244,261,327,339
../../CUB_200_2011/images\097.Orchard_Oriole/Orchard_Oriole_0044_91360.jpg,500,333,097.Orchard_Oriole,114,76,357,297,235,186,243,221
../../CUB_200_2011/images\097.Orchard_Oriole/Orchard_Oriole_0018_91601.jpg,500,400,097.Orchard_Oriole,177,89,401,327,289,208,224,238
../../CUB_200_2011/images\097.Orchard_Oriole/Orchard_Oriole_0116_91645.jpg,500,315,097.Orchard_Oriole,121,108,332,236,226,172,211,128
../../CUB_200_2011/images\097.Orchard_Oriole/Orchard_Oriole_0046_91646.jpg,500,333,097.Orchard_Oriole,224,128,401,290,312,209,177,162
../../CUB_200_2011/images\097.Orchard_Oriole/Orchard_Oriole_0070_91383.jpg,399,500,097.Orchard_Oriole,4,25,315,166,159,95,311,141
../../CUB_200_2011/images\097.Orchard_Oriole/Orchard_Oriole_0021_91644.jpg,500,331,097.Orchard_Oriole,83,190,283,314,183,252,200,124
../../CUB_200_2011/images\097.Orchard_Oriole/Orchard_Oriole_0009_91902.jpg,500,335,097.Orchard_Oriole,130,45,252,299,191,172,122,254
../../CUB_200_2011/images\098.Scott_Oriole/Scott_Oriole_0015_795862.jpg,500,333,098.Scott_Oriole,68,28,469,259,268,143,401,231
../../CUB_200_2011/images\098.Scott_Oriole/Scott_Oriole_0007_92439.jpg,378,500,098.Scott_Oriole,66,72,338,397,202,234,272,325
../../CUB_200_2011/images\098.Scott_Oriole/Scott_Oriole_0052_92440.jpg,500,350,098.Scott_Oriole,179,122,476,283,327,202,297,161
../../CUB_200_2011/images\098.Scott_Oriole/Scott_Oriole_0085_92206.jpg,500,375,098.Scott_Oriole,125,94,384,293,254,193,259,199
../../CUB_200_2011/images\098.Scott_Oriole/Scott_Oriole_0025_92207.jpg,500,334,098.Scott_Oriole,117,35,381,300,249,167,264,265
../../CUB_200_2011/images\098.Scott_Oriole/Scott_Oriole_0045_92237.jpg,500,333,098.Scott_Oriole,191,70,432,305,311,187,241,235
../../CUB_200_2011/images\098.Scott_Oriole/Scott_Oriole_0003_92247.jpg,500,321,098.Scott_Oriole,129,87,470,314,299,200,341,227
../../CUB_200_2011/images\098.Scott_Oriole/Scott_Oriole_0079_92248.jpg,334,500,098.Scott_Oriole,51,133,266,439,158,286,215,306
../../CUB_200_2011/images\098.Scott_Oriole/Scott_Oriole_0044_92262.jpg,500,354,098.Scott_Oriole,220,34,340,343,280,188,120,309
../../CUB_200_2011/images\098.Scott_Oriole/Scott_Oriole_0028_92270.jpg,400,500,098.Scott_Oriole,15,108,286,441,150,274,271,333
../../CUB_200_2011/images\098.Scott_Oriole/Scott_Oriole_0069_92271.jpg,448,299,098.Scott_Oriole,21,54,321,212,171,133,300,158
../../CUB_200_2011/images\098.Scott_Oriole/Scott_Oriole_0024_92302.jpg,500,375,098.Scott_Oriole,174,115,421,272,297,193,247,157
../../CUB_200_2011/images\098.Scott_Oriole/Scott_Oriole_0054_92310.jpg,500,375,098.Scott_Oriole,128,39,288,290,208,164,160,251
../../CUB_200_2011/images\098.Scott_Oriole/Scott_Oriole_0042_795844.jpg,149,160,098.Scott_Oriole,34,41,148,150,91,95,114,109
../../CUB_200_2011/images\098.Scott_Oriole/Scott_Oriole_0068_795804.jpg,500,474,098.Scott_Oriole,165,67,345,451,255,259,180,384
../../CUB_200_2011/images\098.Scott_Oriole/Scott_Oriole_0053_795805.jpg,480,331,098.Scott_Oriole,7,10,466,325,236,167,459,315
../../CUB_200_2011/images\098.Scott_Oriole/Scott_Oriole_0031_90270.jpg,500,375,098.Scott_Oriole,171,120,464,336,317,228,293,216
../../CUB_200_2011/images\098.Scott_Oriole/Scott_Oriole_0051_795807.jpg,404,271,098.Scott_Oriole,135,56,356,202,245,129,221,146
../../CUB_200_2011/images\098.Scott_Oriole/Scott_Oriole_0070_795808.jpg,300,450,098.Scott_Oriole,90,82,257,352,173,217,167,270
../../CUB_200_2011/images\098.Scott_Oriole/Scott_Oriole_0064_92321.jpg,500,428,098.Scott_Oriole,106,74,290,420,198,247,184,346
../../CUB_200_2011/images\098.Scott_Oriole/Scott_Oriole_0032_795810.jpg,364,432,098.Scott_Oriole,64,84,330,394,197,239,266,310
../../CUB_200_2011/images\098.Scott_Oriole/Scott_Oriole_0063_795812.jpg,450,362,098.Scott_Oriole,116,53,382,361,249,207,266,308
../../CUB_200_2011/images\098.Scott_Oriole/Scott_Oriole_0034_795813.jpg,400,266,098.Scott_Oriole,40,32,344,259,192,145,304,227
../../CUB_200_2011/images\098.Scott_Oriole/Scott_Oriole_0008_795814.jpg,316,265,098.Scott_Oriole,81,62,262,195,171,128,181,133
../../CUB_200_2011/images\098.Scott_Oriole/Scott_Oriole_0019_795815.jpg,366,287,098.Scott_Oriole,18,13,363,269,190,141,345,256
../../CUB_200_2011/images\098.Scott_Oriole/Scott_Oriole_0056_795816.jpg,230,300,098.Scott_Oriole,41,48,207,274,124,161,166,226
../../CUB_200_2011/images\098.Scott_Oriole/Scott_Oriole_0038_795818.jpg,330,240,098.Scott_Oriole,22,17,219,239,120,128,197,222
../../CUB_200_2011/images\098.Scott_Oriole/Scott_Oriole_0065_795819.jpg,500,321,098.Scott_Oriole,51,53,320,289,185,171,269,236
../../CUB_200_2011/images\098.Scott_Oriole/Scott_Oriole_0083_795821.jpg,500,335,098.Scott_Oriole,148,100,420,264,284,182,272,164
../../CUB_200_2011/images\098.Scott_Oriole/Scott_Oriole_0072_795822.jpg,404,271,098.Scott_Oriole,104,42,230,216,167,129,126,174
../../CUB_200_2011/images\098.Scott_Oriole/Scott_Oriole_0055_795825.jpg,480,368,098.Scott_Oriole,87,74,400,271,243,172,313,197
../../CUB_200_2011/images\098.Scott_Oriole/Scott_Oriole_0001_795826.jpg,500,436,098.Scott_Oriole,105,145,455,359,280,252,350,214
../../CUB_200_2011/images\098.Scott_Oriole/Scott_Oriole_0014_795827.jpg,500,388,098.Scott_Oriole,48,41,433,325,240,183,385,284
../../CUB_200_2011/images\098.Scott_Oriole/Scott_Oriole_0043_795828.jpg,334,500,098.Scott_Oriole,27,117,299,431,163,274,272,314
../../CUB_200_2011/images\098.Scott_Oriole/Scott_Oriole_0002_795829.jpg,209,275,098.Scott_Oriole,16,49,138,243,77,146,122,194
../../CUB_200_2011/images\098.Scott_Oriole/Scott_Oriole_0030_795830.jpg,500,368,098.Scott_Oriole,172,89,427,354,299,221,255,265
../../CUB_200_2011/images\098.Scott_Oriole/Scott_Oriole_0077_795831.jpg,480,368,098.Scott_Oriole,116,104,346,303,231,203,230,199
../../CUB_200_2011/images\098.Scott_Oriole/Scott_Oriole_0017_795832.jpg,500,333,098.Scott_Oriole,157,21,473,332,315,176,316,311
../../CUB_200_2011/images\098.Scott_Oriole/Scott_Oriole_0078_795833.jpg,390,312,098.Scott_Oriole,61,77,351,262,206,169,290,185
../../CUB_200_2011/images\098.Scott_Oriole/Scott_Oriole_0023_795835.jpg,350,350,098.Scott_Oriole,115,46,258,284,186,165,143,238
../../CUB_200_2011/images\098.Scott_Oriole/Scott_Oriole_0011_795836.jpg,348,258,098.Scott_Oriole,14,32,311,224,162,128,297,192
../../CUB_200_2011/images\098.Scott_Oriole/Scott_Oriole_0012_795837.jpg,500,333,098.Scott_Oriole,245,92,355,329,300,210,110,237
../../CUB_200_2011/images\098.Scott_Oriole/Scott_Oriole_0040_795839.jpg,500,368,098.Scott_Oriole,51,35,382,327,216,181,331,292
../../CUB_200_2011/images\098.Scott_Oriole/Scott_Oriole_0018_795840.jpg,142,160,098.Scott_Oriole,40,21,141,157,90,89,101,136
../../CUB_200_2011/images\098.Scott_Oriole/Scott_Oriole_0022_92356.jpg,500,375,098.Scott_Oriole,187,158,383,272,285,215,196,114
../../CUB_200_2011/images\098.Scott_Oriole/Scott_Oriole_0029_795846.jpg,400,500,098.Scott_Oriole,146,99,252,354,199,226,106,255
../../CUB_200_2011/images\098.Scott_Oriole/Scott_Oriole_0071_795848.jpg,500,402,098.Scott_Oriole,58,82,284,338,171,210,226,256
../../CUB_200_2011/images\098.Scott_Oriole/Scott_Oriole_0058_795849.jpg,200,300,098.Scott_Oriole,38,34,150,263,94,148,112,229
../../CUB_200_2011/images\098.Scott_Oriole/Scott_Oriole_0005_92362.jpg,500,374,098.Scott_Oriole,159,88,300,275,229,181,141,187
../../CUB_200_2011/images\098.Scott_Oriole/Scott_Oriole_0035_795851.jpg,480,480,098.Scott_Oriole,0,104,460,390,230,247,460,286
../../CUB_200_2011/images\098.Scott_Oriole/Scott_Oriole_0010_795852.jpg,500,350,098.Scott_Oriole,103,45,465,326,284,185,362,281
../../CUB_200_2011/images\098.Scott_Oriole/Scott_Oriole_0073_92369.jpg,500,375,098.Scott_Oriole,36,23,423,318,229,170,387,295
../../CUB_200_2011/images\098.Scott_Oriole/Scott_Oriole_0067_795858.jpg,500,337,098.Scott_Oriole,176,80,472,272,324,176,296,192
../../CUB_200_2011/images\098.Scott_Oriole/Scott_Oriole_0046_92371.jpg,500,451,098.Scott_Oriole,209,146,355,358,282,252,146,212
../../CUB_200_2011/images\098.Scott_Oriole/Scott_Oriole_0084_795860.jpg,332,500,098.Scott_Oriole,21,73,223,447,122,260,202,374
../../CUB_200_2011/images\098.Scott_Oriole/Scott_Oriole_0081_92374.jpg,474,419,098.Scott_Oriole,116,100,457,358,286,229,341,258
../../CUB_200_2011/images\098.Scott_Oriole/Scott_Oriole_0036_795850.jpg,330,220,098.Scott_Oriole,92,21,286,195,189,108,194,174
../../CUB_200_2011/images\098.Scott_Oriole/Scott_Oriole_0057_795856.jpg,500,334,098.Scott_Oriole,170,76,458,312,314,194,288,236
../../CUB_200_2011/images\098.Scott_Oriole/Scott_Oriole_0016_92398.jpg,500,346,098.Scott_Oriole,151,90,305,278,228,184,154,188
../../CUB_200_2011/images\098.Scott_Oriole/Scott_Oriole_0075_795817.jpg,500,334,098.Scott_Oriole,9,41,415,329,212,185,406,288
../../CUB_200_2011/images\099.Ovenbird/Ovenbird_0050_92672.jpg,500,357,099.Ovenbird,155,40,448,351,301,195,293,311
../../CUB_200_2011/images\099.Ovenbird/Ovenbird_0108_92675.jpg,500,325,099.Ovenbird,119,114,320,251,219,182,201,137
../../CUB_200_2011/images\099.Ovenbird/Ovenbird_0032_93199.jpg,500,333,099.Ovenbird,202,125,334,241,268,183,132,116
../../CUB_200_2011/images\099.Ovenbird/Ovenbird_0047_93203.jpg,333,500,099.Ovenbird,67,125,300,391,183,258,233,266
../../CUB_200_2011/images\099.Ovenbird/Ovenbird_0019_92699.jpg,500,376,099.Ovenbird,211,101,442,274,326,187,231,173
../../CUB_200_2011/images\099.Ovenbird/Ovenbird_0022_92702.jpg,500,335,099.Ovenbird,207,125,374,253,290,189,167,128
../../CUB_200_2011/images\099.Ovenbird/Ovenbird_0093_92705.jpg,500,333,099.Ovenbird,106,112,352,265,229,188,246,153
../../CUB_200_2011/images\099.Ovenbird/Ovenbird_0033_93232.jpg,500,333,099.Ovenbird,174,109,332,263,253,186,158,154
../../CUB_200_2011/images\099.Ovenbird/Ovenbird_0089_93234.jpg,500,357,099.Ovenbird,71,9,437,340,254,174,366,331
../../CUB_200_2011/images\099.Ovenbird/Ovenbird_0104_92763.jpg,500,375,099.Ovenbird,188,59,361,355,274,207,173,296
../../CUB_200_2011/images\099.Ovenbird/Ovenbird_0012_92778.jpg,500,306,099.Ovenbird,227,96,406,217,316,156,179,121
../../CUB_200_2011/images\099.Ovenbird/Ovenbird_0035_92785.jpg,357,500,099.Ovenbird,105,122,348,457,226,289,243,335
../../CUB_200_2011/images\099.Ovenbird/Ovenbird_0095_92796.jpg,399,433,099.Ovenbird,97,61,255,382,176,221,158,321
../../CUB_200_2011/images\099.Ovenbird/Ovenbird_0046_92821.jpg,481,500,099.Ovenbird,114,116,287,352,200,234,173,236
../../CUB_200_2011/images\099.Ovenbird/Ovenbird_0044_92828.jpg,500,375,099.Ovenbird,180,78,499,345,339,211,319,267
../../CUB_200_2011/images\099.Ovenbird/Ovenbird_0026_92850.jpg,500,391,099.Ovenbird,154,115,397,308,275,211,243,193
../../CUB_200_2011/images\099.Ovenbird/Ovenbird_0128_93366.jpg,457,500,099.Ovenbird,53,204,335,312,194,258,282,108
../../CUB_200_2011/images\099.Ovenbird/Ovenbird_0136_92859.jpg,500,464,099.Ovenbird,70,69,292,423,181,246,222,354
../../CUB_200_2011/images\099.Ovenbird/Ovenbird_0043_93374.jpg,500,369,099.Ovenbird,155,109,453,292,304,200,298,183
../../CUB_200_2011/images\099.Ovenbird/Ovenbird_0090_93375.jpg,500,387,099.Ovenbird,6,62,445,339,225,200,439,277
../../CUB_200_2011/images\099.Ovenbird/Ovenbird_0004_92868.jpg,500,334,099.Ovenbird,114,64,282,277,198,170,168,213
../../CUB_200_2011/images\099.Ovenbird/Ovenbird_0048_92876.jpg,500,457,099.Ovenbird,131,97,416,361,273,229,285,264
../../CUB_200_2011/images\099.Ovenbird/Ovenbird_0009_93395.jpg,500,398,099.Ovenbird,65,77,429,363,247,220,364,286
../../CUB_200_2011/images\099.Ovenbird/Ovenbird_0084_92901.jpg,500,333,099.Ovenbird,145,60,374,295,259,177,229,235
../../CUB_200_2011/images\099.Ovenbird/Ovenbird_0092_93416.jpg,500,381,099.Ovenbird,170,109,376,268,273,188,206,159
../../CUB_200_2011/images\099.Ovenbird/Ovenbird_0003_92910.jpg,500,498,099.Ovenbird,148,50,349,491,248,270,201,441
../../CUB_200_2011/images\099.Ovenbird/Ovenbird_0045_92973.jpg,500,375,099.Ovenbird,105,101,232,268,168,184,127,167
../../CUB_200_2011/images\099.Ovenbird/Ovenbird_0010_92957.jpg,500,375,099.Ovenbird,156,82,376,290,266,186,220,208
../../CUB_200_2011/images\099.Ovenbird/Ovenbird_0130_92452.jpg,500,333,099.Ovenbird,64,52,458,291,261,171,394,239
../../CUB_200_2011/images\099.Ovenbird/Ovenbird_0099_93148.jpg,500,318,099.Ovenbird,46,48,378,306,212,177,332,258
../../CUB_200_2011/images\099.Ovenbird/Ovenbird_0053_92462.jpg,500,439,099.Ovenbird,73,43,456,377,264,210,383,334
../../CUB_200_2011/images\099.Ovenbird/Ovenbird_0059_92470.jpg,500,333,099.Ovenbird,122,77,326,249,224,163,204,172
../../CUB_200_2011/images\099.Ovenbird/Ovenbird_0122_92993.jpg,500,375,099.Ovenbird,115,147,397,368,256,257,282,221
../../CUB_200_2011/images\099.Ovenbird/Ovenbird_0118_93002.jpg,500,383,099.Ovenbird,152,124,391,278,271,201,239,154
../../CUB_200_2011/images\099.Ovenbird/Ovenbird_0034_93006.jpg,333,500,099.Ovenbird,96,113,252,499,174,306,156,386
../../CUB_200_2011/images\099.Ovenbird/Ovenbird_0112_93018.jpg,500,333,099.Ovenbird,77,39,478,307,277,173,401,268
../../CUB_200_2011/images\099.Ovenbird/Ovenbird_0098_93032.jpg,500,335,099.Ovenbird,51,59,292,256,171,157,241,197
../../CUB_200_2011/images\099.Ovenbird/Ovenbird_0011_92451.jpg,500,341,099.Ovenbird,130,102,387,271,258,186,257,169
../../CUB_200_2011/images\099.Ovenbird/Ovenbird_0064_93208.jpg,500,367,099.Ovenbird,144,17,336,319,240,168,192,302
../../CUB_200_2011/images\099.Ovenbird/Ovenbird_0015_93037.jpg,500,338,099.Ovenbird,105,84,437,278,271,181,332,194
../../CUB_200_2011/images\099.Ovenbird/Ovenbird_0023_92534.jpg,333,500,099.Ovenbird,50,45,200,276,125,160,150,231
../../CUB_200_2011/images\099.Ovenbird/Ovenbird_0020_93049.jpg,500,333,099.Ovenbird,62,92,414,275,238,183,352,183
../../CUB_200_2011/images\099.Ovenbird/Ovenbird_0131_92559.jpg,500,352,099.Ovenbird,84,86,437,262,260,174,353,176
../../CUB_200_2011/images\099.Ovenbird/Ovenbird_0083_92561.jpg,500,378,099.Ovenbird,93,102,483,327,288,214,390,225
../../CUB_200_2011/images\099.Ovenbird/Ovenbird_0058_93078.jpg,500,368,099.Ovenbird,100,76,301,289,200,182,201,213
../../CUB_200_2011/images\099.Ovenbird/Ovenbird_0027_93086.jpg,500,357,099.Ovenbird,90,92,453,343,271,217,363,251
../../CUB_200_2011/images\099.Ovenbird/Ovenbird_0094_92577.jpg,500,420,099.Ovenbird,119,152,365,315,242,233,246,163
../../CUB_200_2011/images\099.Ovenbird/Ovenbird_0024_92583.jpg,500,419,099.Ovenbird,107,148,294,263,200,205,187,115
../../CUB_200_2011/images\099.Ovenbird/Ovenbird_0077_92590.jpg,500,459,099.Ovenbird,44,127,350,383,197,255,306,256
../../CUB_200_2011/images\099.Ovenbird/Ovenbird_0124_93103.jpg,382,500,099.Ovenbird,73,76,348,460,210,268,275,384
../../CUB_200_2011/images\099.Ovenbird/Ovenbird_0101_93104.jpg,500,354,099.Ovenbird,74,72,264,322,169,197,190,250
../../CUB_200_2011/images\099.Ovenbird/Ovenbird_0054_92594.jpg,500,333,099.Ovenbird,241,105,401,250,321,177,160,145
../../CUB_200_2011/images\099.Ovenbird/Ovenbird_0126_92602.jpg,500,343,099.Ovenbird,248,54,385,278,316,166,137,224
../../CUB_200_2011/images\099.Ovenbird/Ovenbird_0081_93115.jpg,420,280,099.Ovenbird,134,50,364,225,249,137,230,175
../../CUB_200_2011/images\099.Ovenbird/Ovenbird_0079_92610.jpg,500,333,099.Ovenbird,84,87,366,255,225,171,282,168
../../CUB_200_2011/images\099.Ovenbird/Ovenbird_0096_93131.jpg,500,333,099.Ovenbird,32,92,368,307,200,199,336,215
../../CUB_200_2011/images\099.Ovenbird/Ovenbird_0070_93140.jpg,500,333,099.Ovenbird,71,28,258,303,164,165,187,275
../../CUB_200_2011/images\099.Ovenbird/Ovenbird_0137_92639.jpg,500,334,099.Ovenbird,177,2,440,287,308,144,263,285
../../CUB_200_2011/images\099.Ovenbird/Ovenbird_0135_93168.jpg,500,350,099.Ovenbird,121,121,332,266,226,193,211,145
../../CUB_200_2011/images\099.Ovenbird/Ovenbird_0102_93172.jpg,500,359,099.Ovenbird,107,119,412,350,259,234,305,231
../../CUB_200_2011/images\100.Brown_Pelican/Brown_Pelican_0127_93700.jpg,357,500,100.Brown_Pelican,49,41,311,429,180,235,262,388
../../CUB_200_2011/images\100.Brown_Pelican/Brown_Pelican_0041_93720.jpg,368,500,100.Brown_Pelican,68,46,349,465,208,255,281,419
../../CUB_200_2011/images\100.Brown_Pelican/Brown_Pelican_0102_93727.jpg,500,333,100.Brown_Pelican,48,39,313,259,180,149,265,220
../../CUB_200_2011/images\100.Brown_Pelican/Brown_Pelican_0115_93731.jpg,401,500,100.Brown_Pelican,45,45,240,345,142,195,195,300
../../CUB_200_2011/images\100.Brown_Pelican/Brown_Pelican_0009_94256.jpg,500,400,100.Brown_Pelican,70,33,373,280,221,156,303,247
../../CUB_200_2011/images\100.Brown_Pelican/Brown_Pelican_0002_94773.jpg,333,500,100.Brown_Pelican,70,55,298,431,184,243,228,376
../../CUB_200_2011/images\100.Brown_Pelican/Brown_Pelican_0086_93757.jpg,500,367,100.Brown_Pelican,29,42,476,312,252,177,447,270
../../CUB_200_2011/images\100.Brown_Pelican/Brown_Pelican_0103_94787.jpg,500,375,100.Brown_Pelican,101,30,281,299,191,164,180,269
../../CUB_200_2011/images\100.Brown_Pelican/Brown_Pelican_0110_93622.jpg,320,500,100.Brown_Pelican,46,80,305,487,175,283,259,407
../../CUB_200_2011/images\100.Brown_Pelican/Brown_Pelican_0097_93767.jpg,500,335,100.Brown_Pelican,52,35,481,299,266,167,429,264
../../CUB_200_2011/images\100.Brown_Pelican/Brown_Pelican_0095_94290.jpg,500,375,100.Brown_Pelican,83,81,441,261,262,171,358,180
../../CUB_200_2011/images\100.Brown_Pelican/Brown_Pelican_0073_94823.jpg,333,500,100.Brown_Pelican,61,93,245,276,153,184,184,183
../../CUB_200_2011/images\100.Brown_Pelican/Brown_Pelican_0066_94840.jpg,500,391,100.Brown_Pelican,150,32,381,378,265,205,231,346
../../CUB_200_2011/images\100.Brown_Pelican/Brown_Pelican_0075_95357.jpg,500,375,100.Brown_Pelican,98,66,228,311,163,188,130,245
../../CUB_200_2011/images\100.Brown_Pelican/Brown_Pelican_0036_93843.jpg,500,500,100.Brown_Pelican,28,19,479,459,253,239,451,440
../../CUB_200_2011/images\100.Brown_Pelican/Brown_Pelican_0087_94358.jpg,500,333,100.Brown_Pelican,256,14,475,323,365,168,219,309
../../CUB_200_2011/images\100.Brown_Pelican/Brown_Pelican_0123_94368.jpg,500,332,100.Brown_Pelican,172,13,433,317,302,165,261,304
../../CUB_200_2011/images\100.Brown_Pelican/Brown_Pelican_0010_94370.jpg,500,337,100.Brown_Pelican,76,50,434,329,255,189,358,279
../../CUB_200_2011/images\100.Brown_Pelican/Brown_Pelican_0017_94383.jpg,500,361,100.Brown_Pelican,200,25,482,357,341,191,282,332
../../CUB_200_2011/images\100.Brown_Pelican/Brown_Pelican_0111_93872.jpg,375,500,100.Brown_Pelican,63,154,317,420,190,287,254,266
../../CUB_200_2011/images\100.Brown_Pelican/Brown_Pelican_0031_93874.jpg,379,500,100.Brown_Pelican,84,52,297,355,190,203,213,303
../../CUB_200_2011/images\100.Brown_Pelican/Brown_Pelican_0020_95422.jpg,500,337,100.Brown_Pelican,18,42,317,223,167,132,299,181
../../CUB_200_2011/images\100.Brown_Pelican/Brown_Pelican_0118_93475.jpg,500,333,100.Brown_Pelican,134,16,419,203,276,109,285,187
../../CUB_200_2011/images\100.Brown_Pelican/Brown_Pelican_0068_94430.jpg,500,313,100.Brown_Pelican,94,11,314,276,204,143,220,265
../../CUB_200_2011/images\100.Brown_Pelican/Brown_Pelican_0018_94432.jpg,500,375,100.Brown_Pelican,153,83,308,326,230,204,155,243
../../CUB_200_2011/images\100.Brown_Pelican/Brown_Pelican_0100_94434.jpg,333,500,100.Brown_Pelican,89,119,297,427,193,273,208,308
../../CUB_200_2011/images\100.Brown_Pelican/Brown_Pelican_0013_93589.jpg,500,332,100.Brown_Pelican,21,0,497,266,259,133,476,266
../../CUB_200_2011/images\100.Brown_Pelican/Brown_Pelican_0140_93438.jpg,357,500,100.Brown_Pelican,47,39,338,434,192,236,291,395
../../CUB_200_2011/images\100.Brown_Pelican/Brown_Pelican_0080_93439.jpg,388,500,100.Brown_Pelican,124,58,328,424,226,241,204,366
../../CUB_200_2011/images\100.Brown_Pelican/Brown_Pelican_0131_94464.jpg,336,500,100.Brown_Pelican,39,38,311,478,175,258,272,440
../../CUB_200_2011/images\100.Brown_Pelican/Brown_Pelican_0125_93461.jpg,336,500,100.Brown_Pelican,64,36,288,309,176,172,224,273
../../CUB_200_2011/images\100.Brown_Pelican/Brown_Pelican_0077_93464.jpg,500,334,100.Brown_Pelican,148,52,380,319,264,185,232,267
../../CUB_200_2011/images\100.Brown_Pelican/Brown_Pelican_0003_94427.jpg,333,500,100.Brown_Pelican,69,78,279,395,174,236,210,317
../../CUB_200_2011/images\100.Brown_Pelican/Brown_Pelican_0059_94504.jpg,500,357,100.Brown_Pelican,104,32,431,325,267,178,327,293
../../CUB_200_2011/images\100.Brown_Pelican/Brown_Pelican_0043_94506.jpg,375,500,100.Brown_Pelican,76,45,240,416,158,230,164,371
../../CUB_200_2011/images\100.Brown_Pelican/Brown_Pelican_0139_93995.jpg,500,333,100.Brown_Pelican,30,11,406,317,218,164,376,306
../../CUB_200_2011/images\100.Brown_Pelican/Brown_Pelican_0067_94529.jpg,272,500,100.Brown_Pelican,31,153,223,452,127,302,192,299
../../CUB_200_2011/images\100.Brown_Pelican/Brown_Pelican_0141_94533.jpg,375,500,100.Brown_Pelican,75,54,304,432,189,243,229,378
../../CUB_200_2011/images\100.Brown_Pelican/Brown_Pelican_0122_94022.jpg,500,347,100.Brown_Pelican,108,82,452,294,280,188,344,212
../../CUB_200_2011/images\100.Brown_Pelican/Brown_Pelican_0085_95053.jpg,500,333,100.Brown_Pelican,154,63,352,332,253,197,198,269
../../CUB_200_2011/images\100.Brown_Pelican/Brown_Pelican_0071_94549.jpg,500,333,100.Brown_Pelican,38,83,274,301,156,192,236,218
../../CUB_200_2011/images\100.Brown_Pelican/Brown_Pelican_0040_94051.jpg,367,500,100.Brown_Pelican,125,118,243,378,184,248,118,260
../../CUB_200_2011/images\100.Brown_Pelican/Brown_Pelican_0128_94059.jpg,500,334,100.Brown_Pelican,34,49,485,272,259,160,451,223
../../CUB_200_2011/images\100.Brown_Pelican/Brown_Pelican_0051_94578.jpg,500,333,100.Brown_Pelican,203,20,317,289,260,154,114,269
../../CUB_200_2011/images\100.Brown_Pelican/Brown_Pelican_0121_94067.jpg,334,500,100.Brown_Pelican,0,23,255,499,127,261,255,476
../../CUB_200_2011/images\100.Brown_Pelican/Brown_Pelican_0129_94074.jpg,500,349,100.Brown_Pelican,9,43,334,293,171,168,325,250
../../CUB_200_2011/images\100.Brown_Pelican/Brown_Pelican_0088_94076.jpg,333,500,100.Brown_Pelican,0,80,283,418,141,249,283,338
../../CUB_200_2011/images\100.Brown_Pelican/Brown_Pelican_0007_94078.jpg,500,346,100.Brown_Pelican,141,24,462,339,301,181,321,315
../../CUB_200_2011/images\100.Brown_Pelican/Brown_Pelican_0012_94079.jpg,500,319,100.Brown_Pelican,117,32,444,271,280,151,327,239
../../CUB_200_2011/images\100.Brown_Pelican/Brown_Pelican_0081_94085.jpg,500,375,100.Brown_Pelican,72,45,484,343,278,194,412,298
../../CUB_200_2011/images\100.Brown_Pelican/Brown_Pelican_0049_94598.jpg,500,333,100.Brown_Pelican,112,41,332,320,222,180,220,279
../../CUB_200_2011/images\100.Brown_Pelican/Brown_Pelican_0019_95158.jpg,500,333,100.Brown_Pelican,69,84,410,321,239,202,341,237
../../CUB_200_2011/images\100.Brown_Pelican/Brown_Pelican_0011_94683.jpg,381,500,100.Brown_Pelican,80,33,372,480,226,256,292,447
../../CUB_200_2011/images\100.Brown_Pelican/Brown_Pelican_0070_93678.jpg,500,438,100.Brown_Pelican,46,34,450,373,248,203,404,339
../../CUB_200_2011/images\100.Brown_Pelican/Brown_Pelican_0039_95216.jpg,500,334,100.Brown_Pelican,60,71,447,292,253,181,387,221
../../CUB_200_2011/images\100.Brown_Pelican/Brown_Pelican_0025_95218.jpg,500,442,100.Brown_Pelican,62,20,390,394,226,207,328,374
../../CUB_200_2011/images\100.Brown_Pelican/Brown_Pelican_0124_93684.jpg,457,500,100.Brown_Pelican,78,31,403,494,240,262,325,463
../../CUB_200_2011/images\100.Brown_Pelican/Brown_Pelican_0072_94974.jpg,500,351,100.Brown_Pelican,184,32,382,247,283,139,198,215
../../CUB_200_2011/images\100.Brown_Pelican/Brown_Pelican_0074_93692.jpg,334,500,100.Brown_Pelican,14,85,230,389,122,237,216,304
../../CUB_200_2011/images\100.Brown_Pelican/Brown_Pelican_0056_95229.jpg,500,375,100.Brown_Pelican,241,58,349,223,295,140,108,165
../../CUB_200_2011/images\101.White_Pelican/White_Pelican_0077_97025.jpg,500,333,101.White_Pelican,55,90,452,264,253,177,397,174
../../CUB_200_2011/images\101.White_Pelican/White_Pelican_0073_96260.jpg,500,375,101.White_Pelican,26,72,456,266,241,169,430,194
../../CUB_200_2011/images\101.White_Pelican/White_Pelican_0066_95495.jpg,500,348,101.White_Pelican,76,86,424,226,250,156,348,140
../../CUB_200_2011/images\101.White_Pelican/White_Pelican_0048_95764.jpg,500,375,101.White_Pelican,113,76,418,248,265,162,305,172
../../CUB_200_2011/images\101.White_Pelican/White_Pelican_0013_96901.jpg,500,375,101.White_Pelican,33,29,458,370,245,199,425,341
../../CUB_200_2011/images\101.White_Pelican/White_Pelican_0031_97064.jpg,500,333,101.White_Pelican,71,75,353,239,212,157,282,164
../../CUB_200_2011/images\101.White_Pelican/White_Pelican_0051_97833.jpg,332,500,101.White_Pelican,27,90,274,442,150,266,247,352
../../CUB_200_2011/images\101.White_Pelican/White_Pelican_0056_97071.jpg,333,500,101.White_Pelican,1,111,333,499,167,305,332,388
../../CUB_200_2011/images\101.White_Pelican/White_Pelican_0086_95538.jpg,500,333,101.White_Pelican,62,8,420,265,241,136,358,257
../../CUB_200_2011/images\101.White_Pelican/White_Pelican_0035_96312.jpg,500,340,101.White_Pelican,38,61,361,268,199,164,323,207
../../CUB_200_2011/images\101.White_Pelican/White_Pelican_0009_97340.jpg,500,500,101.White_Pelican,133,153,369,310,251,231,236,157
../../CUB_200_2011/images\101.White_Pelican/White_Pelican_0071_96061.jpg,500,333,101.White_Pelican,7,30,488,231,247,130,481,201
../../CUB_200_2011/images\101.White_Pelican/White_Pelican_0025_97604.jpg,500,382,101.White_Pelican,99,124,383,267,241,195,284,143
../../CUB_200_2011/images\101.White_Pelican/White_Pelican_0042_97250.jpg,500,332,101.White_Pelican,34,21,311,266,172,143,277,245
../../CUB_200_2011/images\101.White_Pelican/White_Pelican_0037_95570.jpg,500,333,101.White_Pelican,96,49,473,319,284,184,377,270
../../CUB_200_2011/images\101.White_Pelican/White_Pelican_0039_97363.jpg,333,500,101.White_Pelican,53,35,235,360,144,197,182,325
../../CUB_200_2011/images\101.White_Pelican/White_Pelican_0067_95573.jpg,500,400,101.White_Pelican,206,48,479,254,342,151,273,206
../../CUB_200_2011/images\101.White_Pelican/White_Pelican_0026_95832.jpg,336,500,101.White_Pelican,28,45,308,442,168,243,280,397
../../CUB_200_2011/images\101.White_Pelican/White_Pelican_0079_97380.jpg,500,400,101.White_Pelican,151,98,313,240,232,169,162,142
../../CUB_200_2011/images\101.White_Pelican/White_Pelican_0036_96863.jpg,500,412,101.White_Pelican,124,86,475,374,299,230,351,288
../../CUB_200_2011/images\101.White_Pelican/White_Pelican_0083_95840.jpg,500,375,101.White_Pelican,9,86,486,239,247,162,477,153
../../CUB_200_2011/images\101.White_Pelican/White_Pelican_0052_96865.jpg,500,335,101.White_Pelican,97,53,416,252,256,152,319,199
../../CUB_200_2011/images\101.White_Pelican/White_Pelican_0010_96876.jpg,500,333,101.White_Pelican,2,11,493,305,247,158,491,294
../../CUB_200_2011/images\101.White_Pelican/White_Pelican_0068_95635.jpg,500,375,101.White_Pelican,116,81,288,307,202,194,172,226
../../CUB_200_2011/images\101.White_Pelican/White_Pelican_0046_96888.jpg,500,334,101.White_Pelican,87,57,499,282,293,169,412,225
../../CUB_200_2011/images\101.White_Pelican/White_Pelican_0044_96028.jpg,333,500,101.White_Pelican,28,67,300,489,164,278,272,422
../../CUB_200_2011/images\101.White_Pelican/White_Pelican_0084_95877.jpg,500,500,101.White_Pelican,152,80,435,313,293,196,283,233
../../CUB_200_2011/images\101.White_Pelican/White_Pelican_0012_97261.jpg,500,375,101.White_Pelican,138,130,344,265,241,197,206,135
../../CUB_200_2011/images\101.White_Pelican/White_Pelican_0016_96659.jpg,500,375,101.White_Pelican,210,108,458,340,334,224,248,232
../../CUB_200_2011/images\101.White_Pelican/White_Pelican_0081_96148.jpg,500,329,101.White_Pelican,150,103,355,217,252,160,205,114
../../CUB_200_2011/images\101.White_Pelican/White_Pelican_0032_96920.jpg,500,313,101.White_Pelican,9,56,461,221,235,138,452,165
../../CUB_200_2011/images\101.White_Pelican/White_Pelican_0022_95897.jpg,500,404,101.White_Pelican,94,117,315,262,204,189,221,145
../../CUB_200_2011/images\101.White_Pelican/White_Pelican_0040_96026.jpg,500,375,101.White_Pelican,92,97,394,225,243,161,302,128
../../CUB_200_2011/images\101.White_Pelican/White_Pelican_0014_96417.jpg,500,334,101.White_Pelican,110,90,386,227,248,158,276,137
../../CUB_200_2011/images\101.White_Pelican/White_Pelican_0059_96675.jpg,500,375,101.White_Pelican,134,53,327,281,230,167,193,228
../../CUB_200_2011/images\101.White_Pelican/White_Pelican_0075_96422.jpg,500,333,101.White_Pelican,66,72,329,237,197,154,263,165
../../CUB_200_2011/images\101.White_Pelican/White_Pelican_0076_96427.jpg,500,333,101.White_Pelican,77,43,393,180,235,111,316,137
../../CUB_200_2011/images\101.White_Pelican/White_Pelican_0005_95916.jpg,500,302,101.White_Pelican,174,96,400,217,287,156,226,121
../../CUB_200_2011/images\101.White_Pelican/White_Pelican_0003_96691.jpg,500,335,101.White_Pelican,151,44,452,269,301,156,301,225
../../CUB_200_2011/images\101.White_Pelican/White_Pelican_0015_96952.jpg,500,336,101.White_Pelican,99,55,416,191,257,123,317,136
../../CUB_200_2011/images\101.White_Pelican/White_Pelican_0034_97466.jpg,500,375,101.White_Pelican,115,22,408,351,261,186,293,329
../../CUB_200_2011/images\101.White_Pelican/White_Pelican_0028_95950.jpg,500,346,101.White_Pelican,1,1,492,251,246,126,491,250
../../CUB_200_2011/images\101.White_Pelican/White_Pelican_0072_96975.jpg,334,500,101.White_Pelican,1,5,328,501,164,253,327,496
../../CUB_200_2011/images\101.White_Pelican/White_Pelican_0050_97913.jpg,500,333,101.White_Pelican,56,45,499,324,277,184,443,279
../../CUB_200_2011/images\101.White_Pelican/White_Pelican_0087_97247.jpg,500,375,101.White_Pelican,83,38,367,368,225,203,284,330
../../CUB_200_2011/images\101.White_Pelican/White_Pelican_0047_97190.jpg,500,357,101.White_Pelican,95,118,360,283,227,200,265,165
../../CUB_200_2011/images\101.White_Pelican/White_Pelican_0080_95721.jpg,500,357,101.White_Pelican,123,134,377,278,250,206,254,144
../../CUB_200_2011/images\101.White_Pelican/White_Pelican_0053_96236.jpg,500,364,101.White_Pelican,133,82,493,303,313,192,360,221
../../CUB_200_2011/images\101.White_Pelican/White_Pelican_0054_97528.jpg,500,500,101.White_Pelican,48,147,386,326,217,236,338,179
../../CUB_200_2011/images\101.White_Pelican/White_Pelican_0024_96554.jpg,500,406,101.White_Pelican,70,56,433,249,251,152,363,193
../../CUB_200_2011/images\102.Western_Wood_Pewee/Western_Wood_Pewee_0052_98006.jpg,400,500,102.Western_Wood_Pewee,71,47,244,475,157,261,173,428
../../CUB_200_2011/images\102.Western_Wood_Pewee/Western_Wood_Pewee_0016_98082.jpg,500,375,102.Western_Wood_Pewee,163,97,341,307,252,202,178,210
../../CUB_200_2011/images\102.Western_Wood_Pewee/Western_Wood_Pewee_0070_98225.jpg,402,500,102.Western_Wood_Pewee,68,73,297,440,182,256,229,367
../../CUB_200_2011/images\102.Western_Wood_Pewee/Western_Wood_Pewee_0014_98094.jpg,500,333,102.Western_Wood_Pewee,218,78,322,244,270,161,104,166
../../CUB_200_2011/images\102.Western_Wood_Pewee/Western_Wood_Pewee_0021_98101.jpg,500,333,102.Western_Wood_Pewee,113,23,278,304,195,163,165,281
../../CUB_200_2011/images\102.Western_Wood_Pewee/Western_Wood_Pewee_0061_795060.jpg,333,500,102.Western_Wood_Pewee,79,73,320,472,199,272,241,399
../../CUB_200_2011/images\102.Western_Wood_Pewee/Western_Wood_Pewee_0024_98229.jpg,400,500,102.Western_Wood_Pewee,152,132,331,356,241,244,179,224
../../CUB_200_2011/images\102.Western_Wood_Pewee/Western_Wood_Pewee_0046_98113.jpg,500,375,102.Western_Wood_Pewee,167,51,464,290,315,170,297,239
../../CUB_200_2011/images\102.Western_Wood_Pewee/Western_Wood_Pewee_0009_98115.jpg,500,334,102.Western_Wood_Pewee,194,90,304,273,249,181,110,183
../../CUB_200_2011/images\102.Western_Wood_Pewee/Western_Wood_Pewee_0032_98121.jpg,500,500,102.Western_Wood_Pewee,173,67,310,455,241,261,137,388
../../CUB_200_2011/images\102.Western_Wood_Pewee/Western_Wood_Pewee_0062_98123.jpg,500,423,102.Western_Wood_Pewee,195,139,296,320,245,229,101,181
../../CUB_200_2011/images\102.Western_Wood_Pewee/Western_Wood_Pewee_0042_98126.jpg,414,500,102.Western_Wood_Pewee,101,88,346,438,223,263,245,350
../../CUB_200_2011/images\102.Western_Wood_Pewee/Western_Wood_Pewee_0037_98127.jpg,500,383,102.Western_Wood_Pewee,117,95,397,240,257,167,280,145
../../CUB_200_2011/images\102.Western_Wood_Pewee/Western_Wood_Pewee_0077_98133.jpg,500,370,102.Western_Wood_Pewee,143,126,314,289,228,207,171,163
../../CUB_200_2011/images\102.Western_Wood_Pewee/Western_Wood_Pewee_0018_98153.jpg,500,375,102.Western_Wood_Pewee,146,148,247,284,196,216,101,136
../../CUB_200_2011/images\102.Western_Wood_Pewee/Western_Wood_Pewee_0074_98282.jpg,500,429,102.Western_Wood_Pewee,84,63,435,374,259,218,351,311
../../CUB_200_2011/images\102.Western_Wood_Pewee/Western_Wood_Pewee_0007_97985.jpg,500,333,102.Western_Wood_Pewee,180,26,322,310,251,168,142,284
../../CUB_200_2011/images\102.Western_Wood_Pewee/Western_Wood_Pewee_0015_98184.jpg,500,398,102.Western_Wood_Pewee,101,108,371,326,236,217,270,218
../../CUB_200_2011/images\102.Western_Wood_Pewee/Western_Wood_Pewee_0053_98186.jpg,500,375,102.Western_Wood_Pewee,165,67,374,299,269,183,209,232
../../CUB_200_2011/images\102.Western_Wood_Pewee/Western_Wood_Pewee_0026_98191.jpg,296,500,102.Western_Wood_Pewee,77,77,251,427,164,252,174,350
../../CUB_200_2011/images\102.Western_Wood_Pewee/Western_Wood_Pewee_0012_98031.jpg,500,401,102.Western_Wood_Pewee,185,74,310,340,247,207,125,266
../../CUB_200_2011/images\102.Western_Wood_Pewee/Western_Wood_Pewee_0010_98204.jpg,500,335,102.Western_Wood_Pewee,110,112,240,269,175,190,130,157
../../CUB_200_2011/images\102.Western_Wood_Pewee/Western_Wood_Pewee_0011_98205.jpg,500,375,102.Western_Wood_Pewee,97,79,359,328,228,203,262,249
../../CUB_200_2011/images\102.Western_Wood_Pewee/Western_Wood_Pewee_0031_795038.jpg,500,500,102.Western_Wood_Pewee,164,142,336,401,250,271,172,259
../../CUB_200_2011/images\102.Western_Wood_Pewee/Western_Wood_Pewee_0057_795040.jpg,332,500,102.Western_Wood_Pewee,29,116,197,333,113,224,168,217
../../CUB_200_2011/images\102.Western_Wood_Pewee/Western_Wood_Pewee_0017_795041.jpg,364,500,102.Western_Wood_Pewee,63,137,248,471,155,304,185,334
../../CUB_200_2011/images\102.Western_Wood_Pewee/Western_Wood_Pewee_0029_795042.jpg,220,330,102.Western_Wood_Pewee,33,31,159,322,96,176,126,291
../../CUB_200_2011/images\102.Western_Wood_Pewee/Western_Wood_Pewee_0073_795044.jpg,325,425,102.Western_Wood_Pewee,91,76,206,360,148,218,115,284
../../CUB_200_2011/images\102.Western_Wood_Pewee/Western_Wood_Pewee_0060_795045.jpg,350,350,102.Western_Wood_Pewee,61,11,255,338,158,174,194,327
../../CUB_200_2011/images\102.Western_Wood_Pewee/Western_Wood_Pewee_0019_795046.jpg,319,500,102.Western_Wood_Pewee,32,37,311,496,171,266,279,459
../../CUB_200_2011/images\102.Western_Wood_Pewee/Western_Wood_Pewee_0079_795047.jpg,428,500,102.Western_Wood_Pewee,106,64,393,393,249,228,287,329
../../CUB_200_2011/images\102.Western_Wood_Pewee/Western_Wood_Pewee_0041_795048.jpg,500,500,102.Western_Wood_Pewee,119,50,328,481,223,265,209,431
../../CUB_200_2011/images\102.Western_Wood_Pewee/Western_Wood_Pewee_0003_795050.jpg,376,500,102.Western_Wood_Pewee,128,91,333,366,230,228,205,275
../../CUB_200_2011/images\102.Western_Wood_Pewee/Western_Wood_Pewee_0040_795051.jpg,300,259,102.Western_Wood_Pewee,91,22,204,221,147,121,113,199
../../CUB_200_2011/images\102.Western_Wood_Pewee/Western_Wood_Pewee_0043_795053.jpg,500,362,102.Western_Wood_Pewee,150,62,274,286,212,174,124,224
../../CUB_200_2011/images\102.Western_Wood_Pewee/Western_Wood_Pewee_0020_795054.jpg,350,350,102.Western_Wood_Pewee,71,42,283,323,177,182,212,281
../../CUB_200_2011/images\102.Western_Wood_Pewee/Western_Wood_Pewee_0028_795057.jpg,400,500,102.Western_Wood_Pewee,71,69,230,409,150,239,159,340
../../CUB_200_2011/images\102.Western_Wood_Pewee/Western_Wood_Pewee_0022_795058.jpg,333,500,102.Western_Wood_Pewee,47,95,235,356,141,225,188,261
../../CUB_200_2011/images\102.Western_Wood_Pewee/Western_Wood_Pewee_0072_98035.jpg,500,333,102.Western_Wood_Pewee,238,45,340,320,289,182,102,275
../../CUB_200_2011/images\102.Western_Wood_Pewee/Western_Wood_Pewee_0045_97972.jpg,354,500,102.Western_Wood_Pewee,77,145,332,479,204,312,255,334
../../CUB_200_2011/images\102.Western_Wood_Pewee/Western_Wood_Pewee_0051_98206.jpg,500,318,102.Western_Wood_Pewee,45,36,229,217,137,126,184,181
../../CUB_200_2011/images\102.Western_Wood_Pewee/Western_Wood_Pewee_0035_795062.jpg,240,284,102.Western_Wood_Pewee,48,36,196,240,122,138,148,204
../../CUB_200_2011/images\102.Western_Wood_Pewee/Western_Wood_Pewee_0039_795063.jpg,375,500,102.Western_Wood_Pewee,111,130,285,365,198,247,174,235
../../CUB_200_2011/images\102.Western_Wood_Pewee/Western_Wood_Pewee_0054_97982.jpg,500,358,102.Western_Wood_Pewee,51,47,348,345,199,196,297,298
../../CUB_200_2011/images\102.Western_Wood_Pewee/Western_Wood_Pewee_0050_98241.jpg,500,350,102.Western_Wood_Pewee,192,50,322,304,257,177,130,254
../../CUB_200_2011/images\102.Western_Wood_Pewee/Western_Wood_Pewee_0004_98257.jpg,441,500,102.Western_Wood_Pewee,183,87,353,271,268,179,170,184
../../CUB_200_2011/images\102.Western_Wood_Pewee/Western_Wood_Pewee_0076_98002.jpg,500,500,102.Western_Wood_Pewee,81,116,335,330,208,223,254,214
../../CUB_200_2011/images\102.Western_Wood_Pewee/Western_Wood_Pewee_0008_795043.jpg,500,344,102.Western_Wood_Pewee,230,19,396,309,313,164,166,290
../../CUB_200_2011/images\102.Western_Wood_Pewee/Western_Wood_Pewee_0059_98262.jpg,500,375,102.Western_Wood_Pewee,184,36,322,351,253,193,138,315
../../CUB_200_2011/images\102.Western_Wood_Pewee/Western_Wood_Pewee_0049_98263.jpg,444,500,102.Western_Wood_Pewee,94,104,239,375,166,239,145,271
../../CUB_200_2011/images\102.Western_Wood_Pewee/Western_Wood_Pewee_0013_98268.jpg,315,500,102.Western_Wood_Pewee,58,90,270,427,164,258,212,337
../../CUB_200_2011/images\102.Western_Wood_Pewee/Western_Wood_Pewee_0081_98270.jpg,416,500,102.Western_Wood_Pewee,83,123,354,449,218,286,271,326
../../CUB_200_2011/images\102.Western_Wood_Pewee/Western_Wood_Pewee_0030_98272.jpg,500,354,102.Western_Wood_Pewee,195,86,309,302,252,194,114,216
../../CUB_200_2011/images\102.Western_Wood_Pewee/Western_Wood_Pewee_0047_98274.jpg,500,494,102.Western_Wood_Pewee,97,168,350,492,223,330,253,324
../../CUB_200_2011/images\102.Western_Wood_Pewee/Western_Wood_Pewee_0065_98001.jpg,500,400,102.Western_Wood_Pewee,196,122,313,361,254,241,117,239
../../CUB_200_2011/images\102.Western_Wood_Pewee/Western_Wood_Pewee_0068_98024.jpg,362,452,102.Western_Wood_Pewee,96,73,319,403,207,238,223,330
../../CUB_200_2011/images\102.Western_Wood_Pewee/Western_Wood_Pewee_0056_98026.jpg,500,358,102.Western_Wood_Pewee,137,43,280,323,208,183,143,280
../../CUB_200_2011/images\102.Western_Wood_Pewee/Western_Wood_Pewee_0063_98295.jpg,407,500,102.Western_Wood_Pewee,169,69,313,309,241,189,144,240
../../CUB_200_2011/images\102.Western_Wood_Pewee/Western_Wood_Pewee_0069_98299.jpg,500,333,102.Western_Wood_Pewee,167,38,305,204,236,121,138,166
../../CUB_200_2011/images\102.Western_Wood_Pewee/Western_Wood_Pewee_0001_98045.jpg,333,500,102.Western_Wood_Pewee,132,147,267,331,199,239,135,184
../../CUB_200_2011/images\103.Sayornis/Sayornis_0137_98305.jpg,500,455,103.Sayornis,96,61,472,418,284,239,376,357
../../CUB_200_2011/images\103.Sayornis/Sayornis_0022_98308.jpg,500,333,103.Sayornis,137,70,252,268,194,169,115,198
../../CUB_200_2011/images\103.Sayornis/Sayornis_0066_98309.jpg,500,393,103.Sayornis,57,53,255,315,156,184,198,262
../../CUB_200_2011/images\103.Sayornis/Sayornis_0115_99335.jpg,500,333,103.Sayornis,80,202,206,304,143,253,126,102
../../CUB_200_2011/images\103.Sayornis/Sayornis_0086_98829.jpg,500,333,103.Sayornis,173,72,436,323,304,197,263,251
../../CUB_200_2011/images\103.Sayornis/Sayornis_0036_98323.jpg,415,500,103.Sayornis,113,153,277,422,195,287,164,269
../../CUB_200_2011/images\103.Sayornis/Sayornis_0106_98841.jpg,500,445,103.Sayornis,140,90,404,372,272,231,264,282
../../CUB_200_2011/images\103.Sayornis/Sayornis_0070_99354.jpg,306,459,103.Sayornis,69,126,189,323,129,224,120,197
../../CUB_200_2011/images\103.Sayornis/Sayornis_0134_98339.jpg,334,500,103.Sayornis,20,132,293,462,156,297,273,330
../../CUB_200_2011/images\103.Sayornis/Sayornis_0105_98853.jpg,500,400,103.Sayornis,207,99,420,369,313,234,213,270
../../CUB_200_2011/images\103.Sayornis/Sayornis_0030_98343.jpg,500,333,103.Sayornis,124,103,295,275,209,189,171,172
../../CUB_200_2011/images\103.Sayornis/Sayornis_0075_98350.jpg,500,375,103.Sayornis,190,80,373,255,281,167,183,175
../../CUB_200_2011/images\103.Sayornis/Sayornis_0119_98864.jpg,397,500,103.Sayornis,35,172,277,457,156,314,242,285
../../CUB_200_2011/images\103.Sayornis/Sayornis_0127_98865.jpg,500,333,103.Sayornis,267,34,449,277,358,155,182,243
../../CUB_200_2011/images\103.Sayornis/Sayornis_0042_98874.jpg,500,332,103.Sayornis,58,134,288,322,173,228,230,188
../../CUB_200_2011/images\103.Sayornis/Sayornis_0012_98881.jpg,500,334,103.Sayornis,117,61,287,226,202,143,170,165
../../CUB_200_2011/images\103.Sayornis/Sayornis_0061_98375.jpg,500,333,103.Sayornis,142,102,291,260,216,181,149,158
../../CUB_200_2011/images\103.Sayornis/Sayornis_0109_98906.jpg,500,368,103.Sayornis,95,54,469,236,282,145,374,182
../../CUB_200_2011/images\103.Sayornis/Sayornis_0069_98914.jpg,500,375,103.Sayornis,17,46,236,197,126,121,219,151
../../CUB_200_2011/images\103.Sayornis/Sayornis_0111_98406.jpg,375,500,103.Sayornis,50,90,316,356,183,223,266,266
../../CUB_200_2011/images\103.Sayornis/Sayornis_0129_98924.jpg,400,500,103.Sayornis,22,134,295,443,158,288,273,309
../../CUB_200_2011/images\103.Sayornis/Sayornis_0067_98930.jpg,500,476,103.Sayornis,101,159,314,329,207,244,213,170
../../CUB_200_2011/images\103.Sayornis/Sayornis_0098_98419.jpg,500,394,103.Sayornis,131,85,488,326,309,205,357,241
../../CUB_200_2011/images\103.Sayornis/Sayornis_0039_98420.jpg,500,433,103.Sayornis,77,120,338,307,207,213,261,187
../../CUB_200_2011/images\103.Sayornis/Sayornis_0116_98939.jpg,500,335,103.Sayornis,69,73,389,312,229,192,320,239
../../CUB_200_2011/images\103.Sayornis/Sayornis_0076_98941.jpg,500,500,103.Sayornis,50,152,406,431,228,291,356,279
../../CUB_200_2011/images\103.Sayornis/Sayornis_0079_98434.jpg,500,333,103.Sayornis,118,79,448,305,283,192,330,226
../../CUB_200_2011/images\103.Sayornis/Sayornis_0037_98949.jpg,500,375,103.Sayornis,225,98,429,309,327,203,204,211
../../CUB_200_2011/images\103.Sayornis/Sayornis_0038_98441.jpg,500,393,103.Sayornis,99,95,317,374,208,234,218,279
../../CUB_200_2011/images\103.Sayornis/Sayornis_0005_98958.jpg,500,335,103.Sayornis,68,53,364,250,216,151,296,197
../../CUB_200_2011/images\103.Sayornis/Sayornis_0032_98962.jpg,500,401,103.Sayornis,117,72,473,369,295,220,356,297
../../CUB_200_2011/images\103.Sayornis/Sayornis_0114_98976.jpg,500,421,103.Sayornis,192,58,461,412,326,235,269,354
../../CUB_200_2011/images\103.Sayornis/Sayornis_0085_99503.jpg,333,500,103.Sayornis,45,76,284,448,164,262,239,372
../../CUB_200_2011/images\103.Sayornis/Sayornis_0081_99508.jpg,500,444,103.Sayornis,130,91,387,390,258,240,257,299
../../CUB_200_2011/images\103.Sayornis/Sayornis_0029_99535.jpg,500,379,103.Sayornis,63,77,342,337,202,207,279,260
../../CUB_200_2011/images\103.Sayornis/Sayornis_0094_98512.jpg,390,500,103.Sayornis,7,96,321,405,164,250,314,309
../../CUB_200_2011/images\103.Sayornis/Sayornis_0080_98518.jpg,333,500,103.Sayornis,52,129,230,418,141,273,178,289
../../CUB_200_2011/images\103.Sayornis/Sayornis_0047_98524.jpg,500,500,103.Sayornis,269,129,465,373,367,251,196,244
../../CUB_200_2011/images\103.Sayornis/Sayornis_0125_98528.jpg,500,375,103.Sayornis,130,41,466,332,298,186,336,291
../../CUB_200_2011/images\103.Sayornis/Sayornis_0045_98549.jpg,500,375,103.Sayornis,183,132,364,300,273,216,181,168
../../CUB_200_2011/images\103.Sayornis/Sayornis_0108_98553.jpg,363,500,103.Sayornis,110,99,271,430,190,264,161,331
../../CUB_200_2011/images\103.Sayornis/Sayornis_0136_99099.jpg,369,500,103.Sayornis,60,141,343,416,201,278,283,275
../../CUB_200_2011/images\103.Sayornis/Sayornis_0099_98593.jpg,336,402,103.Sayornis,95,62,250,342,172,202,155,280
../../CUB_200_2011/images\103.Sayornis/Sayornis_0002_98596.jpg,500,334,103.Sayornis,127,118,271,218,199,168,144,100
../../CUB_200_2011/images\103.Sayornis/Sayornis_0007_99117.jpg,500,357,103.Sayornis,178,69,335,302,256,185,157,233
../../CUB_200_2011/images\103.Sayornis/Sayornis_0011_98610.jpg,500,494,103.Sayornis,101,146,363,492,232,319,262,346
../../CUB_200_2011/images\103.Sayornis/Sayornis_0010_98611.jpg,334,500,103.Sayornis,26,126,299,396,162,261,273,270
../../CUB_200_2011/images\103.Sayornis/Sayornis_0133_99129.jpg,400,500,103.Sayornis,28,153,266,443,147,298,238,290
../../CUB_200_2011/images\103.Sayornis/Sayornis_0003_98618.jpg,500,333,103.Sayornis,272,110,411,264,341,187,139,154
../../CUB_200_2011/images\103.Sayornis/Sayornis_0025_98620.jpg,500,369,103.Sayornis,105,52,276,173,190,112,171,121
../../CUB_200_2011/images\103.Sayornis/Sayornis_0113_98630.jpg,334,500,103.Sayornis,123,49,304,465,213,257,181,416
../../CUB_200_2011/images\103.Sayornis/Sayornis_0056_99553.jpg,500,495,103.Sayornis,97,55,438,406,267,230,341,351
../../CUB_200_2011/images\103.Sayornis/Sayornis_0019_98636.jpg,500,308,103.Sayornis,193,85,315,266,254,175,122,181
../../CUB_200_2011/images\103.Sayornis/Sayornis_0130_98678.jpg,500,400,103.Sayornis,170,57,332,350,251,203,162,293
../../CUB_200_2011/images\103.Sayornis/Sayornis_0021_98710.jpg,500,333,103.Sayornis,193,118,402,272,297,195,209,154
../../CUB_200_2011/images\103.Sayornis/Sayornis_0077_98724.jpg,500,332,103.Sayornis,83,31,494,309,288,170,411,278
../../CUB_200_2011/images\103.Sayornis/Sayornis_0020_98727.jpg,500,500,103.Sayornis,254,105,445,357,349,231,191,252
../../CUB_200_2011/images\103.Sayornis/Sayornis_0014_98889.jpg,333,500,103.Sayornis,56,152,312,367,184,259,256,215
../../CUB_200_2011/images\103.Sayornis/Sayornis_0100_98782.jpg,500,426,103.Sayornis,47,59,375,413,211,236,328,354
../../CUB_200_2011/images\103.Sayornis/Sayornis_0058_98798.jpg,500,442,103.Sayornis,172,166,325,381,248,273,153,215
../../CUB_200_2011/images\104.American_Pipit/American_Pipit_0039_99841.jpg,500,333,104.American_Pipit,264,42,389,168,326,105,125,126
../../CUB_200_2011/images\104.American_Pipit/American_Pipit_0010_99843.jpg,500,362,104.American_Pipit,258,149,396,296,327,222,138,147
../../CUB_200_2011/images\104.American_Pipit/American_Pipit_0074_100154.jpg,500,350,104.American_Pipit,75,94,375,262,225,178,300,168
../../CUB_200_2011/images\104.American_Pipit/American_Pipit_0124_99848.jpg,375,500,104.American_Pipit,43,170,303,370,173,270,260,200
../../CUB_200_2011/images\104.American_Pipit/American_Pipit_0006_99857.jpg,500,333,104.American_Pipit,200,65,455,281,327,173,255,216
../../CUB_200_2011/images\104.American_Pipit/American_Pipit_0031_99607.jpg,500,421,104.American_Pipit,170,121,357,259,263,190,187,138
../../CUB_200_2011/images\104.American_Pipit/American_Pipit_0021_100378.jpg,500,294,104.American_Pipit,148,83,303,255,225,169,155,172
../../CUB_200_2011/images\104.American_Pipit/American_Pipit_0082_99867.jpg,500,333,104.American_Pipit,24,109,253,246,138,177,229,137
../../CUB_200_2011/images\104.American_Pipit/American_Pipit_0114_100380.jpg,500,352,104.American_Pipit,64,66,308,294,186,180,244,228
../../CUB_200_2011/images\104.American_Pipit/American_Pipit_0008_100390.jpg,500,346,104.American_Pipit,267,160,447,286,357,223,180,126
../../CUB_200_2011/images\104.American_Pipit/American_Pipit_0048_100140.jpg,500,448,104.American_Pipit,157,119,267,260,212,189,110,141
../../CUB_200_2011/images\104.American_Pipit/American_Pipit_0011_99630.jpg,500,361,104.American_Pipit,225,112,405,244,315,178,180,132
../../CUB_200_2011/images\104.American_Pipit/American_Pipit_0072_99631.jpg,500,300,104.American_Pipit,182,91,338,207,260,149,156,116
../../CUB_200_2011/images\104.American_Pipit/American_Pipit_0104_100147.jpg,500,335,104.American_Pipit,316,26,443,204,379,115,127,178
../../CUB_200_2011/images\104.American_Pipit/American_Pipit_0078_99898.jpg,500,399,104.American_Pipit,56,75,412,349,234,212,356,274
../../CUB_200_2011/images\104.American_Pipit/American_Pipit_0017_99902.jpg,500,357,104.American_Pipit,153,58,444,291,298,174,291,233
../../CUB_200_2011/images\104.American_Pipit/American_Pipit_0007_99808.jpg,500,299,104.American_Pipit,34,104,278,293,156,198,244,189
../../CUB_200_2011/images\104.American_Pipit/American_Pipit_0036_99658.jpg,412,500,104.American_Pipit,144,150,271,320,207,235,127,170
../../CUB_200_2011/images\104.American_Pipit/American_Pipit_0019_99810.jpg,500,363,104.American_Pipit,22,106,295,337,158,221,273,231
../../CUB_200_2011/images\104.American_Pipit/American_Pipit_0029_99667.jpg,389,239,104.American_Pipit,32,29,376,213,204,121,344,184
../../CUB_200_2011/images\104.American_Pipit/American_Pipit_0035_100181.jpg,500,400,104.American_Pipit,139,155,294,268,216,211,155,113
../../CUB_200_2011/images\104.American_Pipit/American_Pipit_0059_99628.jpg,500,352,104.American_Pipit,97,89,304,322,200,205,207,233
../../CUB_200_2011/images\104.American_Pipit/American_Pipit_0123_99929.jpg,500,384,104.American_Pipit,24,45,438,358,231,201,414,313
../../CUB_200_2011/images\104.American_Pipit/American_Pipit_0015_99932.jpg,500,366,104.American_Pipit,62,31,338,327,200,179,276,296
../../CUB_200_2011/images\104.American_Pipit/American_Pipit_0027_100189.jpg,500,346,104.American_Pipit,85,63,426,263,255,163,341,200
../../CUB_200_2011/images\104.American_Pipit/American_Pipit_0024_99813.jpg,500,307,104.American_Pipit,60,79,297,223,178,151,237,144
../../CUB_200_2011/images\104.American_Pipit/American_Pipit_0113_99939.jpg,500,442,104.American_Pipit,41,94,427,379,234,236,386,285
../../CUB_200_2011/images\104.American_Pipit/American_Pipit_0111_99940.jpg,500,349,104.American_Pipit,157,123,449,295,303,209,292,172
../../CUB_200_2011/images\104.American_Pipit/American_Pipit_0045_99687.jpg,500,322,104.American_Pipit,97,42,281,250,189,146,184,208
../../CUB_200_2011/images\104.American_Pipit/American_Pipit_0034_99946.jpg,500,333,104.American_Pipit,168,75,436,221,302,148,268,146
../../CUB_200_2011/images\104.American_Pipit/American_Pipit_0022_100227.jpg,500,333,104.American_Pipit,51,86,295,277,173,181,244,191
../../CUB_200_2011/images\104.American_Pipit/American_Pipit_0037_99954.jpg,332,500,104.American_Pipit,88,110,306,414,197,262,218,304
../../CUB_200_2011/images\104.American_Pipit/American_Pipit_0088_100213.jpg,500,333,104.American_Pipit,68,117,232,251,150,184,164,134
../../CUB_200_2011/images\104.American_Pipit/American_Pipit_0095_99959.jpg,500,333,104.American_Pipit,101,37,487,325,294,181,386,288
../../CUB_200_2011/images\104.American_Pipit/American_Pipit_0066_99961.jpg,500,391,104.American_Pipit,53,96,411,296,232,196,358,200
../../CUB_200_2011/images\104.American_Pipit/American_Pipit_0058_100218.jpg,500,446,104.American_Pipit,67,89,414,312,240,200,347,223
../../CUB_200_2011/images\104.American_Pipit/American_Pipit_0109_99710.jpg,500,333,104.American_Pipit,246,88,438,326,342,207,192,238
../../CUB_200_2011/images\104.American_Pipit/American_Pipit_0001_100225.jpg,500,332,104.American_Pipit,191,20,487,288,339,154,296,268
../../CUB_200_2011/images\104.American_Pipit/American_Pipit_0099_99971.jpg,500,375,104.American_Pipit,148,113,399,310,273,211,251,197
../../CUB_200_2011/images\104.American_Pipit/American_Pipit_0102_99979.jpg,500,333,104.American_Pipit,112,80,320,244,216,162,208,164
../../CUB_200_2011/images\104.American_Pipit/American_Pipit_0067_100237.jpg,500,333,104.American_Pipit,37,146,253,247,145,196,216,101
../../CUB_200_2011/images\104.American_Pipit/American_Pipit_0046_100240.jpg,500,293,104.American_Pipit,154,101,376,209,265,155,222,108
../../CUB_200_2011/images\104.American_Pipit/American_Pipit_0098_99986.jpg,500,369,104.American_Pipit,197,136,357,263,277,199,160,127
../../CUB_200_2011/images\104.American_Pipit/American_Pipit_0090_99651.jpg,500,333,104.American_Pipit,21,47,463,304,242,175,442,257
../../CUB_200_2011/images\104.American_Pipit/American_Pipit_0085_100246.jpg,500,400,104.American_Pipit,167,122,296,258,231,190,129,136
../../CUB_200_2011/images\104.American_Pipit/American_Pipit_0087_99996.jpg,500,423,104.American_Pipit,38,102,429,379,233,240,391,277
../../CUB_200_2011/images\104.American_Pipit/American_Pipit_0062_100000.jpg,500,375,104.American_Pipit,186,54,433,328,309,191,247,274
../../CUB_200_2011/images\104.American_Pipit/American_Pipit_0089_100260.jpg,500,497,104.American_Pipit,222,79,357,385,289,232,135,306
../../CUB_200_2011/images\104.American_Pipit/American_Pipit_0116_100015.jpg,500,500,104.American_Pipit,113,96,256,237,184,166,143,141
../../CUB_200_2011/images\104.American_Pipit/American_Pipit_0091_100276.jpg,500,333,104.American_Pipit,213,95,399,292,306,193,186,197
../../CUB_200_2011/images\104.American_Pipit/American_Pipit_0002_100023.jpg,500,333,104.American_Pipit,187,55,468,253,327,154,281,198
../../CUB_200_2011/images\104.American_Pipit/American_Pipit_0043_100027.jpg,500,375,104.American_Pipit,121,68,361,293,241,180,240,225
../../CUB_200_2011/images\104.American_Pipit/American_Pipit_0121_100040.jpg,500,352,104.American_Pipit,79,102,315,313,197,207,236,211
../../CUB_200_2011/images\104.American_Pipit/American_Pipit_0081_99785.jpg,500,410,104.American_Pipit,178,58,443,385,310,221,265,327
../../CUB_200_2011/images\104.American_Pipit/American_Pipit_0101_100053.jpg,500,354,104.American_Pipit,142,64,394,314,268,189,252,250
../../CUB_200_2011/images\104.American_Pipit/American_Pipit_0080_100055.jpg,500,375,104.American_Pipit,181,51,499,254,340,152,318,203
../../CUB_200_2011/images\104.American_Pipit/American_Pipit_0041_100060.jpg,500,375,104.American_Pipit,178,104,360,227,269,165,182,123
../../CUB_200_2011/images\104.American_Pipit/American_Pipit_0070_100061.jpg,420,280,104.American_Pipit,130,61,388,234,259,147,258,173
../../CUB_200_2011/images\104.American_Pipit/American_Pipit_0119_99622.jpg,500,400,104.American_Pipit,195,133,445,296,320,214,250,163
../../CUB_200_2011/images\104.American_Pipit/American_Pipit_0073_99642.jpg,500,338,104.American_Pipit,175,71,437,268,306,169,262,197
../../CUB_200_2011/images\105.Whip_poor_Will/Whip_Poor_Will_0011_796416.jpg,500,335,105.Whip_poor_Will,18,55,463,212,240,133,445,157
../../CUB_200_2011/images\105.Whip_poor_Will/Whip_Poor_Will_0048_796417.jpg,500,333,105.Whip_poor_Will,1,40,461,334,231,187,460,294
../../CUB_200_2011/images\105.Whip_poor_Will/Whip_Poor_Will_0040_100482.jpg,500,500,105.Whip_poor_Will,67,143,409,414,238,278,342,271
../../CUB_200_2011/images\105.Whip_poor_Will/Whip_Poor_Will_0042_796419.jpg,500,375,105.Whip_poor_Will,12,98,495,283,253,190,483,185
../../CUB_200_2011/images\105.Whip_poor_Will/Whip_Poor_Will_0008_796420.jpg,500,323,105.Whip_poor_Will,36,87,391,287,213,187,355,200
../../CUB_200_2011/images\105.Whip_poor_Will/Whip_Poor_Will_0028_796421.jpg,365,273,105.Whip_poor_Will,70,70,243,220,156,145,173,150
../../CUB_200_2011/images\105.Whip_poor_Will/Whip_Poor_Will_0045_796422.jpg,500,334,105.Whip_poor_Will,29,81,387,251,208,166,358,170
../../CUB_200_2011/images\105.Whip_poor_Will/Whip_Poor_Will_0009_796423.jpg,500,333,105.Whip_poor_Will,179,90,422,244,300,167,243,154
../../CUB_200_2011/images\105.Whip_poor_Will/Whip_Poor_Will_0016_796424.jpg,369,290,105.Whip_poor_Will,103,65,321,266,212,165,218,201
../../CUB_200_2011/images\105.Whip_poor_Will/Whip_Poor_Will_0005_796425.jpg,500,400,105.Whip_poor_Will,49,84,349,310,199,197,300,226
../../CUB_200_2011/images\105.Whip_poor_Will/Whip_Poor_Will_0021_796426.jpg,265,255,105.Whip_poor_Will,23,31,263,198,143,114,240,167
../../CUB_200_2011/images\105.Whip_poor_Will/Whip_Poor_Will_0002_796427.jpg,500,320,105.Whip_poor_Will,9,16,354,228,181,122,345,212
../../CUB_200_2011/images\105.Whip_poor_Will/Whip_Poor_Will_0041_796428.jpg,500,447,105.Whip_poor_Will,140,99,448,437,294,268,308,338
../../CUB_200_2011/images\105.Whip_poor_Will/Whip_Poor_Will_0017_796429.jpg,500,333,105.Whip_poor_Will,113,93,470,282,291,187,357,189
../../CUB_200_2011/images\105.Whip_poor_Will/Whip_Poor_Will_0035_796430.jpg,500,435,105.Whip_poor_Will,4,13,474,421,239,217,470,408
../../CUB_200_2011/images\105.Whip_poor_Will/Whip_Poor_Will_0007_796431.jpg,350,268,105.Whip_poor_Will,24,47,296,209,160,128,272,162
../../CUB_200_2011/images\105.Whip_poor_Will/Whip_Poor_Will_0006_22800.jpg,500,375,105.Whip_poor_Will,21,83,406,292,213,187,385,209
../../CUB_200_2011/images\105.Whip_poor_Will/Whip_Poor_Will_0019_796433.jpg,500,333,105.Whip_poor_Will,109,104,316,226,212,165,207,122
../../CUB_200_2011/images\105.Whip_poor_Will/Whip_Poor_Will_0025_796434.jpg,497,300,105.Whip_poor_Will,135,120,424,254,279,187,289,134
../../CUB_200_2011/images\105.Whip_poor_Will/Whip_Poor_Will_0015_796435.jpg,500,379,105.Whip_poor_Will,124,85,299,271,211,178,175,186
../../CUB_200_2011/images\105.Whip_poor_Will/Whip_Poor_Will_0032_796437.jpg,500,397,105.Whip_poor_Will,25,94,322,368,173,231,297,274
../../CUB_200_2011/images\105.Whip_poor_Will/Whip_Poor_Will_0022_796438.jpg,500,334,105.Whip_poor_Will,81,81,469,284,275,182,388,203
../../CUB_200_2011/images\105.Whip_poor_Will/Whip_Poor_Will_0013_796439.jpg,380,304,105.Whip_poor_Will,9,33,374,272,191,152,365,239
../../CUB_200_2011/images\105.Whip_poor_Will/Whip_Poor_Will_0046_796440.jpg,500,334,105.Whip_poor_Will,39,92,366,260,202,176,327,168
../../CUB_200_2011/images\105.Whip_poor_Will/Whip_Poor_Will_0027_796441.jpg,500,375,105.Whip_poor_Will,51,71,475,276,263,173,424,205
../../CUB_200_2011/images\105.Whip_poor_Will/Whip_Poor_Will_0043_796442.jpg,350,283,105.Whip_poor_Will,2,45,314,224,158,134,312,179
../../CUB_200_2011/images\105.Whip_poor_Will/Whip_Poor_Will_0049_83621.jpg,500,375,105.Whip_poor_Will,4,76,402,331,203,203,398,255
../../CUB_200_2011/images\105.Whip_poor_Will/Whip_Poor_Will_0004_100479.jpg,500,334,105.Whip_poor_Will,46,81,397,333,221,207,351,252
../../CUB_200_2011/images\105.Whip_poor_Will/Whip_Poor_Will_0020_100396.jpg,500,404,105.Whip_poor_Will,29,48,349,373,189,210,320,325
../../CUB_200_2011/images\105.Whip_poor_Will/Whip_Poor_Will_0031_100397.jpg,500,344,105.Whip_poor_Will,68,41,464,306,266,173,396,265
../../CUB_200_2011/images\105.Whip_poor_Will/Whip_Poor_Will_0036_100399.jpg,500,334,105.Whip_poor_Will,35,24,452,315,243,169,417,291
../../CUB_200_2011/images\105.Whip_poor_Will/Whip_Poor_Will_0030_100412.jpg,500,366,105.Whip_poor_Will,59,36,498,364,278,200,439,328
../../CUB_200_2011/images\105.Whip_poor_Will/Whip_Poor_Will_0038_100443.jpg,500,400,105.Whip_poor_Will,117,105,440,325,278,215,323,220
../../CUB_200_2011/images\105.Whip_poor_Will/Whip_Poor_Will_0024_100444.jpg,500,333,105.Whip_poor_Will,117,36,463,321,290,178,346,285
../../CUB_200_2011/images\105.Whip_poor_Will/Whip_Poor_Will_0029_796432.jpg,392,290,105.Whip_poor_Will,100,82,339,256,219,169,239,174
../../CUB_200_2011/images\105.Whip_poor_Will/Whip_Poor_Will_0026_100456.jpg,500,361,105.Whip_poor_Will,92,24,448,343,270,183,356,319
../../CUB_200_2011/images\105.Whip_poor_Will/Whip_Poor_Will_0010_100464.jpg,500,375,105.Whip_poor_Will,175,94,409,219,292,156,234,125
../../CUB_200_2011/images\105.Whip_poor_Will/Whip_Poor_Will_0018_796403.jpg,500,326,105.Whip_poor_Will,25,100,327,289,176,194,302,189
../../CUB_200_2011/images\105.Whip_poor_Will/Whip_Poor_Will_0037_796405.jpg,500,333,105.Whip_poor_Will,68,64,479,218,273,141,411,154
../../CUB_200_2011/images\105.Whip_poor_Will/Whip_Poor_Will_0033_82166.jpg,400,500,105.Whip_poor_Will,22,113,305,451,163,282,283,338
../../CUB_200_2011/images\105.Whip_poor_Will/Whip_Poor_Will_0044_796407.jpg,250,166,105.Whip_poor_Will,6,20,145,152,75,86,139,132
../../CUB_200_2011/images\105.Whip_poor_Will/Whip_Poor_Will_0039_796408.jpg,360,288,105.Whip_poor_Will,19,65,278,245,148,155,259,180
../../CUB_200_2011/images\105.Whip_poor_Will/Whip_Poor_Will_0003_796409.jpg,250,167,105.Whip_poor_Will,43,20,165,134,104,77,122,114
../../CUB_200_2011/images\105.Whip_poor_Will/Whip_Poor_Will_0023_796410.jpg,500,333,105.Whip_poor_Will,139,2,468,254,303,128,329,252
../../CUB_200_2011/images\105.Whip_poor_Will/Whip_Poor_Will_0001_796411.jpg,230,164,105.Whip_poor_Will,15,35,176,153,95,94,161,118
../../CUB_200_2011/images\105.Whip_poor_Will/Whip_Poor_Will_0047_796412.jpg,400,398,105.Whip_poor_Will,52,139,360,369,206,254,308,230
../../CUB_200_2011/images\105.Whip_poor_Will/Whip_Poor_Will_0034_796413.jpg,500,334,105.Whip_poor_Will,100,80,498,308,299,194,398,228
../../CUB_200_2011/images\105.Whip_poor_Will/Whip_Poor_Will_0012_796414.jpg,350,266,105.Whip_poor_Will,29,48,290,240,159,144,261,192
../../CUB_200_2011/images\105.Whip_poor_Will/Whip_Poor_Will_0050_796415.jpg,450,302,105.Whip_poor_Will,61,23,342,273,201,148,281,250
../../CUB_200_2011/images\106.Horned_Puffin/Horned_Puffin_0016_100993.jpg,500,375,106.Horned_Puffin,167,131,499,275,333,203,332,144
../../CUB_200_2011/images\106.Horned_Puffin/Horned_Puffin_0068_100872.jpg,500,334,106.Horned_Puffin,40,44,441,303,240,173,401,259
../../CUB_200_2011/images\106.Horned_Puffin/Horned_Puffin_0024_100620.jpg,357,500,106.Horned_Puffin,24,66,253,260,138,163,229,194
../../CUB_200_2011/images\106.Horned_Puffin/Horned_Puffin_0011_100621.jpg,500,425,106.Horned_Puffin,100,33,418,377,259,205,318,344
../../CUB_200_2011/images\106.Horned_Puffin/Horned_Puffin_0065_100625.jpg,500,333,106.Horned_Puffin,144,84,306,288,225,186,162,204
../../CUB_200_2011/images\106.Horned_Puffin/Horned_Puffin_0055_100882.jpg,500,375,106.Horned_Puffin,54,34,399,312,226,173,345,278
../../CUB_200_2011/images\106.Horned_Puffin/Horned_Puffin_0074_100886.jpg,500,333,106.Horned_Puffin,131,105,428,275,279,190,297,170
../../CUB_200_2011/images\106.Horned_Puffin/Horned_Puffin_0029_100888.jpg,500,375,106.Horned_Puffin,113,137,379,261,246,199,266,124
../../CUB_200_2011/images\106.Horned_Puffin/Horned_Puffin_0015_100889.jpg,500,333,106.Horned_Puffin,165,91,376,244,270,167,211,153
../../CUB_200_2011/images\106.Horned_Puffin/Horned_Puffin_0039_100890.jpg,500,333,106.Horned_Puffin,224,123,410,242,317,182,186,119
../../CUB_200_2011/images\106.Horned_Puffin/Horned_Puffin_0040_100891.jpg,375,500,106.Horned_Puffin,95,201,330,352,212,276,235,151
../../CUB_200_2011/images\106.Horned_Puffin/Horned_Puffin_0084_100637.jpg,500,332,106.Horned_Puffin,19,41,436,323,227,182,417,282
../../CUB_200_2011/images\106.Horned_Puffin/Horned_Puffin_0034_100895.jpg,500,334,106.Horned_Puffin,16,69,382,336,199,202,366,267
../../CUB_200_2011/images\106.Horned_Puffin/Horned_Puffin_0050_100645.jpg,500,359,106.Horned_Puffin,54,117,381,253,217,185,327,136
../../CUB_200_2011/images\106.Horned_Puffin/Horned_Puffin_0083_100649.jpg,500,333,106.Horned_Puffin,165,100,361,242,263,171,196,142
../../CUB_200_2011/images\106.Horned_Puffin/Horned_Puffin_0027_100906.jpg,500,400,106.Horned_Puffin,92,17,486,382,289,199,394,365
../../CUB_200_2011/images\106.Horned_Puffin/Horned_Puffin_0071_100651.jpg,500,375,106.Horned_Puffin,135,84,464,279,299,181,329,195
../../CUB_200_2011/images\106.Horned_Puffin/Horned_Puffin_0054_100915.jpg,500,333,106.Horned_Puffin,53,137,289,244,171,190,236,107
../../CUB_200_2011/images\106.Horned_Puffin/Horned_Puffin_0048_100916.jpg,500,295,106.Horned_Puffin,108,63,391,200,249,131,283,137
../../CUB_200_2011/images\106.Horned_Puffin/Horned_Puffin_0075_100664.jpg,500,447,106.Horned_Puffin,56,86,249,311,152,198,193,225
../../CUB_200_2011/images\106.Horned_Puffin/Horned_Puffin_0059_100925.jpg,500,333,106.Horned_Puffin,144,59,370,228,257,143,226,169
../../CUB_200_2011/images\106.Horned_Puffin/Horned_Puffin_0077_100671.jpg,500,400,106.Horned_Puffin,244,79,383,208,313,143,139,129
../../CUB_200_2011/images\106.Horned_Puffin/Horned_Puffin_0082_100876.jpg,500,333,106.Horned_Puffin,109,117,373,249,241,183,264,132
../../CUB_200_2011/images\106.Horned_Puffin/Horned_Puffin_0072_100938.jpg,500,375,106.Horned_Puffin,126,122,392,315,259,218,266,193
../../CUB_200_2011/images\106.Horned_Puffin/Horned_Puffin_0025_100942.jpg,500,333,106.Horned_Puffin,66,94,355,240,210,167,289,146
../../CUB_200_2011/images\106.Horned_Puffin/Horned_Puffin_0066_100877.jpg,500,333,106.Horned_Puffin,141,54,349,223,245,138,208,169
../../CUB_200_2011/images\106.Horned_Puffin/Horned_Puffin_0035_100690.jpg,331,500,106.Horned_Puffin,47,33,293,497,170,265,246,464
../../CUB_200_2011/images\106.Horned_Puffin/Horned_Puffin_0062_100693.jpg,500,333,106.Horned_Puffin,157,76,358,332,257,204,201,256
../../CUB_200_2011/images\106.Horned_Puffin/Horned_Puffin_0007_100699.jpg,500,333,106.Horned_Puffin,184,103,414,295,299,199,230,192
../../CUB_200_2011/images\106.Horned_Puffin/Horned_Puffin_0069_101018.jpg,500,375,106.Horned_Puffin,143,98,429,254,286,176,286,156
../../CUB_200_2011/images\106.Horned_Puffin/Horned_Puffin_0047_100967.jpg,500,333,106.Horned_Puffin,166,123,328,223,247,173,162,100
../../CUB_200_2011/images\106.Horned_Puffin/Horned_Puffin_0001_100973.jpg,500,375,106.Horned_Puffin,35,66,399,346,217,206,364,280
../../CUB_200_2011/images\106.Horned_Puffin/Horned_Puffin_0036_100974.jpg,500,346,106.Horned_Puffin,57,85,421,215,239,150,364,130
../../CUB_200_2011/images\106.Horned_Puffin/Horned_Puffin_0052_100977.jpg,500,393,106.Horned_Puffin,83,16,413,331,248,173,330,315
../../CUB_200_2011/images\106.Horned_Puffin/Horned_Puffin_0030_100725.jpg,500,335,106.Horned_Puffin,152,27,370,293,261,160,218,266
../../CUB_200_2011/images\106.Horned_Puffin/Horned_Puffin_0060_100726.jpg,500,346,106.Horned_Puffin,197,79,383,275,290,177,186,196
../../CUB_200_2011/images\106.Horned_Puffin/Horned_Puffin_0033_100731.jpg,500,400,106.Horned_Puffin,217,132,361,295,289,213,144,163
../../CUB_200_2011/images\106.Horned_Puffin/Horned_Puffin_0004_100733.jpg,500,450,106.Horned_Puffin,30,57,496,438,263,247,466,381
../../CUB_200_2011/images\106.Horned_Puffin/Horned_Puffin_0067_100737.jpg,457,500,106.Horned_Puffin,164,140,291,331,227,235,127,191
../../CUB_200_2011/images\106.Horned_Puffin/Horned_Puffin_0042_100760.jpg,500,400,106.Horned_Puffin,122,45,498,397,310,221,376,352
../../CUB_200_2011/images\106.Horned_Puffin/Horned_Puffin_0012_100763.jpg,500,400,106.Horned_Puffin,73,38,481,217,277,127,408,179
../../CUB_200_2011/images\106.Horned_Puffin/Horned_Puffin_0028_100765.jpg,500,334,106.Horned_Puffin,50,108,350,319,200,213,300,211
../../CUB_200_2011/images\106.Horned_Puffin/Horned_Puffin_0022_100766.jpg,344,500,106.Horned_Puffin,44,107,311,289,177,198,267,182
../../CUB_200_2011/images\106.Horned_Puffin/Horned_Puffin_0038_100635.jpg,333,500,106.Horned_Puffin,99,91,237,386,168,238,138,295
../../CUB_200_2011/images\106.Horned_Puffin/Horned_Puffin_0056_101030.jpg,500,357,106.Horned_Puffin,48,66,250,317,149,191,202,251
../../CUB_200_2011/images\106.Horned_Puffin/Horned_Puffin_0078_100777.jpg,500,468,106.Horned_Puffin,5,72,447,467,226,269,442,395
../../CUB_200_2011/images\106.Horned_Puffin/Horned_Puffin_0021_100780.jpg,500,333,106.Horned_Puffin,177,88,310,281,243,184,133,193
../../CUB_200_2011/images\106.Horned_Puffin/Horned_Puffin_0046_100785.jpg,500,375,106.Horned_Puffin,89,36,499,374,294,205,410,338
../../CUB_200_2011/images\106.Horned_Puffin/Horned_Puffin_0003_101045.jpg,375,500,106.Horned_Puffin,140,150,285,410,212,280,145,260
../../CUB_200_2011/images\106.Horned_Puffin/Horned_Puffin_0051_101048.jpg,500,334,106.Horned_Puffin,190,54,365,257,277,155,175,203
../../CUB_200_2011/images\106.Horned_Puffin/Horned_Puffin_0081_101054.jpg,500,334,106.Horned_Puffin,132,31,499,334,315,182,367,303
../../CUB_200_2011/images\106.Horned_Puffin/Horned_Puffin_0045_100803.jpg,500,500,106.Horned_Puffin,12,15,499,499,255,257,487,484
../../CUB_200_2011/images\106.Horned_Puffin/Horned_Puffin_0031_100804.jpg,500,333,106.Horned_Puffin,64,92,308,330,186,211,244,238
../../CUB_200_2011/images\106.Horned_Puffin/Horned_Puffin_0019_101063.jpg,400,500,106.Horned_Puffin,119,175,250,390,184,282,131,215
../../CUB_200_2011/images\106.Horned_Puffin/Horned_Puffin_0010_100771.jpg,330,500,106.Horned_Puffin,27,75,242,365,134,220,215,290
../../CUB_200_2011/images\106.Horned_Puffin/Horned_Puffin_0073_100830.jpg,500,416,106.Horned_Puffin,191,103,304,219,247,161,113,116
../../CUB_200_2011/images\106.Horned_Puffin/Horned_Puffin_0026_100937.jpg,500,375,106.Horned_Puffin,173,114,306,256,239,185,133,142
../../CUB_200_2011/images\106.Horned_Puffin/Horned_Puffin_0061_100845.jpg,500,375,106.Horned_Puffin,146,90,283,235,214,162,137,145
../../CUB_200_2011/images\106.Horned_Puffin/Horned_Puffin_0079_100847.jpg,500,332,106.Horned_Puffin,217,113,351,257,284,185,134,144
../../CUB_200_2011/images\106.Horned_Puffin/Horned_Puffin_0006_100989.jpg,500,375,106.Horned_Puffin,183,56,500,261,341,158,317,205
../../CUB_200_2011/images\107.Common_Raven/Common_Raven_0089_101891.jpg,400,400,107.Common_Raven,5,37,393,344,199,190,388,307
../../CUB_200_2011/images\107.Common_Raven/Common_Raven_0059_101893.jpg,420,280,107.Common_Raven,20,15,398,249,209,132,378,234
../../CUB_200_2011/images\107.Common_Raven/Common_Raven_0070_101896.jpg,500,416,107.Common_Raven,208,90,366,359,287,224,158,269
../../CUB_200_2011/images\107.Common_Raven/Common_Raven_0043_101901.jpg,500,333,107.Common_Raven,71,87,270,232,170,159,199,145
../../CUB_200_2011/images\107.Common_Raven/Common_Raven_0010_101390.jpg,500,332,107.Common_Raven,72,40,393,302,232,171,321,262
../../CUB_200_2011/images\107.Common_Raven/Common_Raven_0024_101394.jpg,500,358,107.Common_Raven,191,24,433,334,312,179,242,310
../../CUB_200_2011/images\107.Common_Raven/Common_Raven_0052_101909.jpg,500,331,107.Common_Raven,11,29,338,330,174,179,327,301
../../CUB_200_2011/images\107.Common_Raven/Common_Raven_0107_101412.jpg,500,414,107.Common_Raven,46,55,451,381,248,218,405,326
../../CUB_200_2011/images\107.Common_Raven/Common_Raven_0023_102437.jpg,400,500,107.Common_Raven,163,47,290,330,226,188,127,283
../../CUB_200_2011/images\107.Common_Raven/Common_Raven_0072_102443.jpg,375,500,107.Common_Raven,67,71,374,330,220,200,307,259
../../CUB_200_2011/images\107.Common_Raven/Common_Raven_0028_102452.jpg,500,430,107.Common_Raven,100,52,470,404,285,228,370,352
../../CUB_200_2011/images\107.Common_Raven/Common_Raven_0065_102465.jpg,500,375,107.Common_Raven,20,11,441,366,230,188,421,355
../../CUB_200_2011/images\107.Common_Raven/Common_Raven_0062_101448.jpg,500,443,107.Common_Raven,66,34,493,442,279,238,427,408
../../CUB_200_2011/images\107.Common_Raven/Common_Raven_0126_101459.jpg,500,471,107.Common_Raven,1,19,474,452,237,235,473,433
../../CUB_200_2011/images\107.Common_Raven/Common_Raven_0066_101461.jpg,500,396,107.Common_Raven,56,76,396,350,226,213,340,274
../../CUB_200_2011/images\107.Common_Raven/Common_Raven_0035_101466.jpg,500,332,107.Common_Raven,158,92,332,305,245,198,174,213
../../CUB_200_2011/images\107.Common_Raven/Common_Raven_0061_102519.jpg,500,375,107.Common_Raven,132,71,431,353,281,212,299,282
../../CUB_200_2011/images\107.Common_Raven/Common_Raven_0060_102013.jpg,500,396,107.Common_Raven,51,108,300,300,175,204,249,192
../../CUB_200_2011/images\107.Common_Raven/Common_Raven_0075_102530.jpg,500,375,107.Common_Raven,53,103,352,339,202,221,299,236
../../CUB_200_2011/images\107.Common_Raven/Common_Raven_0007_102020.jpg,500,333,107.Common_Raven,125,37,459,326,292,181,334,289
../../CUB_200_2011/images\107.Common_Raven/Common_Raven_0069_101825.jpg,500,334,107.Common_Raven,139,104,435,285,287,194,296,181
../../CUB_200_2011/images\107.Common_Raven/Common_Raven_0036_102025.jpg,500,333,107.Common_Raven,1,48,410,331,205,189,409,283
../../CUB_200_2011/images\107.Common_Raven/Common_Raven_0091_101524.jpg,500,356,107.Common_Raven,52,47,418,351,235,199,366,304
../../CUB_200_2011/images\107.Common_Raven/Common_Raven_0092_102550.jpg,500,375,107.Common_Raven,97,41,498,374,297,207,401,333
../../CUB_200_2011/images\107.Common_Raven/Common_Raven_0029_102039.jpg,500,325,107.Common_Raven,174,57,340,233,257,145,166,176
../../CUB_200_2011/images\107.Common_Raven/Common_Raven_0085_102041.jpg,500,334,107.Common_Raven,26,39,300,302,163,170,274,263
../../CUB_200_2011/images\107.Common_Raven/Common_Raven_0017_102044.jpg,500,375,107.Common_Raven,39,57,397,304,218,180,358,247
../../CUB_200_2011/images\107.Common_Raven/Common_Raven_0132_101543.jpg,456,500,107.Common_Raven,17,91,382,406,199,248,365,315
../../CUB_200_2011/images\107.Common_Raven/Common_Raven_0093_102058.jpg,500,357,107.Common_Raven,101,114,459,290,280,202,358,176
../../CUB_200_2011/images\107.Common_Raven/Common_Raven_0002_102582.jpg,343,500,107.Common_Raven,28,56,303,475,165,265,275,419
../../CUB_200_2011/images\107.Common_Raven/Common_Raven_0025_102584.jpg,374,500,107.Common_Raven,93,126,325,485,209,305,232,359
../../CUB_200_2011/images\107.Common_Raven/Common_Raven_0074_101576.jpg,500,313,107.Common_Raven,28,54,346,277,187,165,318,223
../../CUB_200_2011/images\107.Common_Raven/Common_Raven_0129_102094.jpg,500,400,107.Common_Raven,77,31,399,380,238,205,322,349
../../CUB_200_2011/images\107.Common_Raven/Common_Raven_0119_101595.jpg,500,400,107.Common_Raven,166,133,439,301,302,217,273,168
../../CUB_200_2011/images\107.Common_Raven/Common_Raven_0009_102112.jpg,500,333,107.Common_Raven,30,107,338,292,184,199,308,185
../../CUB_200_2011/images\107.Common_Raven/Common_Raven_0037_101096.jpg,500,333,107.Common_Raven,169,58,301,220,235,139,132,162
../../CUB_200_2011/images\107.Common_Raven/Common_Raven_0079_101100.jpg,500,418,107.Common_Raven,174,132,464,346,319,239,290,214
../../CUB_200_2011/images\107.Common_Raven/Common_Raven_0128_102017.jpg,500,332,107.Common_Raven,78,55,497,332,287,193,419,277
../../CUB_200_2011/images\107.Common_Raven/Common_Raven_0078_101148.jpg,500,333,107.Common_Raven,145,56,388,307,266,181,243,251
../../CUB_200_2011/images\107.Common_Raven/Common_Raven_0099_102534.jpg,500,375,107.Common_Raven,108,63,323,320,215,191,215,257
../../CUB_200_2011/images\107.Common_Raven/Common_Raven_0122_101708.jpg,500,333,107.Common_Raven,22,99,411,307,216,203,389,208
../../CUB_200_2011/images\107.Common_Raven/Common_Raven_0018_101713.jpg,500,372,107.Common_Raven,71,49,316,348,193,198,245,299
../../CUB_200_2011/images\107.Common_Raven/Common_Raven_0110_101775.jpg,500,333,107.Common_Raven,52,38,498,329,275,183,446,291
../../CUB_200_2011/images\107.Common_Raven/Common_Raven_0001_101213.jpg,500,476,107.Common_Raven,45,51,402,398,223,224,357,347
../../CUB_200_2011/images\107.Common_Raven/Common_Raven_0068_101216.jpg,500,312,107.Common_Raven,97,65,389,277,243,171,292,212
../../CUB_200_2011/images\107.Common_Raven/Common_Raven_0086_101221.jpg,500,375,107.Common_Raven,171,35,484,374,327,204,313,339
../../CUB_200_2011/images\107.Common_Raven/Common_Raven_0121_101744.jpg,500,363,107.Common_Raven,173,11,463,306,318,158,290,295
../../CUB_200_2011/images\107.Common_Raven/Common_Raven_0054_101750.jpg,500,332,107.Common_Raven,118,98,383,226,250,162,265,128
../../CUB_200_2011/images\107.Common_Raven/Common_Raven_0033_101759.jpg,500,333,107.Common_Raven,158,107,465,301,311,204,307,194
../../CUB_200_2011/images\107.Common_Raven/Common_Raven_0021_101767.jpg,500,321,107.Common_Raven,67,143,404,318,235,230,337,175
../../CUB_200_2011/images\107.Common_Raven/Common_Raven_0082_102306.jpg,500,375,107.Common_Raven,161,49,313,373,237,211,152,324
../../CUB_200_2011/images\107.Common_Raven/Common_Raven_0053_101291.jpg,500,333,107.Common_Raven,109,55,292,313,200,184,183,258
../../CUB_200_2011/images\107.Common_Raven/Common_Raven_0095_101831.jpg,500,333,107.Common_Raven,125,144,282,294,203,219,157,150
../../CUB_200_2011/images\107.Common_Raven/Common_Raven_0117_101833.jpg,375,500,107.Common_Raven,112,149,358,499,235,324,246,350
../../CUB_200_2011/images\107.Common_Raven/Common_Raven_0057_101324.jpg,500,500,107.Common_Raven,4,34,472,496,238,265,468,462
../../CUB_200_2011/images\107.Common_Raven/Common_Raven_0005_101347.jpg,500,333,107.Common_Raven,42,81,329,296,185,188,287,215
../../CUB_200_2011/images\107.Common_Raven/Common_Raven_0077_101349.jpg,500,333,107.Common_Raven,275,92,432,262,353,177,157,170
../../CUB_200_2011/images\107.Common_Raven/Common_Raven_0116_101350.jpg,500,500,107.Common_Raven,87,78,343,409,215,243,256,331
../../CUB_200_2011/images\107.Common_Raven/Common_Raven_0015_101364.jpg,500,357,107.Common_Raven,66,39,437,326,251,182,371,287
../../CUB_200_2011/images\108.White_necked_Raven/White_Necked_Raven_0047_102660.jpg,500,375,108.White_necked_Raven,190,108,304,271,247,189,114,163
../../CUB_200_2011/images\108.White_necked_Raven/White_Necked_Raven_0059_102668.jpg,500,333,108.White_necked_Raven,163,61,285,237,224,149,122,176
../../CUB_200_2011/images\108.White_necked_Raven/White_Necked_Raven_0007_102676.jpg,375,500,108.White_necked_Raven,2,9,291,499,146,254,289,490
../../CUB_200_2011/images\108.White_necked_Raven/White_Necked_Raven_0031_102686.jpg,500,332,108.White_necked_Raven,76,166,288,331,182,248,212,165
../../CUB_200_2011/images\108.White_necked_Raven/White_Necked_Raven_0014_102687.jpg,500,375,108.White_necked_Raven,212,93,367,247,289,170,155,154
../../CUB_200_2011/images\108.White_necked_Raven/White_Necked_Raven_0034_102598.jpg,500,375,108.White_necked_Raven,22,52,456,321,239,186,434,269
../../CUB_200_2011/images\108.White_necked_Raven/White_Necked_Raven_0039_102699.jpg,435,500,108.White_necked_Raven,42,36,395,499,218,267,353,463
../../CUB_200_2011/images\108.White_necked_Raven/White_Necked_Raven_0012_102700.jpg,500,332,108.White_necked_Raven,137,125,280,249,208,187,143,124
../../CUB_200_2011/images\108.White_necked_Raven/White_Necked_Raven_0030_102701.jpg,500,375,108.White_necked_Raven,120,116,431,285,275,200,311,169
../../CUB_200_2011/images\108.White_necked_Raven/White_Necked_Raven_0049_102713.jpg,500,435,108.White_necked_Raven,114,148,337,273,225,210,223,125
../../CUB_200_2011/images\108.White_necked_Raven/White_Necked_Raven_0004_102714.jpg,500,333,108.White_necked_Raven,3,31,390,335,196,183,387,304
../../CUB_200_2011/images\108.White_necked_Raven/White_Necked_Raven_0058_102729.jpg,500,332,108.White_necked_Raven,61,44,359,308,210,176,298,264
../../CUB_200_2011/images\108.White_necked_Raven/White_Necked_Raven_0020_102730.jpg,500,329,108.White_necked_Raven,53,7,421,273,237,140,368,266
../../CUB_200_2011/images\108.White_necked_Raven/White_Necked_Raven_0037_102734.jpg,333,500,108.White_necked_Raven,102,301,222,407,162,354,120,106
../../CUB_200_2011/images\108.White_necked_Raven/White_Necked_Raven_0018_102746.jpg,500,375,108.White_necked_Raven,63,114,353,374,208,244,290,260
../../CUB_200_2011/images\108.White_necked_Raven/White_Necked_Raven_0009_102518.jpg,500,334,108.White_necked_Raven,312,81,476,290,394,185,164,209
../../CUB_200_2011/images\108.White_necked_Raven/White_Necked_Raven_0015_102593.jpg,500,335,108.White_necked_Raven,31,130,416,309,223,219,385,179
../../CUB_200_2011/images\108.White_necked_Raven/White_Necked_Raven_0021_797341.jpg,320,237,108.White_necked_Raven,29,35,310,225,169,130,281,190
../../CUB_200_2011/images\108.White_necked_Raven/White_Necked_Raven_0046_797343.jpg,140,165,108.White_necked_Raven,5,15,133,158,69,86,128,143
../../CUB_200_2011/images\108.White_necked_Raven/White_Necked_Raven_0048_797345.jpg,500,459,108.White_necked_Raven,84,38,499,444,291,241,415,406
../../CUB_200_2011/images\108.White_necked_Raven/White_Necked_Raven_0025_797346.jpg,344,324,108.White_necked_Raven,20,11,343,323,181,167,323,312
../../CUB_200_2011/images\108.White_necked_Raven/White_Necked_Raven_0006_797347.jpg,500,375,108.White_necked_Raven,49,79,383,339,216,209,334,260
../../CUB_200_2011/images\108.White_necked_Raven/White_Necked_Raven_0044_797348.jpg,244,500,108.White_necked_Raven,15,18,228,485,121,251,213,467
../../CUB_200_2011/images\108.White_necked_Raven/White_Necked_Raven_0029_797349.jpg,297,223,108.White_necked_Raven,8,58,138,169,73,113,130,111
../../CUB_200_2011/images\108.White_necked_Raven/White_Necked_Raven_0010_797350.jpg,500,375,108.White_necked_Raven,25,77,393,326,209,201,368,249
../../CUB_200_2011/images\108.White_necked_Raven/White_Necked_Raven_0055_797352.jpg,462,500,108.White_necked_Raven,42,100,328,428,185,264,286,328
../../CUB_200_2011/images\108.White_necked_Raven/White_Necked_Raven_0065_797354.jpg,500,322,108.White_necked_Raven,37,86,318,286,177,186,281,200
../../CUB_200_2011/images\108.White_necked_Raven/White_Necked_Raven_0027_797355.jpg,500,375,108.White_necked_Raven,123,109,376,337,249,223,253,228
../../CUB_200_2011/images\108.White_necked_Raven/White_Necked_Raven_0042_797356.jpg,324,500,108.White_necked_Raven,33,87,237,421,135,254,204,334
../../CUB_200_2011/images\108.White_necked_Raven/White_Necked_Raven_0026_797357.jpg,320,213,108.White_necked_Raven,119,61,248,178,183,119,129,117
../../CUB_200_2011/images\108.White_necked_Raven/White_Necked_Raven_0057_797358.jpg,366,236,108.White_necked_Raven,62,64,207,193,134,128,145,129
../../CUB_200_2011/images\108.White_necked_Raven/White_Necked_Raven_0036_797359.jpg,500,333,108.White_necked_Raven,145,25,493,320,319,172,348,295
../../CUB_200_2011/images\108.White_necked_Raven/White_Necked_Raven_0053_797360.jpg,500,319,108.White_necked_Raven,174,80,396,283,285,181,222,203
../../CUB_200_2011/images\108.White_necked_Raven/White_Necked_Raven_0063_797361.jpg,500,341,108.White_necked_Raven,71,95,325,299,198,197,254,204
../../CUB_200_2011/images\108.White_necked_Raven/White_Necked_Raven_0043_797363.jpg,333,500,108.White_necked_Raven,59,131,319,313,189,222,260,182
../../CUB_200_2011/images\108.White_necked_Raven/White_Necked_Raven_0024_797364.jpg,500,438,108.White_necked_Raven,31,15,470,424,250,219,439,409
../../CUB_200_2011/images\108.White_necked_Raven/White_Necked_Raven_0060_797365.jpg,401,350,108.White_necked_Raven,19,36,319,312,169,174,300,276
../../CUB_200_2011/images\108.White_necked_Raven/White_Necked_Raven_0011_797367.jpg,350,322,108.White_necked_Raven,47,41,322,289,184,165,275,248
../../CUB_200_2011/images\108.White_necked_Raven/White_Necked_Raven_0038_797369.jpg,500,333,108.White_necked_Raven,94,53,419,325,256,189,325,272
../../CUB_200_2011/images\108.White_necked_Raven/White_Necked_Raven_0002_797370.jpg,327,327,108.White_necked_Raven,15,12,309,312,162,162,294,300
../../CUB_200_2011/images\108.White_necked_Raven/White_Necked_Raven_0023_797371.jpg,500,277,108.White_necked_Raven,40,37,388,254,214,145,348,217
../../CUB_200_2011/images\108.White_necked_Raven/White_Necked_Raven_0056_797373.jpg,500,334,108.White_necked_Raven,100,51,241,325,170,188,141,274
../../CUB_200_2011/images\108.White_necked_Raven/White_Necked_Raven_0050_797374.jpg,500,327,108.White_necked_Raven,49,34,388,313,218,173,339,279
../../CUB_200_2011/images\108.White_necked_Raven/White_Necked_Raven_0003_797376.jpg,500,336,108.White_necked_Raven,51,16,410,328,230,172,359,312
../../CUB_200_2011/images\108.White_necked_Raven/White_Necked_Raven_0019_797377.jpg,200,200,108.White_necked_Raven,25,16,192,168,108,92,167,152
../../CUB_200_2011/images\108.White_necked_Raven/White_Necked_Raven_0064_797378.jpg,500,375,108.White_necked_Raven,90,129,206,261,148,195,116,132
../../CUB_200_2011/images\108.White_necked_Raven/White_Necked_Raven_0045_797381.jpg,429,330,108.White_necked_Raven,40,31,347,319,193,175,307,288
../../CUB_200_2011/images\108.White_necked_Raven/White_Necked_Raven_0062_797382.jpg,500,458,108.White_necked_Raven,218,59,431,338,324,198,213,279
../../CUB_200_2011/images\108.White_necked_Raven/White_Necked_Raven_0051_797383.jpg,500,383,108.White_necked_Raven,119,107,403,272,261,189,284,165
../../CUB_200_2011/images\108.White_necked_Raven/White_Necked_Raven_0001_797384.jpg,300,240,108.White_necked_Raven,36,34,191,239,113,136,155,205
../../CUB_200_2011/images\108.White_necked_Raven/White_Necked_Raven_0016_797385.jpg,500,500,108.White_necked_Raven,115,24,377,497,246,260,262,473
../../CUB_200_2011/images\108.White_necked_Raven/White_Necked_Raven_0040_797386.jpg,388,280,108.White_necked_Raven,28,66,327,219,177,142,299,153
../../CUB_200_2011/images\108.White_necked_Raven/White_Necked_Raven_0008_797389.jpg,437,500,108.White_necked_Raven,158,132,408,398,283,265,250,266
../../CUB_200_2011/images\108.White_necked_Raven/White_Necked_Raven_0072_797391.jpg,500,359,108.White_necked_Raven,156,110,278,211,217,160,122,101
../../CUB_200_2011/images\108.White_necked_Raven/White_Necked_Raven_0028_797392.jpg,327,327,108.White_necked_Raven,16,29,168,201,92,115,152,172
../../CUB_200_2011/images\108.White_necked_Raven/White_Necked_Raven_0068_102610.jpg,332,500,108.White_necked_Raven,127,220,229,380,178,300,102,160
../../CUB_200_2011/images\108.White_necked_Raven/White_Necked_Raven_0067_102630.jpg,500,375,108.White_necked_Raven,180,39,340,293,260,166,160,254
../../CUB_200_2011/images\108.White_necked_Raven/White_Necked_Raven_0041_797394.jpg,270,400,108.White_necked_Raven,3,9,252,371,127,190,249,362
../../CUB_200_2011/images\108.White_necked_Raven/White_Necked_Raven_0070_102645.jpg,484,500,108.White_necked_Raven,106,64,445,496,275,280,339,432
../../CUB_200_2011/images\108.White_necked_Raven/White_Necked_Raven_0005_102653.jpg,500,375,108.White_necked_Raven,141,75,428,302,284,188,287,227
../../CUB_200_2011/images\109.American_Redstart/American_Redstart_0094_103425.jpg,482,320,109.American_Redstart,91,81,482,293,286,187,391,212
../../CUB_200_2011/images\109.American_Redstart/American_Redstart_0044_103433.jpg,500,382,109.American_Redstart,71,91,368,318,219,204,297,227
../../CUB_200_2011/images\109.American_Redstart/American_Redstart_0090_102940.jpg,500,500,109.American_Redstart,180,84,316,458,248,271,136,374
../../CUB_200_2011/images\109.American_Redstart/American_Redstart_0111_102945.jpg,500,333,109.American_Redstart,177,99,373,298,275,198,196,199
../../CUB_200_2011/images\109.American_Redstart/American_Redstart_0103_102946.jpg,333,500,109.American_Redstart,52,156,196,448,124,302,144,292
../../CUB_200_2011/images\109.American_Redstart/American_Redstart_0009_103974.jpg,500,295,109.American_Redstart,121,111,425,286,273,198,304,175
../../CUB_200_2011/images\109.American_Redstart/American_Redstart_0082_102973.jpg,500,361,109.American_Redstart,200,102,301,318,250,210,101,216
../../CUB_200_2011/images\109.American_Redstart/American_Redstart_0128_102983.jpg,500,375,109.American_Redstart,74,105,260,214,167,159,186,109
../../CUB_200_2011/images\109.American_Redstart/American_Redstart_0048_104021.jpg,500,319,109.American_Redstart,107,104,422,218,264,161,315,114
../../CUB_200_2011/images\109.American_Redstart/American_Redstart_0078_103268.jpg,500,305,109.American_Redstart,161,66,317,239,239,152,156,173
../../CUB_200_2011/images\109.American_Redstart/American_Redstart_0020_104027.jpg,399,500,109.American_Redstart,196,188,364,331,280,259,168,143
../../CUB_200_2011/images\109.American_Redstart/American_Redstart_0035_103017.jpg,500,350,109.American_Redstart,24,49,457,307,240,178,433,258
../../CUB_200_2011/images\109.American_Redstart/American_Redstart_0077_104042.jpg,500,335,109.American_Redstart,28,92,324,299,176,195,296,207
../../CUB_200_2011/images\109.American_Redstart/American_Redstart_0054_103543.jpg,500,375,109.American_Redstart,206,178,417,343,311,260,211,165
../../CUB_200_2011/images\109.American_Redstart/American_Redstart_0118_103033.jpg,500,391,109.American_Redstart,124,159,459,368,291,263,335,209
../../CUB_200_2011/images\109.American_Redstart/American_Redstart_0024_103042.jpg,500,500,109.American_Redstart,264,57,432,195,348,126,168,138
../../CUB_200_2011/images\109.American_Redstart/American_Redstart_0093_103071.jpg,500,333,109.American_Redstart,68,56,384,319,226,187,316,263
../../CUB_200_2011/images\109.American_Redstart/American_Redstart_0064_103081.jpg,500,466,109.American_Redstart,71,2,483,419,277,210,412,417
../../CUB_200_2011/images\109.American_Redstart/American_Redstart_0058_103082.jpg,500,479,109.American_Redstart,107,91,431,431,269,261,324,340
../../CUB_200_2011/images\109.American_Redstart/American_Redstart_0120_103089.jpg,500,329,109.American_Redstart,28,173,304,312,166,242,276,139
../../CUB_200_2011/images\109.American_Redstart/American_Redstart_0126_103091.jpg,500,333,109.American_Redstart,133,77,250,226,191,151,117,149
../../CUB_200_2011/images\109.American_Redstart/American_Redstart_0122_103102.jpg,500,333,109.American_Redstart,38,60,379,286,208,173,341,226
../../CUB_200_2011/images\109.American_Redstart/American_Redstart_0116_103631.jpg,500,333,109.American_Redstart,110,100,396,257,253,178,286,157
../../CUB_200_2011/images\109.American_Redstart/American_Redstart_0119_104057.jpg,500,333,109.American_Redstart,74,95,302,231,188,163,228,136
../../CUB_200_2011/images\109.American_Redstart/American_Redstart_0085_103155.jpg,500,338,109.American_Redstart,101,67,362,268,231,167,261,201
../../CUB_200_2011/images\109.American_Redstart/American_Redstart_0013_103677.jpg,500,333,109.American_Redstart,102,76,458,270,280,173,356,194
../../CUB_200_2011/images\109.American_Redstart/American_Redstart_0027_103168.jpg,330,500,109.American_Redstart,119,107,228,346,173,226,109,239
../../CUB_200_2011/images\109.American_Redstart/American_Redstart_0108_103686.jpg,500,421,109.American_Redstart,10,100,314,341,162,220,304,241
../../CUB_200_2011/images\109.American_Redstart/American_Redstart_0049_103176.jpg,500,375,109.American_Redstart,122,69,484,296,303,182,362,227
../../CUB_200_2011/images\109.American_Redstart/American_Redstart_0089_103187.jpg,500,307,109.American_Redstart,185,88,437,221,311,154,252,133
../../CUB_200_2011/images\109.American_Redstart/American_Redstart_0022_103701.jpg,500,403,109.American_Redstart,73,112,318,315,195,213,245,203
../../CUB_200_2011/images\109.American_Redstart/American_Redstart_0041_103717.jpg,500,350,109.American_Redstart,202,113,360,241,281,177,158,128
../../CUB_200_2011/images\109.American_Redstart/American_Redstart_0002_103723.jpg,333,500,109.American_Redstart,80,119,311,405,195,262,231,286
../../CUB_200_2011/images\109.American_Redstart/American_Redstart_0026_103729.jpg,500,335,109.American_Redstart,166,84,464,257,315,170,298,173
../../CUB_200_2011/images\109.American_Redstart/American_Redstart_0036_103231.jpg,500,333,109.American_Redstart,62,60,389,194,225,127,327,134
../../CUB_200_2011/images\109.American_Redstart/American_Redstart_0080_103749.jpg,500,397,109.American_Redstart,75,65,365,360,220,212,290,295
../../CUB_200_2011/images\109.American_Redstart/American_Redstart_0097_103238.jpg,500,312,109.American_Redstart,25,100,286,251,155,175,261,151
../../CUB_200_2011/images\109.American_Redstart/American_Redstart_0056_103241.jpg,500,400,109.American_Redstart,216,158,378,327,297,242,162,169
../../CUB_200_2011/images\109.American_Redstart/American_Redstart_0067_103259.jpg,500,333,109.American_Redstart,98,95,490,262,294,178,392,167
../../CUB_200_2011/images\109.American_Redstart/American_Redstart_0071_103266.jpg,500,425,109.American_Redstart,34,77,395,335,214,206,361,258
../../CUB_200_2011/images\109.American_Redstart/American_Redstart_0033_103783.jpg,500,333,109.American_Redstart,174,107,422,253,298,180,248,146
../../CUB_200_2011/images\109.American_Redstart/American_Redstart_0038_103278.jpg,500,326,109.American_Redstart,99,100,327,244,213,172,228,144
../../CUB_200_2011/images\109.American_Redstart/American_Redstart_0109_103795.jpg,500,352,109.American_Redstart,87,128,210,267,148,197,123,139
../../CUB_200_2011/images\109.American_Redstart/American_Redstart_0066_102774.jpg,500,300,109.American_Redstart,150,28,351,253,250,140,201,225
../../CUB_200_2011/images\109.American_Redstart/American_Redstart_0059_103402.jpg,500,341,109.American_Redstart,178,94,450,254,314,174,272,160
../../CUB_200_2011/images\109.American_Redstart/American_Redstart_0037_102818.jpg,500,332,109.American_Redstart,144,79,259,289,201,184,115,210
../../CUB_200_2011/images\109.American_Redstart/American_Redstart_0055_103750.jpg,500,333,109.American_Redstart,140,102,302,222,221,162,162,120
../../CUB_200_2011/images\109.American_Redstart/American_Redstart_0045_102823.jpg,500,357,109.American_Redstart,95,87,335,244,215,165,240,157
../../CUB_200_2011/images\109.American_Redstart/American_Redstart_0137_102848.jpg,500,451,109.American_Redstart,30,159,401,370,215,264,371,211
../../CUB_200_2011/images\109.American_Redstart/American_Redstart_0096_102853.jpg,500,362,109.American_Redstart,178,74,372,249,275,161,194,175
../../CUB_200_2011/images\109.American_Redstart/American_Redstart_0087_103371.jpg,500,443,109.American_Redstart,123,139,457,347,290,243,334,208
../../CUB_200_2011/images\109.American_Redstart/American_Redstart_0047_102860.jpg,500,333,109.American_Redstart,156,64,276,278,216,171,120,214
../../CUB_200_2011/images\109.American_Redstart/American_Redstart_0034_102866.jpg,370,500,109.American_Redstart,74,189,254,416,164,302,180,227
../../CUB_200_2011/images\109.American_Redstart/American_Redstart_0088_103892.jpg,500,333,109.American_Redstart,120,99,442,281,281,190,322,182
../../CUB_200_2011/images\109.American_Redstart/American_Redstart_0138_102869.jpg,500,356,109.American_Redstart,34,121,446,318,240,219,412,197
../../CUB_200_2011/images\109.American_Redstart/American_Redstart_0012_103385.jpg,500,335,109.American_Redstart,55,104,267,212,161,158,212,108
../../CUB_200_2011/images\109.American_Redstart/American_Redstart_0086_102876.jpg,500,362,109.American_Redstart,115,109,335,265,225,187,220,156
../../CUB_200_2011/images\109.American_Redstart/American_Redstart_0107_102888.jpg,500,333,109.American_Redstart,62,77,455,284,258,180,393,207
../../CUB_200_2011/images\109.American_Redstart/American_Redstart_0031_102890.jpg,500,357,109.American_Redstart,144,143,492,319,318,231,348,176
../../CUB_200_2011/images\109.American_Redstart/American_Redstart_0110_103924.jpg,500,400,109.American_Redstart,39,61,365,310,202,185,326,249
../../CUB_200_2011/images\110.Geococcyx/Geococcyx_0078_104468.jpg,500,407,110.Geococcyx,85,85,340,352,212,218,255,267
../../CUB_200_2011/images\110.Geococcyx/Geococcyx_0050_104506.jpg,500,393,110.Geococcyx,113,80,438,288,275,184,325,208
../../CUB_200_2011/images\110.Geococcyx/Geococcyx_0040_104507.jpg,500,333,110.Geococcyx,141,25,404,305,272,165,263,280
../../CUB_200_2011/images\110.Geococcyx/Geococcyx_0006_104523.jpg,500,413,110.Geococcyx,47,68,310,354,178,211,263,286
../../CUB_200_2011/images\110.Geococcyx/Geococcyx_0030_104525.jpg,500,500,110.Geococcyx,159,121,311,445,235,283,152,324
../../CUB_200_2011/images\110.Geococcyx/Geococcyx_0107_104534.jpg,500,281,110.Geococcyx,184,107,405,243,294,175,221,136
../../CUB_200_2011/images\110.Geococcyx/Geococcyx_0067_104537.jpg,500,360,110.Geococcyx,83,38,487,339,285,188,404,301
../../CUB_200_2011/images\110.Geococcyx/Geococcyx_0112_104548.jpg,499,500,110.Geococcyx,172,74,396,482,284,278,224,408
../../CUB_200_2011/images\110.Geococcyx/Geococcyx_0061_104553.jpg,500,381,110.Geococcyx,124,94,466,329,295,211,342,235
../../CUB_200_2011/images\110.Geococcyx/Geococcyx_0084_104574.jpg,500,333,110.Geococcyx,10,88,424,260,217,174,414,172
../../CUB_200_2011/images\110.Geococcyx/Geococcyx_0131_104300.jpg,500,304,110.Geococcyx,23,75,389,270,206,172,366,195
../../CUB_200_2011/images\110.Geococcyx/Geococcyx_0091_104301.jpg,500,333,110.Geococcyx,70,97,296,303,183,200,226,206
../../CUB_200_2011/images\110.Geococcyx/Geococcyx_0114_104136.jpg,500,333,110.Geococcyx,0,75,335,281,167,178,335,206
../../CUB_200_2011/images\110.Geococcyx/Geococcyx_0024_104243.jpg,500,345,110.Geococcyx,55,54,480,240,267,147,425,186
../../CUB_200_2011/images\110.Geococcyx/Geococcyx_0118_104131.jpg,500,333,110.Geococcyx,10,82,340,277,175,179,330,195
../../CUB_200_2011/images\110.Geococcyx/Geococcyx_0099_104134.jpg,333,500,110.Geococcyx,56,74,257,413,156,243,201,339
../../CUB_200_2011/images\110.Geococcyx/Geococcyx_0124_104141.jpg,500,333,110.Geococcyx,131,127,413,289,272,208,282,162
../../CUB_200_2011/images\110.Geococcyx/Geococcyx_0056_104142.jpg,500,344,110.Geococcyx,125,33,399,332,262,182,274,299
../../CUB_200_2011/images\110.Geococcyx/Geococcyx_0136_104144.jpg,500,333,110.Geococcyx,173,67,480,312,326,189,307,245
../../CUB_200_2011/images\110.Geococcyx/Geococcyx_0068_104149.jpg,500,333,110.Geococcyx,95,37,474,294,284,165,379,257
../../CUB_200_2011/images\110.Geococcyx/Geococcyx_0022_104157.jpg,500,500,110.Geococcyx,57,47,465,425,261,236,408,378
../../CUB_200_2011/images\110.Geococcyx/Geococcyx_0110_104163.jpg,500,329,110.Geococcyx,75,46,493,289,284,167,418,243
../../CUB_200_2011/images\110.Geococcyx/Geococcyx_0020_104164.jpg,500,307,110.Geococcyx,50,49,399,242,224,145,349,193
../../CUB_200_2011/images\110.Geococcyx/Geococcyx_0045_104166.jpg,500,326,110.Geococcyx,105,42,319,247,212,144,214,205
../../CUB_200_2011/images\110.Geococcyx/Geococcyx_0036_104173.jpg,500,313,110.Geococcyx,88,44,475,218,281,131,387,174
../../CUB_200_2011/images\110.Geococcyx/Geococcyx_0120_104176.jpg,500,334,110.Geococcyx,3,21,373,313,188,167,370,292
../../CUB_200_2011/images\110.Geococcyx/Geococcyx_0137_104693.jpg,500,333,110.Geococcyx,160,29,431,332,295,180,271,303
../../CUB_200_2011/images\110.Geococcyx/Geococcyx_0077_104185.jpg,500,375,110.Geococcyx,134,39,447,330,290,184,313,291
../../CUB_200_2011/images\110.Geococcyx/Geococcyx_0005_104187.jpg,500,333,110.Geococcyx,36,48,469,231,252,139,433,183
../../CUB_200_2011/images\110.Geococcyx/Geococcyx_0033_104195.jpg,500,320,110.Geococcyx,108,51,499,310,303,180,391,259
../../CUB_200_2011/images\110.Geococcyx/Geococcyx_0134_104196.jpg,500,334,110.Geococcyx,34,11,490,285,262,148,456,274
../../CUB_200_2011/images\110.Geococcyx/Geococcyx_0010_104197.jpg,500,337,110.Geococcyx,2,60,404,289,203,174,402,229
../../CUB_200_2011/images\110.Geococcyx/Geococcyx_0135_104716.jpg,500,357,110.Geococcyx,194,38,465,328,329,183,271,290
../../CUB_200_2011/images\110.Geococcyx/Geococcyx_0106_104216.jpg,500,400,110.Geococcyx,108,59,449,323,278,191,341,264
../../CUB_200_2011/images\110.Geococcyx/Geococcyx_0105_104239.jpg,500,417,110.Geococcyx,78,13,423,395,250,204,345,382
../../CUB_200_2011/images\110.Geococcyx/Geococcyx_0117_104227.jpg,500,412,110.Geococcyx,13,93,360,369,186,231,347,276
../../CUB_200_2011/images\110.Geococcyx/Geococcyx_0101_104230.jpg,500,375,110.Geococcyx,85,33,435,312,260,172,350,279
../../CUB_200_2011/images\110.Geococcyx/Geococcyx_0062_104743.jpg,500,333,110.Geococcyx,209,106,432,280,320,193,223,174
../../CUB_200_2011/images\110.Geococcyx/Geococcyx_0028_104751.jpg,500,375,110.Geococcyx,139,3,497,257,318,130,358,254
../../CUB_200_2011/images\110.Geococcyx/Geococcyx_0116_104240.jpg,500,344,110.Geococcyx,78,78,377,224,227,151,299,146
../../CUB_200_2011/images\110.Geococcyx/Geococcyx_0086_104755.jpg,500,491,110.Geococcyx,267,224,430,376,348,300,163,152
../../CUB_200_2011/images\110.Geococcyx/Geococcyx_0079_104249.jpg,500,332,110.Geococcyx,78,40,499,311,288,175,421,271
../../CUB_200_2011/images\110.Geococcyx/Geococcyx_0063_104250.jpg,500,301,110.Geococcyx,150,125,314,228,232,176,164,103
../../CUB_200_2011/images\110.Geococcyx/Geococcyx_0059_104258.jpg,500,375,110.Geococcyx,112,162,293,283,202,222,181,121
../../CUB_200_2011/images\110.Geococcyx/Geococcyx_0038_104266.jpg,377,500,110.Geococcyx,43,128,360,493,201,310,317,365
../../CUB_200_2011/images\110.Geococcyx/Geococcyx_0133_104267.jpg,500,313,110.Geococcyx,53,53,348,197,200,125,295,144
../../CUB_200_2011/images\110.Geococcyx/Geococcyx_0041_104273.jpg,357,500,110.Geococcyx,8,117,287,457,147,287,279,340
../../CUB_200_2011/images\110.Geococcyx/Geococcyx_0139_104277.jpg,500,375,110.Geococcyx,159,150,298,257,228,203,139,107
../../CUB_200_2011/images\110.Geococcyx/Geococcyx_0015_104792.jpg,393,500,110.Geococcyx,20,58,269,487,144,272,249,429
../../CUB_200_2011/images\110.Geococcyx/Geococcyx_0027_104291.jpg,500,358,110.Geococcyx,43,75,250,337,146,206,207,262
../../CUB_200_2011/images\110.Geococcyx/Geococcyx_0065_104806.jpg,326,500,110.Geococcyx,10,128,278,372,144,250,268,244
../../CUB_200_2011/images\110.Geococcyx/Geococcyx_0048_104817.jpg,500,375,110.Geococcyx,70,161,439,345,254,253,369,184
../../CUB_200_2011/images\110.Geococcyx/Geococcyx_0075_104334.jpg,500,417,110.Geococcyx,19,21,440,383,229,202,421,362
../../CUB_200_2011/images\110.Geococcyx/Geococcyx_0047_104259.jpg,500,340,110.Geococcyx,0,9,490,339,245,174,490,330
../../CUB_200_2011/images\110.Geococcyx/Geococcyx_0108_104350.jpg,500,359,110.Geococcyx,110,43,468,318,289,180,358,275
../../CUB_200_2011/images\110.Geococcyx/Geococcyx_0012_104352.jpg,500,333,110.Geococcyx,100,46,432,259,266,152,332,213
../../CUB_200_2011/images\110.Geococcyx/Geococcyx_0095_104358.jpg,388,500,110.Geococcyx,113,49,387,370,250,209,274,321
../../CUB_200_2011/images\110.Geococcyx/Geococcyx_0096_104369.jpg,500,400,110.Geococcyx,146,137,418,344,282,240,272,207
../../CUB_200_2011/images\110.Geococcyx/Geococcyx_0009_104372.jpg,500,333,110.Geococcyx,157,62,458,266,307,164,301,204
../../CUB_200_2011/images\110.Geococcyx/Geococcyx_0011_104779.jpg,500,333,110.Geococcyx,88,119,499,310,293,214,411,191
../../CUB_200_2011/images\111.Loggerhead_Shrike/Loggerhead_Shrike_0114_104960.jpg,500,355,111.Loggerhead_Shrike,115,104,281,224,198,164,166,120
../../CUB_200_2011/images\111.Loggerhead_Shrike/Loggerhead_Shrike_0032_106521.jpg,500,409,111.Loggerhead_Shrike,169,85,351,345,260,215,182,260
../../CUB_200_2011/images\111.Loggerhead_Shrike/Loggerhead_Shrike_0022_105501.jpg,500,400,111.Loggerhead_Shrike,166,89,403,328,284,208,237,239
../../CUB_200_2011/images\111.Loggerhead_Shrike/Loggerhead_Shrike_0036_105904.jpg,500,400,111.Loggerhead_Shrike,50,144,495,320,272,232,445,176
../../CUB_200_2011/images\111.Loggerhead_Shrike/Loggerhead_Shrike_0046_104998.jpg,473,450,111.Loggerhead_Shrike,84,92,346,355,215,223,262,263
../../CUB_200_2011/images\111.Loggerhead_Shrike/Loggerhead_Shrike_0041_105002.jpg,500,428,111.Loggerhead_Shrike,73,62,323,308,198,185,250,246
../../CUB_200_2011/images\111.Loggerhead_Shrike/Loggerhead_Shrike_0086_105005.jpg,333,500,111.Loggerhead_Shrike,90,190,210,359,150,274,120,169
../../CUB_200_2011/images\111.Loggerhead_Shrike/Loggerhead_Shrike_0108_105023.jpg,500,379,111.Loggerhead_Shrike,50,118,318,307,184,212,268,189
../../CUB_200_2011/images\111.Loggerhead_Shrike/Loggerhead_Shrike_0089_106055.jpg,500,333,111.Loggerhead_Shrike,136,93,274,247,205,170,138,154
../../CUB_200_2011/images\111.Loggerhead_Shrike/Loggerhead_Shrike_0071_105040.jpg,500,387,111.Loggerhead_Shrike,70,76,330,253,200,164,260,177
../../CUB_200_2011/images\111.Loggerhead_Shrike/Loggerhead_Shrike_0059_106086.jpg,500,409,111.Loggerhead_Shrike,61,61,275,186,168,123,214,125
../../CUB_200_2011/images\111.Loggerhead_Shrike/Loggerhead_Shrike_0115_105575.jpg,500,397,111.Loggerhead_Shrike,58,111,432,357,245,234,374,246
../../CUB_200_2011/images\111.Loggerhead_Shrike/Loggerhead_Shrike_0073_106097.jpg,420,280,111.Loggerhead_Shrike,89,16,341,272,215,144,252,256
../../CUB_200_2011/images\111.Loggerhead_Shrike/Loggerhead_Shrike_0091_105076.jpg,500,375,111.Loggerhead_Shrike,191,138,371,250,281,194,180,112
../../CUB_200_2011/images\111.Loggerhead_Shrike/Loggerhead_Shrike_0007_106101.jpg,500,333,111.Loggerhead_Shrike,140,86,268,240,204,163,128,154
../../CUB_200_2011/images\111.Loggerhead_Shrike/Loggerhead_Shrike_0024_105593.jpg,500,333,111.Loggerhead_Shrike,151,85,366,226,258,155,215,141
../../CUB_200_2011/images\111.Loggerhead_Shrike/Loggerhead_Shrike_0125_105594.jpg,406,500,111.Loggerhead_Shrike,46,75,345,396,195,235,299,321
../../CUB_200_2011/images\111.Loggerhead_Shrike/Loggerhead_Shrike_0100_105106.jpg,500,426,111.Loggerhead_Shrike,149,108,273,269,211,188,124,161
../../CUB_200_2011/images\111.Loggerhead_Shrike/Loggerhead_Shrike_0019_106132.jpg,357,500,111.Loggerhead_Shrike,66,40,239,458,152,249,173,418
../../CUB_200_2011/images\111.Loggerhead_Shrike/Loggerhead_Shrike_0052_105120.jpg,500,375,111.Loggerhead_Shrike,176,129,370,249,273,189,194,120
../../CUB_200_2011/images\111.Loggerhead_Shrike/Loggerhead_Shrike_0075_106153.jpg,365,500,111.Loggerhead_Shrike,115,186,343,397,229,291,228,211
../../CUB_200_2011/images\111.Loggerhead_Shrike/Loggerhead_Shrike_0103_105137.jpg,500,434,111.Loggerhead_Shrike,183,175,407,359,295,267,224,184
../../CUB_200_2011/images\111.Loggerhead_Shrike/Loggerhead_Shrike_0119_105138.jpg,335,500,111.Loggerhead_Shrike,96,128,266,458,181,293,170,330
../../CUB_200_2011/images\111.Loggerhead_Shrike/Loggerhead_Shrike_0069_73908.jpg,500,401,111.Loggerhead_Shrike,276,146,444,341,360,243,168,195
../../CUB_200_2011/images\111.Loggerhead_Shrike/Loggerhead_Shrike_0088_105663.jpg,500,500,111.Loggerhead_Shrike,252,79,364,419,308,249,112,340
../../CUB_200_2011/images\111.Loggerhead_Shrike/Loggerhead_Shrike_0118_105157.jpg,500,400,111.Loggerhead_Shrike,17,46,284,395,150,220,267,349
../../CUB_200_2011/images\111.Loggerhead_Shrike/Loggerhead_Shrike_0106_105437.jpg,500,400,111.Loggerhead_Shrike,136,101,457,303,296,202,321,202
../../CUB_200_2011/images\111.Loggerhead_Shrike/Loggerhead_Shrike_0033_105686.jpg,500,313,111.Loggerhead_Shrike,159,15,352,308,255,161,193,293
../../CUB_200_2011/images\111.Loggerhead_Shrike/Loggerhead_Shrike_0048_106215.jpg,500,375,111.Loggerhead_Shrike,174,143,481,290,327,216,307,147
../../CUB_200_2011/images\111.Loggerhead_Shrike/Loggerhead_Shrike_0025_104828.jpg,357,500,111.Loggerhead_Shrike,190,144,305,310,247,227,115,166
../../CUB_200_2011/images\111.Loggerhead_Shrike/Loggerhead_Shrike_0002_105195.jpg,333,500,111.Loggerhead_Shrike,163,189,277,352,220,270,114,163
../../CUB_200_2011/images\111.Loggerhead_Shrike/Loggerhead_Shrike_0028_106221.jpg,500,333,111.Loggerhead_Shrike,139,42,426,258,282,150,287,216
../../CUB_200_2011/images\111.Loggerhead_Shrike/Loggerhead_Shrike_0109_105710.jpg,500,395,111.Loggerhead_Shrike,110,88,341,360,225,224,231,272
../../CUB_200_2011/images\111.Loggerhead_Shrike/Loggerhead_Shrike_0064_106225.jpg,500,375,111.Loggerhead_Shrike,60,55,390,344,225,199,330,289
../../CUB_200_2011/images\111.Loggerhead_Shrike/Loggerhead_Shrike_0127_105742.jpg,422,500,111.Loggerhead_Shrike,79,117,323,365,201,241,244,248
../../CUB_200_2011/images\111.Loggerhead_Shrike/Loggerhead_Shrike_0128_105238.jpg,500,326,111.Loggerhead_Shrike,178,17,319,305,248,161,141,288
../../CUB_200_2011/images\111.Loggerhead_Shrike/Loggerhead_Shrike_0011_104921.jpg,400,500,111.Loggerhead_Shrike,13,200,230,473,121,336,217,273
../../CUB_200_2011/images\111.Loggerhead_Shrike/Loggerhead_Shrike_0055_105246.jpg,500,334,111.Loggerhead_Shrike,21,58,245,224,133,141,224,166
../../CUB_200_2011/images\111.Loggerhead_Shrike/Loggerhead_Shrike_0018_26407.jpg,500,400,111.Loggerhead_Shrike,24,90,413,339,218,214,389,249
../../CUB_200_2011/images\111.Loggerhead_Shrike/Loggerhead_Shrike_0120_105777.jpg,500,333,111.Loggerhead_Shrike,96,62,293,299,194,180,197,237
../../CUB_200_2011/images\111.Loggerhead_Shrike/Loggerhead_Shrike_0116_105286.jpg,500,335,111.Loggerhead_Shrike,219,100,435,243,327,171,216,143
../../CUB_200_2011/images\111.Loggerhead_Shrike/Loggerhead_Shrike_0126_106316.jpg,324,432,111.Loggerhead_Shrike,54,77,272,369,163,223,218,292
../../CUB_200_2011/images\111.Loggerhead_Shrike/Loggerhead_Shrike_0123_105849.jpg,500,364,111.Loggerhead_Shrike,182,53,408,318,295,185,226,265
../../CUB_200_2011/images\111.Loggerhead_Shrike/Loggerhead_Shrike_0039_106367.jpg,500,289,111.Loggerhead_Shrike,127,74,460,247,293,160,333,173
../../CUB_200_2011/images\111.Loggerhead_Shrike/Loggerhead_Shrike_0101_105392.jpg,357,500,111.Loggerhead_Shrike,26,107,254,307,140,207,228,200
../../CUB_200_2011/images\111.Loggerhead_Shrike/Loggerhead_Shrike_0117_104838.jpg,500,332,111.Loggerhead_Shrike,122,98,330,276,226,187,208,178
../../CUB_200_2011/images\111.Loggerhead_Shrike/Loggerhead_Shrike_0029_104849.jpg,500,482,111.Loggerhead_Shrike,51,115,308,460,179,287,257,345
../../CUB_200_2011/images\111.Loggerhead_Shrike/Loggerhead_Shrike_0129_106389.jpg,500,398,111.Loggerhead_Shrike,83,38,320,383,201,210,237,345
../../CUB_200_2011/images\111.Loggerhead_Shrike/Loggerhead_Shrike_0065_104856.jpg,500,335,111.Loggerhead_Shrike,239,134,447,273,343,203,208,139
../../CUB_200_2011/images\111.Loggerhead_Shrike/Loggerhead_Shrike_0010_104866.jpg,500,382,111.Loggerhead_Shrike,100,137,213,287,156,212,113,150
../../CUB_200_2011/images\111.Loggerhead_Shrike/Loggerhead_Shrike_0023_105892.jpg,500,361,111.Loggerhead_Shrike,202,113,441,327,321,220,239,214
../../CUB_200_2011/images\111.Loggerhead_Shrike/Loggerhead_Shrike_0021_104885.jpg,500,333,111.Loggerhead_Shrike,54,84,303,254,178,169,249,170
../../CUB_200_2011/images\111.Loggerhead_Shrike/Loggerhead_Shrike_0068_105400.jpg,500,333,111.Loggerhead_Shrike,85,89,310,276,197,182,225,187
../../CUB_200_2011/images\111.Loggerhead_Shrike/Loggerhead_Shrike_0084_105919.jpg,500,375,111.Loggerhead_Shrike,79,41,309,269,194,155,230,228
../../CUB_200_2011/images\111.Loggerhead_Shrike/Loggerhead_Shrike_0017_104864.jpg,500,355,111.Loggerhead_Shrike,6,79,250,350,128,214,244,271
../../CUB_200_2011/images\111.Loggerhead_Shrike/Loggerhead_Shrike_0026_104898.jpg,500,335,111.Loggerhead_Shrike,69,50,377,240,223,145,308,190
../../CUB_200_2011/images\111.Loggerhead_Shrike/Loggerhead_Shrike_0110_105947.jpg,500,451,111.Loggerhead_Shrike,126,59,389,349,257,204,263,290
../../CUB_200_2011/images\111.Loggerhead_Shrike/Loggerhead_Shrike_0090_106461.jpg,500,333,111.Loggerhead_Shrike,107,76,351,258,229,167,244,182
../../CUB_200_2011/images\111.Loggerhead_Shrike/Loggerhead_Shrike_0030_104930.jpg,403,500,111.Loggerhead_Shrike,91,138,325,342,208,240,234,204
../../CUB_200_2011/images\111.Loggerhead_Shrike/Loggerhead_Shrike_0051_105447.jpg,500,340,111.Loggerhead_Shrike,199,60,411,318,305,189,212,258
../../CUB_200_2011/images\112.Great_Grey_Shrike/Great_Grey_Shrike_0056_106752.jpg,395,500,112.Great_Grey_Shrike,123,100,254,365,188,232,131,265
../../CUB_200_2011/images\112.Great_Grey_Shrike/Great_Grey_Shrike_0048_106754.jpg,500,281,112.Great_Grey_Shrike,211,98,312,200,261,149,101,102
../../CUB_200_2011/images\112.Great_Grey_Shrike/Great_Grey_Shrike_0066_106759.jpg,385,500,112.Great_Grey_Shrike,26,128,332,435,179,281,306,307
../../CUB_200_2011/images\112.Great_Grey_Shrike/Great_Grey_Shrike_0017_797028.jpg,179,180,112.Great_Grey_Shrike,24,8,162,164,93,86,138,156
../../CUB_200_2011/images\112.Great_Grey_Shrike/Great_Grey_Shrike_0054_106768.jpg,500,375,112.Great_Grey_Shrike,57,143,270,298,163,220,213,155
../../CUB_200_2011/images\112.Great_Grey_Shrike/Great_Grey_Shrike_0018_106776.jpg,387,500,112.Great_Grey_Shrike,100,113,270,406,185,259,170,293
../../CUB_200_2011/images\112.Great_Grey_Shrike/Great_Grey_Shrike_0068_797060.jpg,500,347,112.Great_Grey_Shrike,77,86,308,247,192,166,231,161
../../CUB_200_2011/images\112.Great_Grey_Shrike/Great_Grey_Shrike_0064_106778.jpg,420,351,112.Great_Grey_Shrike,90,71,268,323,179,197,178,252
../../CUB_200_2011/images\112.Great_Grey_Shrike/Great_Grey_Shrike_0086_106533.jpg,500,333,112.Great_Grey_Shrike,242,102,371,236,306,169,129,134
../../CUB_200_2011/images\112.Great_Grey_Shrike/Great_Grey_Shrike_0053_106792.jpg,500,427,112.Great_Grey_Shrike,47,125,301,337,174,231,254,212
../../CUB_200_2011/images\112.Great_Grey_Shrike/Great_Grey_Shrike_0032_797021.jpg,493,500,112.Great_Grey_Shrike,21,56,388,296,204,176,367,240
../../CUB_200_2011/images\112.Great_Grey_Shrike/Great_Grey_Shrike_0070_106547.jpg,500,369,112.Great_Grey_Shrike,31,37,331,358,181,197,300,321
../../CUB_200_2011/images\112.Great_Grey_Shrike/Great_Grey_Shrike_0003_106552.jpg,500,339,112.Great_Grey_Shrike,105,37,498,338,301,187,393,301
../../CUB_200_2011/images\112.Great_Grey_Shrike/Great_Grey_Shrike_0094_106576.jpg,357,500,112.Great_Grey_Shrike,56,163,269,271,162,217,213,108
../../CUB_200_2011/images\112.Great_Grey_Shrike/Great_Grey_Shrike_0027_797009.jpg,400,318,112.Great_Grey_Shrike,158,97,304,222,231,159,146,125
../../CUB_200_2011/images\112.Great_Grey_Shrike/Great_Grey_Shrike_0061_106580.jpg,500,354,112.Great_Grey_Shrike,101,74,313,246,207,160,212,172
../../CUB_200_2011/images\112.Great_Grey_Shrike/Great_Grey_Shrike_0039_797015.jpg,300,220,112.Great_Grey_Shrike,75,46,279,164,177,105,204,118
../../CUB_200_2011/images\112.Great_Grey_Shrike/Great_Grey_Shrike_0079_797018.jpg,450,409,112.Great_Grey_Shrike,182,95,351,277,266,186,169,182
../../CUB_200_2011/images\112.Great_Grey_Shrike/Great_Grey_Shrike_0075_797022.jpg,500,422,112.Great_Grey_Shrike,35,93,479,319,257,206,444,226
../../CUB_200_2011/images\112.Great_Grey_Shrike/Great_Grey_Shrike_0010_797023.jpg,500,391,112.Great_Grey_Shrike,75,93,371,326,223,209,296,233
../../CUB_200_2011/images\112.Great_Grey_Shrike/Great_Grey_Shrike_0049_797025.jpg,500,333,112.Great_Grey_Shrike,18,58,379,281,198,169,361,223
../../CUB_200_2011/images\112.Great_Grey_Shrike/Great_Grey_Shrike_0080_106850.jpg,387,500,112.Great_Grey_Shrike,93,68,260,434,176,251,167,366
../../CUB_200_2011/images\112.Great_Grey_Shrike/Great_Grey_Shrike_0065_797027.jpg,450,300,112.Great_Grey_Shrike,157,58,274,244,215,151,117,186
../../CUB_200_2011/images\112.Great_Grey_Shrike/Great_Grey_Shrike_0011_106852.jpg,500,381,112.Great_Grey_Shrike,138,83,462,332,300,207,324,249
../../CUB_200_2011/images\112.Great_Grey_Shrike/Great_Grey_Shrike_0015_797031.jpg,500,340,112.Great_Grey_Shrike,94,51,325,272,209,161,231,221
../../CUB_200_2011/images\112.Great_Grey_Shrike/Great_Grey_Shrike_0055_106858.jpg,500,378,112.Great_Grey_Shrike,42,77,277,311,159,194,235,234
../../CUB_200_2011/images\112.Great_Grey_Shrike/Great_Grey_Shrike_0089_797036.jpg,500,334,112.Great_Grey_Shrike,117,68,439,288,278,178,322,220
../../CUB_200_2011/images\112.Great_Grey_Shrike/Great_Grey_Shrike_0085_797037.jpg,333,500,112.Great_Grey_Shrike,80,65,259,234,169,149,179,169
../../CUB_200_2011/images\112.Great_Grey_Shrike/Great_Grey_Shrike_0009_797038.jpg,333,500,112.Great_Grey_Shrike,45,69,302,336,173,202,257,267
../../CUB_200_2011/images\112.Great_Grey_Shrike/Great_Grey_Shrike_0004_797041.jpg,400,300,112.Great_Grey_Shrike,101,75,350,185,225,130,249,110
../../CUB_200_2011/images\112.Great_Grey_Shrike/Great_Grey_Shrike_0063_797042.jpg,230,250,112.Great_Grey_Shrike,11,49,175,165,93,107,164,116
../../CUB_200_2011/images\112.Great_Grey_Shrike/Great_Grey_Shrike_0014_797044.jpg,500,364,112.Great_Grey_Shrike,242,85,368,285,305,185,126,200
../../CUB_200_2011/images\112.Great_Grey_Shrike/Great_Grey_Shrike_0045_797047.jpg,500,357,112.Great_Grey_Shrike,104,15,406,353,255,184,302,338
../../CUB_200_2011/images\112.Great_Grey_Shrike/Great_Grey_Shrike_0092_797048.jpg,500,334,112.Great_Grey_Shrike,222,63,397,280,309,171,175,217
../../CUB_200_2011/images\112.Great_Grey_Shrike/Great_Grey_Shrike_0038_106617.jpg,500,263,112.Great_Grey_Shrike,177,75,328,228,252,151,151,153
../../CUB_200_2011/images\112.Great_Grey_Shrike/Great_Grey_Shrike_0076_797050.jpg,481,500,112.Great_Grey_Shrike,195,113,356,278,275,195,161,165
../../CUB_200_2011/images\112.Great_Grey_Shrike/Great_Grey_Shrike_0083_797051.jpg,500,333,112.Great_Grey_Shrike,22,36,356,308,189,172,334,272
../../CUB_200_2011/images\112.Great_Grey_Shrike/Great_Grey_Shrike_0020_797052.jpg,363,500,112.Great_Grey_Shrike,68,167,207,459,137,313,139,292
../../CUB_200_2011/images\112.Great_Grey_Shrike/Great_Grey_Shrike_0025_106622.jpg,500,344,112.Great_Grey_Shrike,135,70,314,265,224,167,179,195
../../CUB_200_2011/images\112.Great_Grey_Shrike/Great_Grey_Shrike_0005_797055.jpg,500,313,112.Great_Grey_Shrike,28,71,387,273,207,172,359,202
../../CUB_200_2011/images\112.Great_Grey_Shrike/Great_Grey_Shrike_0042_797056.jpg,300,437,112.Great_Grey_Shrike,4,29,289,417,146,223,285,388
../../CUB_200_2011/images\112.Great_Grey_Shrike/Great_Grey_Shrike_0022_797057.jpg,500,333,112.Great_Grey_Shrike,210,109,316,224,263,166,106,115
../../CUB_200_2011/images\112.Great_Grey_Shrike/Great_Grey_Shrike_0062_106628.jpg,500,497,112.Great_Grey_Shrike,30,56,293,481,161,268,263,425
../../CUB_200_2011/images\112.Great_Grey_Shrike/Great_Grey_Shrike_0058_106634.jpg,500,359,112.Great_Grey_Shrike,101,85,299,308,200,196,198,223
../../CUB_200_2011/images\112.Great_Grey_Shrike/Great_Grey_Shrike_0043_106818.jpg,500,335,112.Great_Grey_Shrike,106,137,294,256,200,196,188,119
../../CUB_200_2011/images\112.Great_Grey_Shrike/Great_Grey_Shrike_0071_106861.jpg,500,327,112.Great_Grey_Shrike,143,43,337,202,240,122,194,159
../../CUB_200_2011/images\112.Great_Grey_Shrike/Great_Grey_Shrike_0082_106650.jpg,490,500,112.Great_Grey_Shrike,70,61,386,464,228,262,316,403
../../CUB_200_2011/images\112.Great_Grey_Shrike/Great_Grey_Shrike_0012_106661.jpg,426,500,112.Great_Grey_Shrike,60,143,292,330,176,236,232,187
../../CUB_200_2011/images\112.Great_Grey_Shrike/Great_Grey_Shrike_0044_106851.jpg,500,375,112.Great_Grey_Shrike,21,48,378,313,199,180,357,265
../../CUB_200_2011/images\112.Great_Grey_Shrike/Great_Grey_Shrike_0029_106668.jpg,500,303,112.Great_Grey_Shrike,79,41,474,265,276,153,395,224
../../CUB_200_2011/images\112.Great_Grey_Shrike/Great_Grey_Shrike_0023_106670.jpg,360,480,112.Great_Grey_Shrike,80,36,241,467,160,251,161,431
../../CUB_200_2011/images\112.Great_Grey_Shrike/Great_Grey_Shrike_0028_106678.jpg,500,333,112.Great_Grey_Shrike,56,114,304,270,180,192,248,156
../../CUB_200_2011/images\112.Great_Grey_Shrike/Great_Grey_Shrike_0057_106681.jpg,500,357,112.Great_Grey_Shrike,178,99,405,246,291,172,227,147
../../CUB_200_2011/images\112.Great_Grey_Shrike/Great_Grey_Shrike_0074_106689.jpg,500,375,112.Great_Grey_Shrike,165,66,336,302,250,184,171,236
../../CUB_200_2011/images\112.Great_Grey_Shrike/Great_Grey_Shrike_0019_797049.jpg,500,314,112.Great_Grey_Shrike,191,86,463,253,327,169,272,167
../../CUB_200_2011/images\112.Great_Grey_Shrike/Great_Grey_Shrike_0016_106720.jpg,333,500,112.Great_Grey_Shrike,50,122,267,295,158,208,217,173
../../CUB_200_2011/images\112.Great_Grey_Shrike/Great_Grey_Shrike_0060_797008.jpg,431,300,112.Great_Grey_Shrike,128,131,430,238,279,184,302,107
../../CUB_200_2011/images\112.Great_Grey_Shrike/Great_Grey_Shrike_0008_797053.jpg,400,329,112.Great_Grey_Shrike,56,85,273,230,164,157,217,145
../../CUB_200_2011/images\112.Great_Grey_Shrike/Great_Grey_Shrike_0091_797054.jpg,500,500,112.Great_Grey_Shrike,161,122,441,341,301,231,280,219
../../CUB_200_2011/images\112.Great_Grey_Shrike/Great_Grey_Shrike_0050_797012.jpg,440,286,112.Great_Grey_Shrike,125,44,424,227,274,135,299,183
../../CUB_200_2011/images\113.Baird_Sparrow/Baird_Sparrow_0009_106882.jpg,500,400,113.Baird_Sparrow,66,56,337,372,201,214,271,316
../../CUB_200_2011/images\113.Baird_Sparrow/Baird_Sparrow_0051_787319.jpg,500,335,113.Baird_Sparrow,108,68,258,264,183,166,150,196
../../CUB_200_2011/images\113.Baird_Sparrow/Baird_Sparrow_0035_106904.jpg,500,334,113.Baird_Sparrow,166,52,307,304,236,178,141,252
../../CUB_200_2011/images\113.Baird_Sparrow/Baird_Sparrow_0008_106929.jpg,500,349,113.Baird_Sparrow,45,103,459,342,252,222,414,239
../../CUB_200_2011/images\113.Baird_Sparrow/Baird_Sparrow_0014_794549.jpg,500,342,113.Baird_Sparrow,156,101,460,299,308,200,304,198
../../CUB_200_2011/images\113.Baird_Sparrow/Baird_Sparrow_0002_794551.jpg,300,300,113.Baird_Sparrow,74,8,219,291,146,149,145,283
../../CUB_200_2011/images\113.Baird_Sparrow/Baird_Sparrow_0012_794552.jpg,343,500,113.Baird_Sparrow,110,136,239,435,174,285,129,299
../../CUB_200_2011/images\113.Baird_Sparrow/Baird_Sparrow_0032_794553.jpg,334,500,113.Baird_Sparrow,99,173,289,420,194,296,190,247
../../CUB_200_2011/images\113.Baird_Sparrow/Baird_Sparrow_0044_794554.jpg,500,342,113.Baird_Sparrow,208,106,377,311,292,208,169,205
../../CUB_200_2011/images\113.Baird_Sparrow/Baird_Sparrow_0043_794555.jpg,500,333,113.Baird_Sparrow,204,151,438,254,321,202,234,103
../../CUB_200_2011/images\113.Baird_Sparrow/Baird_Sparrow_0016_794556.jpg,320,242,113.Baird_Sparrow,54,81,178,210,116,145,124,129
../../CUB_200_2011/images\113.Baird_Sparrow/Baird_Sparrow_0028_794557.jpg,500,462,113.Baird_Sparrow,216,69,446,461,331,265,230,392
../../CUB_200_2011/images\113.Baird_Sparrow/Baird_Sparrow_0003_794558.jpg,500,333,113.Baird_Sparrow,42,33,478,218,260,125,436,185
../../CUB_200_2011/images\113.Baird_Sparrow/Baird_Sparrow_0023_794559.jpg,458,500,113.Baird_Sparrow,46,76,330,391,188,233,284,315
../../CUB_200_2011/images\113.Baird_Sparrow/Baird_Sparrow_0042_794560.jpg,343,500,113.Baird_Sparrow,146,199,258,416,202,307,112,217
../../CUB_200_2011/images\113.Baird_Sparrow/Baird_Sparrow_0037_794562.jpg,500,333,113.Baird_Sparrow,233,61,457,245,345,153,224,184
../../CUB_200_2011/images\113.Baird_Sparrow/Baird_Sparrow_0007_794563.jpg,500,375,113.Baird_Sparrow,124,121,265,350,194,235,141,229
../../CUB_200_2011/images\113.Baird_Sparrow/Baird_Sparrow_0025_794564.jpg,500,391,113.Baird_Sparrow,106,46,405,376,255,211,299,330
../../CUB_200_2011/images\113.Baird_Sparrow/Baird_Sparrow_0005_794565.jpg,334,500,113.Baird_Sparrow,14,222,256,422,135,322,242,200
../../CUB_200_2011/images\113.Baird_Sparrow/Baird_Sparrow_0033_794566.jpg,335,500,113.Baird_Sparrow,126,161,248,457,187,309,122,296
../../CUB_200_2011/images\113.Baird_Sparrow/Baird_Sparrow_0019_794567.jpg,500,334,113.Baird_Sparrow,203,72,319,264,261,168,116,192
../../CUB_200_2011/images\113.Baird_Sparrow/Baird_Sparrow_0004_794568.jpg,334,500,113.Baird_Sparrow,88,215,239,481,163,348,151,266
../../CUB_200_2011/images\113.Baird_Sparrow/Baird_Sparrow_0030_794569.jpg,343,500,113.Baird_Sparrow,21,182,209,441,115,311,188,259
../../CUB_200_2011/images\113.Baird_Sparrow/Baird_Sparrow_0022_794570.jpg,334,500,113.Baird_Sparrow,113,146,241,438,177,292,128,292
../../CUB_200_2011/images\113.Baird_Sparrow/Baird_Sparrow_0045_794571.jpg,500,342,113.Baird_Sparrow,226,84,392,313,309,198,166,229
../../CUB_200_2011/images\113.Baird_Sparrow/Baird_Sparrow_0036_794572.jpg,320,310,113.Baird_Sparrow,117,101,255,269,186,185,138,168
../../CUB_200_2011/images\113.Baird_Sparrow/Baird_Sparrow_0015_794573.jpg,278,408,113.Baird_Sparrow,40,36,255,311,147,173,215,275
../../CUB_200_2011/images\113.Baird_Sparrow/Baird_Sparrow_0026_794574.jpg,245,250,113.Baird_Sparrow,49,6,220,249,134,127,171,243
../../CUB_200_2011/images\113.Baird_Sparrow/Baird_Sparrow_0010_794575.jpg,500,365,113.Baird_Sparrow,74,97,310,297,192,197,236,200
../../CUB_200_2011/images\113.Baird_Sparrow/Baird_Sparrow_0021_794576.jpg,320,316,113.Baird_Sparrow,22,97,167,273,94,185,145,176
../../CUB_200_2011/images\113.Baird_Sparrow/Baird_Sparrow_0011_794577.jpg,240,196,113.Baird_Sparrow,75,29,217,138,146,83,142,109
../../CUB_200_2011/images\113.Baird_Sparrow/Baird_Sparrow_0001_794578.jpg,500,375,113.Baird_Sparrow,182,79,316,206,249,142,134,127
../../CUB_200_2011/images\113.Baird_Sparrow/Baird_Sparrow_0006_794579.jpg,500,343,113.Baird_Sparrow,84,86,265,273,174,179,181,187
../../CUB_200_2011/images\113.Baird_Sparrow/Baird_Sparrow_0031_794580.jpg,500,333,113.Baird_Sparrow,234,114,429,263,331,188,195,149
../../CUB_200_2011/images\113.Baird_Sparrow/Baird_Sparrow_0040_794581.jpg,255,221,113.Baird_Sparrow,18,16,253,207,135,111,235,191
../../CUB_200_2011/images\113.Baird_Sparrow/Baird_Sparrow_0041_794582.jpg,301,380,113.Baird_Sparrow,92,43,210,301,151,172,118,258
../../CUB_200_2011/images\113.Baird_Sparrow/Baird_Sparrow_0029_794583.jpg,150,159,113.Baird_Sparrow,13,9,138,157,75,83,125,148
../../CUB_200_2011/images\113.Baird_Sparrow/Baird_Sparrow_0018_794584.jpg,500,333,113.Baird_Sparrow,232,57,420,279,326,168,188,222
../../CUB_200_2011/images\113.Baird_Sparrow/Baird_Sparrow_0017_794586.jpg,355,500,113.Baird_Sparrow,33,146,205,286,119,216,172,140
../../CUB_200_2011/images\113.Baird_Sparrow/Baird_Sparrow_0013_794587.jpg,500,371,113.Baird_Sparrow,207,64,419,260,313,162,212,196
../../CUB_200_2011/images\113.Baird_Sparrow/Baird_Sparrow_0046_794588.jpg,500,334,113.Baird_Sparrow,173,72,313,324,243,198,140,252
../../CUB_200_2011/images\113.Baird_Sparrow/Baird_Sparrow_0034_794589.jpg,500,334,113.Baird_Sparrow,205,132,408,312,306,222,203,180
../../CUB_200_2011/images\113.Baird_Sparrow/Baird_Sparrow_0027_794590.jpg,343,500,113.Baird_Sparrow,98,154,241,469,169,311,143,315
../../CUB_200_2011/images\113.Baird_Sparrow/Baird_Sparrow_0039_794591.jpg,230,297,113.Baird_Sparrow,65,46,208,273,136,159,143,227
../../CUB_200_2011/images\113.Baird_Sparrow/Baird_Sparrow_0038_794592.jpg,335,500,113.Baird_Sparrow,119,149,270,321,194,235,151,172
../../CUB_200_2011/images\113.Baird_Sparrow/Baird_Sparrow_0020_106863.jpg,500,392,113.Baird_Sparrow,79,62,428,341,253,201,349,279
../../CUB_200_2011/images\113.Baird_Sparrow/Baird_Sparrow_0050_787316.jpg,500,345,113.Baird_Sparrow,195,54,436,312,315,183,241,258
../../CUB_200_2011/images\113.Baird_Sparrow/Baird_Sparrow_0047_787318.jpg,500,354,113.Baird_Sparrow,139,64,440,326,289,195,301,262
../../CUB_200_2011/images\113.Baird_Sparrow/Baird_Sparrow_0048_787323.jpg,420,280,113.Baird_Sparrow,100,28,285,259,192,143,185,231
../../CUB_200_2011/images\113.Baird_Sparrow/Baird_Sparrow_0049_787324.jpg,500,375,113.Baird_Sparrow,157,158,310,344,233,251,153,186
../../CUB_200_2011/images\114.Black_throated_Sparrow/Black_Throated_Sparrow_0056_107010.jpg,500,334,114.Black_throated_Sparrow,157,57,336,286,246,171,179,229
../../CUB_200_2011/images\114.Black_throated_Sparrow/Black_Throated_Sparrow_0095_107268.jpg,500,334,114.Black_throated_Sparrow,94,79,453,279,273,179,359,200
../../CUB_200_2011/images\114.Black_throated_Sparrow/Black_Throated_Sparrow_0044_107270.jpg,500,266,114.Black_throated_Sparrow,137,89,353,208,245,148,216,119
../../CUB_200_2011/images\114.Black_throated_Sparrow/Black_Throated_Sparrow_0021_107021.jpg,500,375,114.Black_throated_Sparrow,251,87,432,360,341,223,181,273
../../CUB_200_2011/images\114.Black_throated_Sparrow/Black_Throated_Sparrow_0027_107278.jpg,500,375,114.Black_throated_Sparrow,239,164,376,352,307,258,137,188
../../CUB_200_2011/images\114.Black_throated_Sparrow/Black_Throated_Sparrow_0054_107026.jpg,500,447,114.Black_throated_Sparrow,145,159,395,273,270,216,250,114
../../CUB_200_2011/images\114.Black_throated_Sparrow/Black_Throated_Sparrow_0050_107033.jpg,321,402,114.Black_throated_Sparrow,42,56,217,219,129,137,175,163
../../CUB_200_2011/images\114.Black_throated_Sparrow/Black_Throated_Sparrow_0003_107035.jpg,500,377,114.Black_throated_Sparrow,77,148,345,336,211,242,268,188
../../CUB_200_2011/images\114.Black_throated_Sparrow/Black_Throated_Sparrow_0057_107036.jpg,500,343,114.Black_throated_Sparrow,157,102,358,251,257,176,201,149
../../CUB_200_2011/images\114.Black_throated_Sparrow/Black_Throated_Sparrow_0090_107295.jpg,500,375,114.Black_throated_Sparrow,165,123,499,363,332,243,334,240
../../CUB_200_2011/images\114.Black_throated_Sparrow/Black_Throated_Sparrow_0033_107042.jpg,398,500,114.Black_throated_Sparrow,70,250,225,432,147,341,155,182
../../CUB_200_2011/images\114.Black_throated_Sparrow/Black_Throated_Sparrow_0080_107050.jpg,500,500,114.Black_throated_Sparrow,280,160,453,408,366,284,173,248
../../CUB_200_2011/images\114.Black_throated_Sparrow/Black_Throated_Sparrow_0059_107060.jpg,500,333,114.Black_throated_Sparrow,192,77,365,230,278,153,173,153
../../CUB_200_2011/images\114.Black_throated_Sparrow/Black_Throated_Sparrow_0084_107066.jpg,500,303,114.Black_throated_Sparrow,212,101,371,249,291,175,159,148
../../CUB_200_2011/images\114.Black_throated_Sparrow/Black_Throated_Sparrow_0034_107327.jpg,332,500,114.Black_throated_Sparrow,40,215,203,397,121,306,163,182
../../CUB_200_2011/images\114.Black_throated_Sparrow/Black_Throated_Sparrow_0015_107079.jpg,500,393,114.Black_throated_Sparrow,115,58,438,293,276,175,323,235
../../CUB_200_2011/images\114.Black_throated_Sparrow/Black_Throated_Sparrow_0046_107339.jpg,333,500,114.Black_throated_Sparrow,136,129,284,477,210,303,148,348
../../CUB_200_2011/images\114.Black_throated_Sparrow/Black_Throated_Sparrow_0094_107085.jpg,500,333,114.Black_throated_Sparrow,37,104,277,276,157,190,240,172
../../CUB_200_2011/images\114.Black_throated_Sparrow/Black_Throated_Sparrow_0065_107087.jpg,500,475,114.Black_throated_Sparrow,86,89,381,296,233,192,295,207
../../CUB_200_2011/images\114.Black_throated_Sparrow/Black_Throated_Sparrow_0091_107346.jpg,500,470,114.Black_throated_Sparrow,82,83,430,390,256,236,348,307
../../CUB_200_2011/images\114.Black_throated_Sparrow/Black_Throated_Sparrow_0017_107355.jpg,500,324,114.Black_throated_Sparrow,159,28,388,292,273,160,229,264
../../CUB_200_2011/images\114.Black_throated_Sparrow/Black_Throated_Sparrow_0023_107104.jpg,497,500,114.Black_throated_Sparrow,79,177,334,338,206,257,255,161
../../CUB_200_2011/images\114.Black_throated_Sparrow/Black_Throated_Sparrow_0097_106935.jpg,500,333,114.Black_throated_Sparrow,96,65,456,261,276,163,360,196
../../CUB_200_2011/images\114.Black_throated_Sparrow/Black_Throated_Sparrow_0081_107111.jpg,500,333,114.Black_throated_Sparrow,181,82,421,279,301,180,240,197
../../CUB_200_2011/images\114.Black_throated_Sparrow/Black_Throated_Sparrow_0074_107113.jpg,363,500,114.Black_throated_Sparrow,46,69,326,365,186,217,280,296
../../CUB_200_2011/images\114.Black_throated_Sparrow/Black_Throated_Sparrow_0011_107115.jpg,420,280,114.Black_throated_Sparrow,96,27,259,267,177,147,163,240
../../CUB_200_2011/images\114.Black_throated_Sparrow/Black_Throated_Sparrow_0069_107116.jpg,500,326,114.Black_throated_Sparrow,47,91,457,319,252,205,410,228
../../CUB_200_2011/images\114.Black_throated_Sparrow/Black_Throated_Sparrow_0053_107282.jpg,500,465,114.Black_throated_Sparrow,183,158,353,317,268,237,170,159
../../CUB_200_2011/images\114.Black_throated_Sparrow/Black_Throated_Sparrow_0010_107375.jpg,500,410,114.Black_throated_Sparrow,86,91,342,370,214,230,256,279
../../CUB_200_2011/images\114.Black_throated_Sparrow/Black_Throated_Sparrow_0098_107138.jpg,500,333,114.Black_throated_Sparrow,87,42,307,230,197,136,220,188
../../CUB_200_2011/images\114.Black_throated_Sparrow/Black_Throated_Sparrow_0005_107150.jpg,500,333,114.Black_throated_Sparrow,175,43,349,317,262,180,174,274
../../CUB_200_2011/images\114.Black_throated_Sparrow/Black_Throated_Sparrow_0009_107333.jpg,500,348,114.Black_throated_Sparrow,149,73,440,302,294,187,291,229
../../CUB_200_2011/images\114.Black_throated_Sparrow/Black_Throated_Sparrow_0040_107172.jpg,500,334,114.Black_throated_Sparrow,103,57,297,296,200,176,194,239
../../CUB_200_2011/images\114.Black_throated_Sparrow/Black_Throated_Sparrow_0060_107177.jpg,500,333,114.Black_throated_Sparrow,134,107,292,299,213,203,158,192
../../CUB_200_2011/images\114.Black_throated_Sparrow/Black_Throated_Sparrow_0035_107185.jpg,500,333,114.Black_throated_Sparrow,180,102,349,244,264,173,169,142
../../CUB_200_2011/images\114.Black_throated_Sparrow/Black_Throated_Sparrow_0076_106995.jpg,500,333,114.Black_throated_Sparrow,199,80,459,271,329,175,260,191
../../CUB_200_2011/images\114.Black_throated_Sparrow/Black_Throated_Sparrow_0019_107192.jpg,500,372,114.Black_throated_Sparrow,304,127,437,276,370,201,133,149
../../CUB_200_2011/images\114.Black_throated_Sparrow/Black_Throated_Sparrow_0070_107196.jpg,500,437,114.Black_throated_Sparrow,101,135,254,286,177,210,153,151
../../CUB_200_2011/images\114.Black_throated_Sparrow/Black_Throated_Sparrow_0026_107198.jpg,300,274,114.Black_throated_Sparrow,14,10,298,255,156,132,284,245
../../CUB_200_2011/images\114.Black_throated_Sparrow/Black_Throated_Sparrow_0099_106944.jpg,421,500,114.Black_throated_Sparrow,110,65,310,473,210,269,200,408
../../CUB_200_2011/images\114.Black_throated_Sparrow/Black_Throated_Sparrow_0007_106999.jpg,500,400,114.Black_throated_Sparrow,58,116,362,287,210,201,304,171
../../CUB_200_2011/images\114.Black_throated_Sparrow/Black_Throated_Sparrow_0055_107213.jpg,500,334,114.Black_throated_Sparrow,105,44,319,300,212,172,214,256
../../CUB_200_2011/images\114.Black_throated_Sparrow/Black_Throated_Sparrow_0049_106958.jpg,500,321,114.Black_throated_Sparrow,137,109,336,243,236,176,199,134
../../CUB_200_2011/images\114.Black_throated_Sparrow/Black_Throated_Sparrow_0068_106960.jpg,500,375,114.Black_throated_Sparrow,38,12,339,374,188,193,301,362
../../CUB_200_2011/images\114.Black_throated_Sparrow/Black_Throated_Sparrow_0051_107217.jpg,500,375,114.Black_throated_Sparrow,143,165,301,270,222,217,158,105
../../CUB_200_2011/images\114.Black_throated_Sparrow/Black_Throated_Sparrow_0002_106962.jpg,500,382,114.Black_throated_Sparrow,169,89,283,319,226,204,114,230
../../CUB_200_2011/images\114.Black_throated_Sparrow/Black_Throated_Sparrow_0088_107220.jpg,500,486,114.Black_throated_Sparrow,118,47,477,415,297,231,359,368
../../CUB_200_2011/images\114.Black_throated_Sparrow/Black_Throated_Sparrow_0061_106967.jpg,378,500,114.Black_throated_Sparrow,119,60,303,368,211,214,184,308
../../CUB_200_2011/images\114.Black_throated_Sparrow/Black_Throated_Sparrow_0086_106970.jpg,500,309,114.Black_throated_Sparrow,285,115,391,218,338,166,106,103
../../CUB_200_2011/images\114.Black_throated_Sparrow/Black_Throated_Sparrow_0020_106971.jpg,500,375,114.Black_throated_Sparrow,104,73,253,358,178,215,149,285
../../CUB_200_2011/images\114.Black_throated_Sparrow/Black_Throated_Sparrow_0066_106974.jpg,500,375,114.Black_throated_Sparrow,10,70,354,307,182,188,344,237
../../CUB_200_2011/images\114.Black_throated_Sparrow/Black_Throated_Sparrow_0001_107233.jpg,500,352,114.Black_throated_Sparrow,195,134,388,250,291,192,193,116
../../CUB_200_2011/images\114.Black_throated_Sparrow/Black_Throated_Sparrow_0043_107236.jpg,500,397,114.Black_throated_Sparrow,37,62,413,360,225,211,376,298
../../CUB_200_2011/images\114.Black_throated_Sparrow/Black_Throated_Sparrow_0096_107238.jpg,357,500,114.Black_throated_Sparrow,30,79,304,429,167,254,274,350
../../CUB_200_2011/images\114.Black_throated_Sparrow/Black_Throated_Sparrow_0102_107243.jpg,463,370,114.Black_throated_Sparrow,124,58,381,334,252,196,257,276
../../CUB_200_2011/images\114.Black_throated_Sparrow/Black_Throated_Sparrow_0078_107298.jpg,500,375,114.Black_throated_Sparrow,168,191,336,333,252,262,168,142
../../CUB_200_2011/images\114.Black_throated_Sparrow/Black_Throated_Sparrow_0072_107255.jpg,500,375,114.Black_throated_Sparrow,113,87,346,312,229,199,233,225
../../CUB_200_2011/images\114.Black_throated_Sparrow/Black_Throated_Sparrow_0008_107000.jpg,333,500,114.Black_throated_Sparrow,80,70,274,385,177,227,194,315
../../CUB_200_2011/images\114.Black_throated_Sparrow/Black_Throated_Sparrow_0039_107259.jpg,500,333,114.Black_throated_Sparrow,16,58,422,277,219,167,406,219
../../CUB_200_2011/images\114.Black_throated_Sparrow/Black_Throated_Sparrow_0013_107005.jpg,500,409,114.Black_throated_Sparrow,174,45,499,399,336,222,325,354
../../CUB_200_2011/images\115.Brewer_Sparrow/Brewer_Sparrow_0034_796693.jpg,500,400,115.Brewer_Sparrow,107,105,482,329,294,217,375,224
../../CUB_200_2011/images\115.Brewer_Sparrow/Brewer_Sparrow_0053_796694.jpg,500,333,115.Brewer_Sparrow,157,23,484,317,320,170,327,294
../../CUB_200_2011/images\115.Brewer_Sparrow/Brewer_Sparrow_0046_796696.jpg,500,375,115.Brewer_Sparrow,159,85,329,307,244,196,170,222
../../CUB_200_2011/images\115.Brewer_Sparrow/Brewer_Sparrow_0020_796697.jpg,200,179,115.Brewer_Sparrow,45,19,180,165,112,92,135,146
../../CUB_200_2011/images\115.Brewer_Sparrow/Brewer_Sparrow_0044_796698.jpg,500,333,115.Brewer_Sparrow,224,86,388,236,306,161,164,150
../../CUB_200_2011/images\115.Brewer_Sparrow/Brewer_Sparrow_0029_796699.jpg,500,375,115.Brewer_Sparrow,210,79,375,274,292,176,165,195
../../CUB_200_2011/images\115.Brewer_Sparrow/Brewer_Sparrow_0007_796700.jpg,272,182,115.Brewer_Sparrow,11,59,193,161,102,110,182,102
../../CUB_200_2011/images\115.Brewer_Sparrow/Brewer_Sparrow_0058_796701.jpg,350,329,115.Brewer_Sparrow,9,127,346,265,177,196,337,138
../../CUB_200_2011/images\115.Brewer_Sparrow/Brewer_Sparrow_0032_796702.jpg,367,500,115.Brewer_Sparrow,43,52,244,446,143,249,201,394
../../CUB_200_2011/images\115.Brewer_Sparrow/Brewer_Sparrow_0008_796703.jpg,500,380,115.Brewer_Sparrow,129,54,473,329,301,191,344,275
../../CUB_200_2011/images\115.Brewer_Sparrow/Brewer_Sparrow_0049_796705.jpg,359,315,115.Brewer_Sparrow,129,116,285,238,207,177,156,122
../../CUB_200_2011/images\115.Brewer_Sparrow/Brewer_Sparrow_0011_796708.jpg,500,375,115.Brewer_Sparrow,88,87,283,340,185,213,195,253
../../CUB_200_2011/images\115.Brewer_Sparrow/Brewer_Sparrow_0069_796709.jpg,459,500,115.Brewer_Sparrow,195,130,308,339,251,234,113,209
../../CUB_200_2011/images\115.Brewer_Sparrow/Brewer_Sparrow_0051_796710.jpg,423,500,115.Brewer_Sparrow,48,125,315,423,181,274,267,298
../../CUB_200_2011/images\115.Brewer_Sparrow/Brewer_Sparrow_0041_796711.jpg,500,400,115.Brewer_Sparrow,19,117,313,329,166,223,294,212
../../CUB_200_2011/images\115.Brewer_Sparrow/Brewer_Sparrow_0031_796712.jpg,413,500,115.Brewer_Sparrow,48,74,294,466,171,270,246,392
../../CUB_200_2011/images\115.Brewer_Sparrow/Brewer_Sparrow_0027_796713.jpg,500,379,115.Brewer_Sparrow,44,67,418,321,231,194,374,254
../../CUB_200_2011/images\115.Brewer_Sparrow/Brewer_Sparrow_0063_796714.jpg,500,334,115.Brewer_Sparrow,197,31,338,284,267,157,141,253
../../CUB_200_2011/images\115.Brewer_Sparrow/Brewer_Sparrow_0072_796715.jpg,400,500,115.Brewer_Sparrow,16,163,292,481,154,322,276,318
../../CUB_200_2011/images\115.Brewer_Sparrow/Brewer_Sparrow_0010_796716.jpg,150,150,115.Brewer_Sparrow,0,8,143,150,71,79,143,142
../../CUB_200_2011/images\115.Brewer_Sparrow/Brewer_Sparrow_0070_796717.jpg,500,333,115.Brewer_Sparrow,150,99,326,277,238,188,176,178
../../CUB_200_2011/images\115.Brewer_Sparrow/Brewer_Sparrow_0001_796718.jpg,341,500,115.Brewer_Sparrow,62,154,251,436,156,295,189,282
../../CUB_200_2011/images\115.Brewer_Sparrow/Brewer_Sparrow_0055_796720.jpg,500,375,115.Brewer_Sparrow,90,71,495,290,292,180,405,219
../../CUB_200_2011/images\115.Brewer_Sparrow/Brewer_Sparrow_0042_796721.jpg,500,375,115.Brewer_Sparrow,187,95,365,315,276,205,178,220
../../CUB_200_2011/images\115.Brewer_Sparrow/Brewer_Sparrow_0060_107391.jpg,500,347,115.Brewer_Sparrow,12,113,298,291,155,202,286,178
../../CUB_200_2011/images\115.Brewer_Sparrow/Brewer_Sparrow_0076_107393.jpg,333,500,115.Brewer_Sparrow,194,210,297,448,245,329,103,238
../../CUB_200_2011/images\115.Brewer_Sparrow/Brewer_Sparrow_0074_107408.jpg,375,500,115.Brewer_Sparrow,124,139,298,358,211,248,174,219
../../CUB_200_2011/images\115.Brewer_Sparrow/Brewer_Sparrow_0012_107411.jpg,500,335,115.Brewer_Sparrow,177,90,303,333,240,211,126,243
../../CUB_200_2011/images\115.Brewer_Sparrow/Brewer_Sparrow_0065_107419.jpg,500,333,115.Brewer_Sparrow,86,47,353,267,219,157,267,220
../../CUB_200_2011/images\115.Brewer_Sparrow/Brewer_Sparrow_0068_107422.jpg,390,500,115.Brewer_Sparrow,137,282,259,453,198,367,122,171
../../CUB_200_2011/images\115.Brewer_Sparrow/Brewer_Sparrow_0047_107428.jpg,500,421,115.Brewer_Sparrow,152,76,446,246,299,161,294,170
../../CUB_200_2011/images\115.Brewer_Sparrow/Brewer_Sparrow_0039_107431.jpg,500,325,115.Brewer_Sparrow,112,14,421,311,266,162,309,297
../../CUB_200_2011/images\115.Brewer_Sparrow/Brewer_Sparrow_0026_107432.jpg,477,500,115.Brewer_Sparrow,154,142,370,455,262,298,216,313
../../CUB_200_2011/images\115.Brewer_Sparrow/Brewer_Sparrow_0014_107435.jpg,500,348,115.Brewer_Sparrow,152,54,366,280,259,167,214,226
../../CUB_200_2011/images\115.Brewer_Sparrow/Brewer_Sparrow_0018_107437.jpg,335,500,115.Brewer_Sparrow,106,129,264,308,185,218,158,179
../../CUB_200_2011/images\115.Brewer_Sparrow/Brewer_Sparrow_0061_107438.jpg,500,386,115.Brewer_Sparrow,204,47,307,227,255,137,103,180
../../CUB_200_2011/images\115.Brewer_Sparrow/Brewer_Sparrow_0024_107439.jpg,394,500,115.Brewer_Sparrow,22,70,362,501,192,285,340,431
../../CUB_200_2011/images\115.Brewer_Sparrow/Brewer_Sparrow_0022_107440.jpg,405,500,115.Brewer_Sparrow,149,136,297,442,223,289,148,306
../../CUB_200_2011/images\115.Brewer_Sparrow/Brewer_Sparrow_0037_107442.jpg,500,333,115.Brewer_Sparrow,85,47,350,265,217,156,265,218
../../CUB_200_2011/images\115.Brewer_Sparrow/Brewer_Sparrow_0005_107443.jpg,500,500,115.Brewer_Sparrow,164,108,318,433,241,270,154,325
../../CUB_200_2011/images\115.Brewer_Sparrow/Brewer_Sparrow_0071_107446.jpg,490,500,115.Brewer_Sparrow,92,141,237,354,164,247,145,213
../../CUB_200_2011/images\115.Brewer_Sparrow/Brewer_Sparrow_0036_107451.jpg,500,333,115.Brewer_Sparrow,51,25,480,255,265,140,429,230
../../CUB_200_2011/images\115.Brewer_Sparrow/Brewer_Sparrow_0019_107452.jpg,500,333,115.Brewer_Sparrow,66,35,316,233,191,134,250,198
../../CUB_200_2011/images\115.Brewer_Sparrow/Brewer_Sparrow_0062_107456.jpg,500,375,115.Brewer_Sparrow,95,138,394,260,244,199,299,122
../../CUB_200_2011/images\115.Brewer_Sparrow/Brewer_Sparrow_0056_107458.jpg,420,280,115.Brewer_Sparrow,134,16,358,260,246,138,224,244
../../CUB_200_2011/images\115.Brewer_Sparrow/Brewer_Sparrow_0003_107459.jpg,500,333,115.Brewer_Sparrow,34,94,257,247,145,170,223,153
../../CUB_200_2011/images\115.Brewer_Sparrow/Brewer_Sparrow_0050_107460.jpg,356,500,115.Brewer_Sparrow,94,97,323,389,208,243,229,292
../../CUB_200_2011/images\115.Brewer_Sparrow/Brewer_Sparrow_0006_107463.jpg,375,500,115.Brewer_Sparrow,118,150,257,336,187,243,139,186
../../CUB_200_2011/images\115.Brewer_Sparrow/Brewer_Sparrow_0028_107467.jpg,500,343,115.Brewer_Sparrow,83,98,356,241,219,169,273,143
../../CUB_200_2011/images\115.Brewer_Sparrow/Brewer_Sparrow_0052_107478.jpg,333,500,115.Brewer_Sparrow,82,168,191,338,136,253,109,170
../../CUB_200_2011/images\115.Brewer_Sparrow/Brewer_Sparrow_0043_107479.jpg,500,333,115.Brewer_Sparrow,60,42,270,310,165,176,210,268
../../CUB_200_2011/images\115.Brewer_Sparrow/Brewer_Sparrow_0067_107480.jpg,350,279,115.Brewer_Sparrow,115,84,261,230,188,157,146,146
../../CUB_200_2011/images\115.Brewer_Sparrow/Brewer_Sparrow_0009_107481.jpg,500,375,115.Brewer_Sparrow,125,102,468,373,296,237,343,271
../../CUB_200_2011/images\115.Brewer_Sparrow/Brewer_Sparrow_0023_107489.jpg,500,401,115.Brewer_Sparrow,191,78,299,334,245,206,108,256
../../CUB_200_2011/images\115.Brewer_Sparrow/Brewer_Sparrow_0004_107496.jpg,500,333,115.Brewer_Sparrow,224,118,367,281,295,199,143,163
../../CUB_200_2011/images\115.Brewer_Sparrow/Brewer_Sparrow_0064_107502.jpg,333,500,115.Brewer_Sparrow,39,121,218,497,128,309,179,376
../../CUB_200_2011/images\115.Brewer_Sparrow/Brewer_Sparrow_0035_107509.jpg,500,432,115.Brewer_Sparrow,133,93,262,379,197,236,129,286
../../CUB_200_2011/images\115.Brewer_Sparrow/Brewer_Sparrow_0066_107510.jpg,500,333,115.Brewer_Sparrow,187,85,371,286,279,185,184,201
../../CUB_200_2011/images\115.Brewer_Sparrow/Brewer_Sparrow_0073_107518.jpg,500,354,115.Brewer_Sparrow,90,65,324,310,207,187,234,245
../../CUB_200_2011/images\116.Chipping_Sparrow/Chipping_Sparrow_0033_109069.jpg,500,375,116.Chipping_Sparrow,253,85,416,225,334,155,163,140
../../CUB_200_2011/images\116.Chipping_Sparrow/Chipping_Sparrow_0089_107535.jpg,500,419,116.Chipping_Sparrow,153,137,284,312,218,224,131,175
../../CUB_200_2011/images\116.Chipping_Sparrow/Chipping_Sparrow_0066_109187.jpg,500,357,116.Chipping_Sparrow,135,104,318,253,226,178,183,149
../../CUB_200_2011/images\116.Chipping_Sparrow/Chipping_Sparrow_0021_109588.jpg,500,399,116.Chipping_Sparrow,184,134,369,301,276,217,185,167
../../CUB_200_2011/images\116.Chipping_Sparrow/Chipping_Sparrow_0015_108462.jpg,500,331,116.Chipping_Sparrow,145,75,278,191,211,133,133,116
../../CUB_200_2011/images\116.Chipping_Sparrow/Chipping_Sparrow_0096_109853.jpg,500,364,116.Chipping_Sparrow,46,100,271,260,158,180,225,160
../../CUB_200_2011/images\116.Chipping_Sparrow/Chipping_Sparrow_0017_107552.jpg,458,500,116.Chipping_Sparrow,169,48,392,481,280,264,223,433
../../CUB_200_2011/images\116.Chipping_Sparrow/Chipping_Sparrow_0008_107810.jpg,500,357,116.Chipping_Sparrow,208,134,441,281,324,207,233,147
../../CUB_200_2011/images\116.Chipping_Sparrow/Chipping_Sparrow_0022_107825.jpg,500,400,116.Chipping_Sparrow,141,99,312,293,226,196,171,194
../../CUB_200_2011/images\116.Chipping_Sparrow/Chipping_Sparrow_0088_107562.jpg,405,500,116.Chipping_Sparrow,93,105,300,476,196,290,207,371
../../CUB_200_2011/images\116.Chipping_Sparrow/Chipping_Sparrow_0018_108295.jpg,500,376,116.Chipping_Sparrow,189,165,379,324,284,244,190,159
../../CUB_200_2011/images\116.Chipping_Sparrow/Chipping_Sparrow_0011_108081.jpg,500,333,116.Chipping_Sparrow,55,103,340,269,197,186,285,166
../../CUB_200_2011/images\116.Chipping_Sparrow/Chipping_Sparrow_0052_109874.jpg,500,366,116.Chipping_Sparrow,2,32,405,347,203,189,403,315
../../CUB_200_2011/images\116.Chipping_Sparrow/Chipping_Sparrow_0061_109113.jpg,374,500,116.Chipping_Sparrow,104,117,242,440,173,278,138,323
../../CUB_200_2011/images\116.Chipping_Sparrow/Chipping_Sparrow_0035_110138.jpg,500,351,116.Chipping_Sparrow,133,24,426,318,279,171,293,294
../../CUB_200_2011/images\116.Chipping_Sparrow/Chipping_Sparrow_0075_108348.jpg,500,333,116.Chipping_Sparrow,0,1,409,321,204,161,409,320
../../CUB_200_2011/images\116.Chipping_Sparrow/Chipping_Sparrow_0006_107849.jpg,333,500,116.Chipping_Sparrow,152,170,291,310,221,240,139,140
../../CUB_200_2011/images\116.Chipping_Sparrow/Chipping_Sparrow_0073_108881.jpg,500,375,116.Chipping_Sparrow,127,14,303,371,215,192,176,357
../../CUB_200_2011/images\116.Chipping_Sparrow/Chipping_Sparrow_0041_108370.jpg,400,296,116.Chipping_Sparrow,2,39,253,243,127,141,251,204
../../CUB_200_2011/images\116.Chipping_Sparrow/Chipping_Sparrow_0039_107864.jpg,327,500,116.Chipping_Sparrow,68,51,271,493,169,272,203,442
../../CUB_200_2011/images\116.Chipping_Sparrow/Chipping_Sparrow_0042_107791.jpg,500,376,116.Chipping_Sparrow,206,106,329,242,267,174,123,136
../../CUB_200_2011/images\116.Chipping_Sparrow/Chipping_Sparrow_0001_108638.jpg,500,344,116.Chipping_Sparrow,153,100,463,244,308,172,310,144
../../CUB_200_2011/images\116.Chipping_Sparrow/Chipping_Sparrow_0098_108644.jpg,500,328,116.Chipping_Sparrow,135,60,326,203,230,131,191,143
../../CUB_200_2011/images\116.Chipping_Sparrow/Chipping_Sparrow_0062_110187.jpg,500,386,116.Chipping_Sparrow,253,82,383,342,318,212,130,260
../../CUB_200_2011/images\116.Chipping_Sparrow/Chipping_Sparrow_0025_108653.jpg,500,347,116.Chipping_Sparrow,164,86,400,253,282,169,236,167
../../CUB_200_2011/images\116.Chipping_Sparrow/Chipping_Sparrow_0079_110449.jpg,500,375,116.Chipping_Sparrow,102,135,350,253,226,194,248,118
../../CUB_200_2011/images\116.Chipping_Sparrow/Chipping_Sparrow_0076_108919.jpg,500,333,116.Chipping_Sparrow,163,91,401,235,282,163,238,144
../../CUB_200_2011/images\116.Chipping_Sparrow/Chipping_Sparrow_0091_108308.jpg,500,342,116.Chipping_Sparrow,18,131,245,322,131,226,227,191
../../CUB_200_2011/images\116.Chipping_Sparrow/Chipping_Sparrow_0090_14718.jpg,466,500,116.Chipping_Sparrow,157,132,328,425,242,278,171,293
../../CUB_200_2011/images\116.Chipping_Sparrow/Chipping_Sparrow_0109_108162.jpg,500,369,116.Chipping_Sparrow,207,100,433,328,320,214,226,228
../../CUB_200_2011/images\116.Chipping_Sparrow/Chipping_Sparrow_0024_109445.jpg,500,333,116.Chipping_Sparrow,180,70,371,317,275,193,191,247
../../CUB_200_2011/images\116.Chipping_Sparrow/Chipping_Sparrow_0023_108684.jpg,423,500,116.Chipping_Sparrow,116,129,360,360,238,244,244,231
../../CUB_200_2011/images\116.Chipping_Sparrow/Chipping_Sparrow_0080_108685.jpg,500,400,116.Chipping_Sparrow,258,67,423,233,340,150,165,166
../../CUB_200_2011/images\116.Chipping_Sparrow/Chipping_Sparrow_0004_108430.jpg,500,454,116.Chipping_Sparrow,130,83,440,413,285,248,310,330
../../CUB_200_2011/images\116.Chipping_Sparrow/Chipping_Sparrow_0050_108441.jpg,333,500,116.Chipping_Sparrow,85,186,328,430,206,308,243,244
../../CUB_200_2011/images\116.Chipping_Sparrow/Chipping_Sparrow_0097_107678.jpg,344,500,116.Chipping_Sparrow,105,134,281,432,193,283,176,298
../../CUB_200_2011/images\116.Chipping_Sparrow/Chipping_Sparrow_0037_109851.jpg,375,500,116.Chipping_Sparrow,85,129,313,436,199,282,228,307
../../CUB_200_2011/images\116.Chipping_Sparrow/Chipping_Sparrow_0074_108401.jpg,359,500,116.Chipping_Sparrow,59,68,301,449,180,258,242,381
../../CUB_200_2011/images\116.Chipping_Sparrow/Chipping_Sparrow_0064_108204.jpg,500,333,116.Chipping_Sparrow,97,76,333,292,215,184,236,216
../../CUB_200_2011/images\116.Chipping_Sparrow/Chipping_Sparrow_0030_109741.jpg,500,382,116.Chipping_Sparrow,54,79,448,333,251,206,394,254
../../CUB_200_2011/images\116.Chipping_Sparrow/Chipping_Sparrow_0110_108974.jpg,500,351,116.Chipping_Sparrow,21,34,333,309,177,171,312,275
../../CUB_200_2011/images\116.Chipping_Sparrow/Chipping_Sparrow_0036_107695.jpg,500,334,116.Chipping_Sparrow,137,89,376,277,256,183,239,188
../../CUB_200_2011/images\116.Chipping_Sparrow/Chipping_Sparrow_0038_109234.jpg,500,358,116.Chipping_Sparrow,47,126,308,274,177,200,261,148
../../CUB_200_2011/images\116.Chipping_Sparrow/Chipping_Sparrow_0071_108735.jpg,500,333,116.Chipping_Sparrow,267,29,417,262,342,145,150,233
../../CUB_200_2011/images\116.Chipping_Sparrow/Chipping_Sparrow_0010_109760.jpg,500,375,116.Chipping_Sparrow,196,146,339,276,267,211,143,130
../../CUB_200_2011/images\116.Chipping_Sparrow/Chipping_Sparrow_0012_108576.jpg,500,423,116.Chipping_Sparrow,16,152,380,334,198,243,364,182
../../CUB_200_2011/images\116.Chipping_Sparrow/Chipping_Sparrow_0085_109506.jpg,500,333,116.Chipping_Sparrow,223,126,461,271,342,198,238,145
../../CUB_200_2011/images\116.Chipping_Sparrow/Chipping_Sparrow_0063_108139.jpg,500,443,116.Chipping_Sparrow,44,101,415,370,229,235,371,269
../../CUB_200_2011/images\116.Chipping_Sparrow/Chipping_Sparrow_0043_109509.jpg,500,346,116.Chipping_Sparrow,188,118,307,276,247,197,119,158
../../CUB_200_2011/images\116.Chipping_Sparrow/Chipping_Sparrow_0045_109985.jpg,500,357,116.Chipping_Sparrow,155,47,399,296,277,171,244,249
../../CUB_200_2011/images\116.Chipping_Sparrow/Chipping_Sparrow_0053_109774.jpg,500,334,116.Chipping_Sparrow,234,103,352,245,293,174,118,142
../../CUB_200_2011/images\116.Chipping_Sparrow/Chipping_Sparrow_0103_109529.jpg,500,375,116.Chipping_Sparrow,185,126,360,305,272,215,175,179
../../CUB_200_2011/images\116.Chipping_Sparrow/Chipping_Sparrow_0086_109022.jpg,500,375,116.Chipping_Sparrow,168,145,442,306,305,225,274,161
../../CUB_200_2011/images\116.Chipping_Sparrow/Chipping_Sparrow_0111_108515.jpg,500,402,116.Chipping_Sparrow,168,69,444,352,306,210,276,283
../../CUB_200_2011/images\116.Chipping_Sparrow/Chipping_Sparrow_0005_108931.jpg,500,446,116.Chipping_Sparrow,149,91,289,288,219,189,140,197
../../CUB_200_2011/images\116.Chipping_Sparrow/Chipping_Sparrow_0032_108882.jpg,500,467,116.Chipping_Sparrow,0,52,441,465,220,258,441,413
../../CUB_200_2011/images\116.Chipping_Sparrow/Chipping_Sparrow_0026_109010.jpg,500,333,116.Chipping_Sparrow,79,76,262,264,170,170,183,188
../../CUB_200_2011/images\116.Chipping_Sparrow/Chipping_Sparrow_0067_107508.jpg,500,330,116.Chipping_Sparrow,217,125,384,226,300,175,167,101
../../CUB_200_2011/images\116.Chipping_Sparrow/Chipping_Sparrow_0070_108281.jpg,485,445,116.Chipping_Sparrow,81,122,288,303,184,212,207,181
../../CUB_200_2011/images\116.Chipping_Sparrow/Chipping_Sparrow_0016_109051.jpg,500,333,116.Chipping_Sparrow,260,156,461,305,360,230,201,149
../../CUB_200_2011/images\117.Clay_colored_Sparrow/Clay_Colored_Sparrow_0056_110848.jpg,500,468,117.Clay_colored_Sparrow,111,134,336,352,223,243,225,218
../../CUB_200_2011/images\117.Clay_colored_Sparrow/Clay_Colored_Sparrow_0072_110851.jpg,500,337,117.Clay_colored_Sparrow,223,96,377,311,300,203,154,215
../../CUB_200_2011/images\117.Clay_colored_Sparrow/Clay_Colored_Sparrow_0002_110606.jpg,500,361,117.Clay_colored_Sparrow,17,113,371,352,194,232,354,239
../../CUB_200_2011/images\117.Clay_colored_Sparrow/Clay_Colored_Sparrow_0078_110912.jpg,500,356,117.Clay_colored_Sparrow,280,130,476,288,378,209,196,158
../../CUB_200_2011/images\117.Clay_colored_Sparrow/Clay_Colored_Sparrow_0020_110609.jpg,500,344,117.Clay_colored_Sparrow,115,47,437,324,276,185,322,277
../../CUB_200_2011/images\117.Clay_colored_Sparrow/Clay_Colored_Sparrow_0001_110632.jpg,400,337,117.Clay_colored_Sparrow,111,106,327,294,219,200,216,188
../../CUB_200_2011/images\117.Clay_colored_Sparrow/Clay_Colored_Sparrow_0095_110635.jpg,500,374,117.Clay_colored_Sparrow,49,71,344,266,196,168,295,195
../../CUB_200_2011/images\117.Clay_colored_Sparrow/Clay_Colored_Sparrow_0055_110647.jpg,234,203,117.Clay_colored_Sparrow,29,32,152,172,90,102,123,140
../../CUB_200_2011/images\117.Clay_colored_Sparrow/Clay_Colored_Sparrow_0028_797241.jpg,500,333,117.Clay_colored_Sparrow,214,64,410,304,312,184,196,240
../../CUB_200_2011/images\117.Clay_colored_Sparrow/Clay_Colored_Sparrow_0042_797243.jpg,288,204,117.Clay_colored_Sparrow,71,40,189,145,130,92,118,105
../../CUB_200_2011/images\117.Clay_colored_Sparrow/Clay_Colored_Sparrow_0048_110653.jpg,500,375,117.Clay_colored_Sparrow,161,133,329,287,245,210,168,154
../../CUB_200_2011/images\117.Clay_colored_Sparrow/Clay_Colored_Sparrow_0018_797246.jpg,400,325,117.Clay_colored_Sparrow,11,105,361,261,186,183,350,156
../../CUB_200_2011/images\117.Clay_colored_Sparrow/Clay_Colored_Sparrow_0106_797247.jpg,500,429,117.Clay_colored_Sparrow,49,26,424,408,236,217,375,382
../../CUB_200_2011/images\117.Clay_colored_Sparrow/Clay_Colored_Sparrow_0071_110656.jpg,456,500,117.Clay_colored_Sparrow,164,110,370,338,267,224,206,228
../../CUB_200_2011/images\117.Clay_colored_Sparrow/Clay_Colored_Sparrow_0094_797250.jpg,400,400,117.Clay_colored_Sparrow,9,89,392,382,200,235,383,293
../../CUB_200_2011/images\117.Clay_colored_Sparrow/Clay_Colored_Sparrow_0075_797251.jpg,500,354,117.Clay_colored_Sparrow,84,81,397,251,240,166,313,170
../../CUB_200_2011/images\117.Clay_colored_Sparrow/Clay_Colored_Sparrow_0034_797252.jpg,500,375,117.Clay_colored_Sparrow,71,115,402,301,236,208,331,186
../../CUB_200_2011/images\117.Clay_colored_Sparrow/Clay_Colored_Sparrow_0080_797253.jpg,500,333,117.Clay_colored_Sparrow,122,33,269,281,195,157,147,248
../../CUB_200_2011/images\117.Clay_colored_Sparrow/Clay_Colored_Sparrow_0064_110664.jpg,500,400,117.Clay_colored_Sparrow,102,69,397,315,249,192,295,246
../../CUB_200_2011/images\117.Clay_colored_Sparrow/Clay_Colored_Sparrow_0023_797258.jpg,500,361,117.Clay_colored_Sparrow,49,81,292,304,170,192,243,223
../../CUB_200_2011/images\117.Clay_colored_Sparrow/Clay_Colored_Sparrow_0085_797260.jpg,500,418,117.Clay_colored_Sparrow,192,90,428,361,310,225,236,271
../../CUB_200_2011/images\117.Clay_colored_Sparrow/Clay_Colored_Sparrow_0090_110669.jpg,500,364,117.Clay_colored_Sparrow,133,61,471,326,302,193,338,265
../../CUB_200_2011/images\117.Clay_colored_Sparrow/Clay_Colored_Sparrow_0010_797262.jpg,404,500,117.Clay_colored_Sparrow,109,103,391,340,250,221,282,237
../../CUB_200_2011/images\117.Clay_colored_Sparrow/Clay_Colored_Sparrow_0003_110672.jpg,500,500,117.Clay_colored_Sparrow,150,107,333,440,241,273,183,333
../../CUB_200_2011/images\117.Clay_colored_Sparrow/Clay_Colored_Sparrow_0093_110677.jpg,500,353,117.Clay_colored_Sparrow,57,121,392,280,224,200,335,159
../../CUB_200_2011/images\117.Clay_colored_Sparrow/Clay_Colored_Sparrow_0081_110682.jpg,500,333,117.Clay_colored_Sparrow,77,60,476,310,276,185,399,250
../../CUB_200_2011/images\117.Clay_colored_Sparrow/Clay_Colored_Sparrow_0043_110685.jpg,500,371,117.Clay_colored_Sparrow,193,98,444,280,318,189,251,182
../../CUB_200_2011/images\117.Clay_colored_Sparrow/Clay_Colored_Sparrow_0044_110942.jpg,500,356,117.Clay_colored_Sparrow,193,105,374,219,283,162,181,114
../../CUB_200_2011/images\117.Clay_colored_Sparrow/Clay_Colored_Sparrow_0087_110946.jpg,500,338,117.Clay_colored_Sparrow,190,101,336,260,263,180,146,159
../../CUB_200_2011/images\117.Clay_colored_Sparrow/Clay_Colored_Sparrow_0054_110948.jpg,366,500,117.Clay_colored_Sparrow,60,232,313,434,186,333,253,202
../../CUB_200_2011/images\117.Clay_colored_Sparrow/Clay_Colored_Sparrow_0062_110908.jpg,280,286,117.Clay_colored_Sparrow,70,42,194,235,132,138,124,193
../../CUB_200_2011/images\117.Clay_colored_Sparrow/Clay_Colored_Sparrow_0104_110699.jpg,500,333,117.Clay_colored_Sparrow,103,63,312,314,207,188,209,251
../../CUB_200_2011/images\117.Clay_colored_Sparrow/Clay_Colored_Sparrow_0068_110706.jpg,500,389,117.Clay_colored_Sparrow,18,155,307,329,162,242,289,174
../../CUB_200_2011/images\117.Clay_colored_Sparrow/Clay_Colored_Sparrow_0099_110561.jpg,500,457,117.Clay_colored_Sparrow,21,23,476,449,248,236,455,426
../../CUB_200_2011/images\117.Clay_colored_Sparrow/Clay_Colored_Sparrow_0040_110717.jpg,500,318,117.Clay_colored_Sparrow,41,86,322,249,181,167,281,163
../../CUB_200_2011/images\117.Clay_colored_Sparrow/Clay_Colored_Sparrow_0073_110718.jpg,500,333,117.Clay_colored_Sparrow,17,20,484,302,250,161,467,282
../../CUB_200_2011/images\117.Clay_colored_Sparrow/Clay_Colored_Sparrow_0029_110720.jpg,500,500,117.Clay_colored_Sparrow,40,139,337,414,188,276,297,275
../../CUB_200_2011/images\117.Clay_colored_Sparrow/Clay_Colored_Sparrow_0041_110726.jpg,327,500,117.Clay_colored_Sparrow,111,231,326,378,218,304,215,147
../../CUB_200_2011/images\117.Clay_colored_Sparrow/Clay_Colored_Sparrow_0046_110728.jpg,500,309,117.Clay_colored_Sparrow,76,34,253,243,164,138,177,209
../../CUB_200_2011/images\117.Clay_colored_Sparrow/Clay_Colored_Sparrow_0083_110734.jpg,375,500,117.Clay_colored_Sparrow,54,71,216,316,135,193,162,245
../../CUB_200_2011/images\117.Clay_colored_Sparrow/Clay_Colored_Sparrow_0098_110735.jpg,328,462,117.Clay_colored_Sparrow,13,174,326,299,169,236,313,125
../../CUB_200_2011/images\117.Clay_colored_Sparrow/Clay_Colored_Sparrow_0049_110736.jpg,500,380,117.Clay_colored_Sparrow,122,140,403,283,262,211,281,143
../../CUB_200_2011/images\117.Clay_colored_Sparrow/Clay_Colored_Sparrow_0033_797255.jpg,330,480,117.Clay_colored_Sparrow,90,52,300,421,195,236,210,369
../../CUB_200_2011/images\117.Clay_colored_Sparrow/Clay_Colored_Sparrow_0091_110768.jpg,500,365,117.Clay_colored_Sparrow,79,127,324,294,201,210,245,167
../../CUB_200_2011/images\117.Clay_colored_Sparrow/Clay_Colored_Sparrow_0031_110769.jpg,500,450,117.Clay_colored_Sparrow,176,132,322,353,249,242,146,221
../../CUB_200_2011/images\117.Clay_colored_Sparrow/Clay_Colored_Sparrow_0097_110516.jpg,500,362,117.Clay_colored_Sparrow,0,44,476,303,238,173,476,259
../../CUB_200_2011/images\117.Clay_colored_Sparrow/Clay_Colored_Sparrow_0026_110774.jpg,500,363,117.Clay_colored_Sparrow,287,93,393,290,340,191,106,197
../../CUB_200_2011/images\117.Clay_colored_Sparrow/Clay_Colored_Sparrow_0009_797256.jpg,383,500,117.Clay_colored_Sparrow,114,74,280,454,197,264,166,380
../../CUB_200_2011/images\117.Clay_colored_Sparrow/Clay_Colored_Sparrow_0036_110924.jpg,469,500,117.Clay_colored_Sparrow,121,120,289,406,205,263,168,286
../../CUB_200_2011/images\117.Clay_colored_Sparrow/Clay_Colored_Sparrow_0038_110799.jpg,348,500,117.Clay_colored_Sparrow,14,56,291,304,152,180,277,248
../../CUB_200_2011/images\117.Clay_colored_Sparrow/Clay_Colored_Sparrow_0100_110545.jpg,500,375,117.Clay_colored_Sparrow,102,61,456,300,279,180,354,239
../../CUB_200_2011/images\117.Clay_colored_Sparrow/Clay_Colored_Sparrow_0022_110518.jpg,333,500,117.Clay_colored_Sparrow,10,97,251,353,130,225,241,256
../../CUB_200_2011/images\117.Clay_colored_Sparrow/Clay_Colored_Sparrow_0014_797248.jpg,500,500,117.Clay_colored_Sparrow,133,105,475,447,304,276,342,342
../../CUB_200_2011/images\117.Clay_colored_Sparrow/Clay_Colored_Sparrow_0066_110819.jpg,500,375,117.Clay_colored_Sparrow,134,67,413,375,273,221,279,308
../../CUB_200_2011/images\117.Clay_colored_Sparrow/Clay_Colored_Sparrow_0107_110825.jpg,500,373,117.Clay_colored_Sparrow,166,108,299,227,232,167,133,119
../../CUB_200_2011/images\117.Clay_colored_Sparrow/Clay_Colored_Sparrow_0061_110830.jpg,400,500,117.Clay_colored_Sparrow,91,83,283,368,187,225,192,285
../../CUB_200_2011/images\117.Clay_colored_Sparrow/Clay_Colored_Sparrow_0005_110911.jpg,500,448,117.Clay_colored_Sparrow,200,148,406,319,303,233,206,171
../../CUB_200_2011/images\117.Clay_colored_Sparrow/Clay_Colored_Sparrow_0105_110547.jpg,500,334,117.Clay_colored_Sparrow,272,72,424,279,348,175,152,207
../../CUB_200_2011/images\117.Clay_colored_Sparrow/Clay_Colored_Sparrow_0008_110536.jpg,333,500,117.Clay_colored_Sparrow,51,109,285,313,168,211,234,204
../../CUB_200_2011/images\118.House_Sparrow/House_Sparrow_0134_112644.jpg,500,336,118.House_Sparrow,6,90,365,293,185,191,359,203
../../CUB_200_2011/images\118.House_Sparrow/House_Sparrow_0019_112645.jpg,500,375,118.House_Sparrow,201,66,400,282,300,174,199,216
../../CUB_200_2011/images\118.House_Sparrow/House_Sparrow_0125_111130.jpg,500,400,118.House_Sparrow,139,98,435,341,287,219,296,243
../../CUB_200_2011/images\118.House_Sparrow/House_Sparrow_0121_113182.jpg,500,332,118.House_Sparrow,113,102,413,219,263,160,300,117
../../CUB_200_2011/images\118.House_Sparrow/House_Sparrow_0010_112678.jpg,500,333,118.House_Sparrow,177,36,428,290,302,163,251,254
../../CUB_200_2011/images\118.House_Sparrow/House_Sparrow_0025_111669.jpg,350,500,118.House_Sparrow,95,172,300,436,197,304,205,264
../../CUB_200_2011/images\118.House_Sparrow/House_Sparrow_0059_111164.jpg,500,378,118.House_Sparrow,145,134,412,296,278,215,267,162
../../CUB_200_2011/images\118.House_Sparrow/House_Sparrow_0144_113216.jpg,357,500,118.House_Sparrow,102,135,341,478,221,306,239,343
../../CUB_200_2011/images\118.House_Sparrow/House_Sparrow_0028_113217.jpg,500,333,118.House_Sparrow,184,66,427,328,305,197,243,262
../../CUB_200_2011/images\118.House_Sparrow/House_Sparrow_0041_112706.jpg,333,500,118.House_Sparrow,11,149,256,356,133,252,245,207
../../CUB_200_2011/images\118.House_Sparrow/House_Sparrow_0006_111034.jpg,500,331,118.House_Sparrow,0,89,388,256,194,172,388,167
../../CUB_200_2011/images\118.House_Sparrow/House_Sparrow_0068_113247.jpg,500,333,118.House_Sparrow,115,70,370,313,242,191,255,243
../../CUB_200_2011/images\118.House_Sparrow/House_Sparrow_0008_111204.jpg,500,365,118.House_Sparrow,200,82,494,345,347,213,294,263
../../CUB_200_2011/images\118.House_Sparrow/House_Sparrow_0073_112745.jpg,500,346,118.House_Sparrow,237,83,404,333,320,208,167,250
../../CUB_200_2011/images\118.House_Sparrow/House_Sparrow_0137_111219.jpg,500,372,118.House_Sparrow,113,62,388,314,250,188,275,252
../../CUB_200_2011/images\118.House_Sparrow/House_Sparrow_0052_112252.jpg,500,375,118.House_Sparrow,235,154,397,330,316,242,162,176
../../CUB_200_2011/images\118.House_Sparrow/House_Sparrow_0094_112773.jpg,483,500,118.House_Sparrow,116,119,393,388,254,253,277,269
../../CUB_200_2011/images\118.House_Sparrow/House_Sparrow_0079_113288.jpg,500,333,118.House_Sparrow,75,27,441,259,258,143,366,232
../../CUB_200_2011/images\118.House_Sparrow/House_Sparrow_0119_111471.jpg,500,338,118.House_Sparrow,74,81,259,240,166,160,185,159
../../CUB_200_2011/images\118.House_Sparrow/House_Sparrow_0084_111300.jpg,500,375,118.House_Sparrow,117,118,404,335,260,226,287,217
../../CUB_200_2011/images\118.House_Sparrow/House_Sparrow_0046_112845.jpg,500,333,118.House_Sparrow,36,38,278,302,157,170,242,264
../../CUB_200_2011/images\118.House_Sparrow/House_Sparrow_0036_112847.jpg,500,413,118.House_Sparrow,167,124,346,309,256,216,179,185
../../CUB_200_2011/images\118.House_Sparrow/House_Sparrow_0133_112368.jpg,500,380,118.House_Sparrow,54,76,380,276,217,176,326,200
../../CUB_200_2011/images\118.House_Sparrow/House_Sparrow_0080_111099.jpg,500,333,118.House_Sparrow,244,58,402,201,323,129,158,143
../../CUB_200_2011/images\118.House_Sparrow/House_Sparrow_0002_112905.jpg,500,281,118.House_Sparrow,104,31,396,200,250,115,292,169
../../CUB_200_2011/images\118.House_Sparrow/House_Sparrow_0067_112913.jpg,500,375,118.House_Sparrow,67,130,287,279,177,204,220,149
../../CUB_200_2011/images\118.House_Sparrow/House_Sparrow_0086_111385.jpg,500,334,118.House_Sparrow,26,57,332,308,179,182,306,251
../../CUB_200_2011/images\118.House_Sparrow/House_Sparrow_0030_111387.jpg,500,489,118.House_Sparrow,177,71,357,385,267,228,180,314
../../CUB_200_2011/images\118.House_Sparrow/House_Sparrow_0053_111388.jpg,500,333,118.House_Sparrow,152,62,400,274,276,168,248,212
../../CUB_200_2011/images\118.House_Sparrow/House_Sparrow_0055_111393.jpg,500,374,118.House_Sparrow,57,37,430,309,243,173,373,272
../../CUB_200_2011/images\118.House_Sparrow/House_Sparrow_0143_111400.jpg,500,295,118.House_Sparrow,172,62,301,251,236,156,129,189
../../CUB_200_2011/images\118.House_Sparrow/House_Sparrow_0145_112703.jpg,500,334,118.House_Sparrow,64,77,303,314,183,195,239,237
../../CUB_200_2011/images\118.House_Sparrow/House_Sparrow_0014_112947.jpg,500,426,118.House_Sparrow,32,26,452,372,242,199,420,346
../../CUB_200_2011/images\118.House_Sparrow/House_Sparrow_0015_111085.jpg,500,300,118.House_Sparrow,22,96,273,270,147,183,251,174
../../CUB_200_2011/images\118.House_Sparrow/House_Sparrow_0092_111413.jpg,500,376,118.House_Sparrow,112,52,382,324,247,188,270,272
../../CUB_200_2011/images\118.House_Sparrow/House_Sparrow_0139_112438.jpg,500,360,118.House_Sparrow,210,132,384,320,297,226,174,188
../../CUB_200_2011/images\118.House_Sparrow/House_Sparrow_0130_110985.jpg,500,333,118.House_Sparrow,209,25,389,212,299,118,180,187
../../CUB_200_2011/images\118.House_Sparrow/House_Sparrow_0127_111935.jpg,400,500,118.House_Sparrow,125,117,330,320,227,218,205,203
../../CUB_200_2011/images\118.House_Sparrow/House_Sparrow_0108_112963.jpg,500,333,118.House_Sparrow,137,77,365,277,251,177,228,200
../../CUB_200_2011/images\118.House_Sparrow/House_Sparrow_0111_112968.jpg,500,496,118.House_Sparrow,45,152,322,409,183,280,277,257
../../CUB_200_2011/images\118.House_Sparrow/House_Sparrow_0093_110990.jpg,500,334,118.House_Sparrow,184,96,475,298,329,197,291,202
../../CUB_200_2011/images\118.House_Sparrow/House_Sparrow_0082_112478.jpg,500,333,118.House_Sparrow,228,67,410,261,319,164,182,194
../../CUB_200_2011/images\118.House_Sparrow/House_Sparrow_0005_111967.jpg,500,332,118.House_Sparrow,24,43,484,297,254,170,460,254
../../CUB_200_2011/images\118.House_Sparrow/House_Sparrow_0063_111460.jpg,500,333,118.House_Sparrow,82,67,225,245,153,156,143,178
../../CUB_200_2011/images\118.House_Sparrow/House_Sparrow_0120_113001.jpg,500,333,118.House_Sparrow,113,40,489,303,301,171,376,263
../../CUB_200_2011/images\118.House_Sparrow/House_Sparrow_0083_111470.jpg,500,459,118.House_Sparrow,95,62,327,415,211,238,232,353
../../CUB_200_2011/images\118.House_Sparrow/House_Sparrow_0126_110959.jpg,500,346,118.House_Sparrow,296,81,444,300,370,190,148,219
../../CUB_200_2011/images\118.House_Sparrow/House_Sparrow_0004_111989.jpg,500,333,118.House_Sparrow,49,116,241,302,145,209,192,186
../../CUB_200_2011/images\118.House_Sparrow/House_Sparrow_0128_110971.jpg,500,375,118.House_Sparrow,74,87,274,358,174,222,200,271
../../CUB_200_2011/images\118.House_Sparrow/House_Sparrow_0074_111997.jpg,500,333,118.House_Sparrow,94,66,363,308,228,187,269,242
../../CUB_200_2011/images\118.House_Sparrow/House_Sparrow_0049_110976.jpg,500,348,118.House_Sparrow,166,79,375,271,270,175,209,192
../../CUB_200_2011/images\118.House_Sparrow/House_Sparrow_0096_111519.jpg,500,357,118.House_Sparrow,49,151,376,311,212,231,327,160
../../CUB_200_2011/images\118.House_Sparrow/House_Sparrow_0061_112795.jpg,394,500,118.House_Sparrow,16,88,288,364,152,226,272,276
../../CUB_200_2011/images\118.House_Sparrow/House_Sparrow_0007_111029.jpg,500,375,118.House_Sparrow,19,49,399,339,209,194,380,290
../../CUB_200_2011/images\118.House_Sparrow/House_Sparrow_0106_111564.jpg,500,354,118.House_Sparrow,117,59,430,267,273,163,313,208
../../CUB_200_2011/images\118.House_Sparrow/House_Sparrow_0033_112590.jpg,500,333,118.House_Sparrow,111,87,255,279,183,183,144,192
../../CUB_200_2011/images\118.House_Sparrow/House_Sparrow_0104_113105.jpg,500,373,118.House_Sparrow,116,5,499,372,307,188,383,367
../../CUB_200_2011/images\118.House_Sparrow/House_Sparrow_0098_111073.jpg,500,333,118.House_Sparrow,214,95,359,294,286,194,145,199
../../CUB_200_2011/images\118.House_Sparrow/House_Sparrow_0011_112099.jpg,469,500,118.House_Sparrow,48,171,386,397,217,284,338,226
../../CUB_200_2011/images\118.House_Sparrow/House_Sparrow_0050_111087.jpg,500,305,118.House_Sparrow,185,130,415,263,300,196,230,133
../../CUB_200_2011/images\119.Field_Sparrow/Field_Sparrow_0063_113667.jpg,500,333,119.Field_Sparrow,21,71,233,245,127,158,212,174
../../CUB_200_2011/images\119.Field_Sparrow/Field_Sparrow_0060_114177.jpg,500,333,119.Field_Sparrow,93,68,299,255,196,161,206,187
../../CUB_200_2011/images\119.Field_Sparrow/Field_Sparrow_0118_113416.jpg,500,400,119.Field_Sparrow,43,25,341,318,192,171,298,293
../../CUB_200_2011/images\119.Field_Sparrow/Field_Sparrow_0011_113420.jpg,500,333,119.Field_Sparrow,121,51,419,310,270,180,298,259
../../CUB_200_2011/images\119.Field_Sparrow/Field_Sparrow_0126_113426.jpg,500,413,119.Field_Sparrow,89,164,355,277,222,220,266,113
../../CUB_200_2011/images\119.Field_Sparrow/Field_Sparrow_0025_113683.jpg,500,333,119.Field_Sparrow,62,83,275,323,168,203,213,240
../../CUB_200_2011/images\119.Field_Sparrow/Field_Sparrow_0131_113582.jpg,500,375,119.Field_Sparrow,44,41,421,258,232,149,377,217
../../CUB_200_2011/images\119.Field_Sparrow/Field_Sparrow_0029_113434.jpg,500,335,119.Field_Sparrow,108,109,227,270,167,189,119,161
../../CUB_200_2011/images\119.Field_Sparrow/Field_Sparrow_0121_113455.jpg,500,304,119.Field_Sparrow,96,60,380,302,238,181,284,242
../../CUB_200_2011/images\119.Field_Sparrow/Field_Sparrow_0120_113953.jpg,500,333,119.Field_Sparrow,201,119,328,257,264,188,127,138
../../CUB_200_2011/images\119.Field_Sparrow/Field_Sparrow_0067_113448.jpg,500,340,119.Field_Sparrow,97,130,259,298,178,214,162,168
../../CUB_200_2011/images\119.Field_Sparrow/Field_Sparrow_0127_114087.jpg,500,400,119.Field_Sparrow,197,70,392,318,294,194,195,248
../../CUB_200_2011/images\119.Field_Sparrow/Field_Sparrow_0008_113459.jpg,334,500,119.Field_Sparrow,130,158,242,303,186,230,112,145
../../CUB_200_2011/images\119.Field_Sparrow/Field_Sparrow_0021_113461.jpg,471,500,119.Field_Sparrow,70,80,407,458,238,269,337,378
../../CUB_200_2011/images\119.Field_Sparrow/Field_Sparrow_0055_113929.jpg,453,500,119.Field_Sparrow,31,24,348,458,189,241,317,434
../../CUB_200_2011/images\119.Field_Sparrow/Field_Sparrow_0100_113503.jpg,464,432,119.Field_Sparrow,94,120,294,352,194,236,200,232
../../CUB_200_2011/images\119.Field_Sparrow/Field_Sparrow_0074_113504.jpg,500,500,119.Field_Sparrow,142,111,499,408,320,259,357,297
../../CUB_200_2011/images\119.Field_Sparrow/Field_Sparrow_0035_113479.jpg,500,400,119.Field_Sparrow,59,84,315,346,187,215,256,262
../../CUB_200_2011/images\119.Field_Sparrow/Field_Sparrow_0110_113995.jpg,439,435,119.Field_Sparrow,78,104,337,349,207,226,259,245
../../CUB_200_2011/images\119.Field_Sparrow/Field_Sparrow_0091_113486.jpg,379,500,119.Field_Sparrow,24,132,226,307,125,219,202,175
../../CUB_200_2011/images\119.Field_Sparrow/Field_Sparrow_0071_113747.jpg,500,364,119.Field_Sparrow,152,96,321,276,236,186,169,180
../../CUB_200_2011/images\119.Field_Sparrow/Field_Sparrow_0129_113748.jpg,500,340,119.Field_Sparrow,105,90,411,305,258,197,306,215
../../CUB_200_2011/images\119.Field_Sparrow/Field_Sparrow_0059_113759.jpg,333,500,119.Field_Sparrow,34,105,231,310,132,207,197,205
../../CUB_200_2011/images\119.Field_Sparrow/Field_Sparrow_0101_113762.jpg,492,500,119.Field_Sparrow,201,108,415,295,308,201,214,187
../../CUB_200_2011/images\119.Field_Sparrow/Field_Sparrow_0102_113595.jpg,500,332,119.Field_Sparrow,269,83,499,331,384,207,230,248
../../CUB_200_2011/images\119.Field_Sparrow/Field_Sparrow_0104_113524.jpg,347,500,119.Field_Sparrow,11,82,266,265,138,173,255,183
../../CUB_200_2011/images\119.Field_Sparrow/Field_Sparrow_0108_114154.jpg,500,376,119.Field_Sparrow,154,148,456,349,305,248,302,201
../../CUB_200_2011/images\119.Field_Sparrow/Field_Sparrow_0111_113899.jpg,500,333,119.Field_Sparrow,176,79,340,331,258,205,164,252
../../CUB_200_2011/images\119.Field_Sparrow/Field_Sparrow_0047_113801.jpg,500,424,119.Field_Sparrow,156,77,422,339,289,208,266,262
../../CUB_200_2011/images\119.Field_Sparrow/Field_Sparrow_0080_113811.jpg,500,357,119.Field_Sparrow,61,26,463,355,262,190,402,329
../../CUB_200_2011/images\119.Field_Sparrow/Field_Sparrow_0124_113868.jpg,500,373,119.Field_Sparrow,145,67,305,254,225,160,160,187
../../CUB_200_2011/images\119.Field_Sparrow/Field_Sparrow_0042_113815.jpg,500,473,119.Field_Sparrow,186,156,341,328,263,242,155,172
../../CUB_200_2011/images\119.Field_Sparrow/Field_Sparrow_0105_113822.jpg,333,500,119.Field_Sparrow,34,165,321,327,177,246,287,162
../../CUB_200_2011/images\119.Field_Sparrow/Field_Sparrow_0069_113827.jpg,456,500,119.Field_Sparrow,18,95,356,459,187,277,338,364
../../CUB_200_2011/images\119.Field_Sparrow/Field_Sparrow_0078_113575.jpg,500,333,119.Field_Sparrow,232,36,477,208,354,122,245,172
../../CUB_200_2011/images\119.Field_Sparrow/Field_Sparrow_0043_113607.jpg,500,398,119.Field_Sparrow,203,107,470,379,336,243,267,272
../../CUB_200_2011/images\119.Field_Sparrow/Field_Sparrow_0092_113580.jpg,500,353,119.Field_Sparrow,73,155,383,313,228,234,310,158
../../CUB_200_2011/images\119.Field_Sparrow/Field_Sparrow_0022_113838.jpg,500,334,119.Field_Sparrow,165,104,432,296,298,200,267,192
../../CUB_200_2011/images\119.Field_Sparrow/Field_Sparrow_0006_113839.jpg,500,333,119.Field_Sparrow,182,100,440,314,311,207,258,214
../../CUB_200_2011/images\119.Field_Sparrow/Field_Sparrow_0095_113842.jpg,500,333,119.Field_Sparrow,74,118,346,258,210,188,272,140
../../CUB_200_2011/images\119.Field_Sparrow/Field_Sparrow_0128_113587.jpg,500,305,119.Field_Sparrow,4,8,320,289,162,148,316,281
../../CUB_200_2011/images\119.Field_Sparrow/Field_Sparrow_0130_113846.jpg,500,375,119.Field_Sparrow,153,88,499,374,326,231,346,286
../../CUB_200_2011/images\119.Field_Sparrow/Field_Sparrow_0123_113847.jpg,478,500,119.Field_Sparrow,178,170,397,356,287,263,219,186
../../CUB_200_2011/images\119.Field_Sparrow/Field_Sparrow_0051_114107.jpg,500,375,119.Field_Sparrow,8,130,372,328,190,229,364,198
../../CUB_200_2011/images\119.Field_Sparrow/Field_Sparrow_0066_114109.jpg,333,500,119.Field_Sparrow,40,134,260,422,150,278,220,288
../../CUB_200_2011/images\119.Field_Sparrow/Field_Sparrow_0013_113599.jpg,400,500,119.Field_Sparrow,130,116,368,375,249,245,238,259
../../CUB_200_2011/images\119.Field_Sparrow/Field_Sparrow_0009_113860.jpg,486,500,119.Field_Sparrow,71,122,347,372,209,247,276,250
../../CUB_200_2011/images\119.Field_Sparrow/Field_Sparrow_0106_113350.jpg,500,333,119.Field_Sparrow,137,111,429,305,283,208,292,194
../../CUB_200_2011/images\119.Field_Sparrow/Field_Sparrow_0027_113353.jpg,250,225,119.Field_Sparrow,30,23,209,215,119,119,179,192
../../CUB_200_2011/images\119.Field_Sparrow/Field_Sparrow_0038_113356.jpg,500,341,119.Field_Sparrow,174,73,312,316,243,194,138,243
../../CUB_200_2011/images\119.Field_Sparrow/Field_Sparrow_0099_113872.jpg,500,334,119.Field_Sparrow,90,50,370,285,230,167,280,235
../../CUB_200_2011/images\119.Field_Sparrow/Field_Sparrow_0034_113364.jpg,423,500,119.Field_Sparrow,47,68,394,418,220,243,347,350
../../CUB_200_2011/images\119.Field_Sparrow/Field_Sparrow_0016_110297.jpg,500,420,119.Field_Sparrow,123,104,420,354,271,229,297,250
../../CUB_200_2011/images\119.Field_Sparrow/Field_Sparrow_0109_113375.jpg,500,478,119.Field_Sparrow,224,182,403,361,313,271,179,179
../../CUB_200_2011/images\119.Field_Sparrow/Field_Sparrow_0090_113613.jpg,375,500,119.Field_Sparrow,92,145,320,491,206,318,228,346
../../CUB_200_2011/images\119.Field_Sparrow/Field_Sparrow_0048_113387.jpg,470,500,119.Field_Sparrow,61,45,462,457,261,251,401,412
../../CUB_200_2011/images\119.Field_Sparrow/Field_Sparrow_0112_114159.jpg,500,361,119.Field_Sparrow,149,101,367,218,258,159,218,117
../../CUB_200_2011/images\119.Field_Sparrow/Field_Sparrow_0125_113869.jpg,500,375,119.Field_Sparrow,133,88,323,255,228,171,190,167
../../CUB_200_2011/images\119.Field_Sparrow/Field_Sparrow_0107_113659.jpg,500,334,119.Field_Sparrow,50,159,233,307,141,233,183,148
../../CUB_200_2011/images\120.Fox_Sparrow/Fox_Sparrow_0065_114945.jpg,500,454,120.Fox_Sparrow,59,80,499,441,279,260,440,361
../../CUB_200_2011/images\120.Fox_Sparrow/Fox_Sparrow_0041_115218.jpg,500,400,120.Fox_Sparrow,34,71,485,366,259,218,451,295
../../CUB_200_2011/images\120.Fox_Sparrow/Fox_Sparrow_0106_114720.jpg,412,500,120.Fox_Sparrow,196,125,392,366,294,245,196,241
../../CUB_200_2011/images\120.Fox_Sparrow/Fox_Sparrow_0016_114213.jpg,500,333,120.Fox_Sparrow,104,58,461,267,282,162,357,209
../../CUB_200_2011/images\120.Fox_Sparrow/Fox_Sparrow_0010_114728.jpg,500,400,120.Fox_Sparrow,86,108,289,371,187,239,203,263
../../CUB_200_2011/images\120.Fox_Sparrow/Fox_Sparrow_0022_115248.jpg,333,500,120.Fox_Sparrow,42,113,325,407,183,260,283,294
../../CUB_200_2011/images\120.Fox_Sparrow/Fox_Sparrow_0135_115251.jpg,500,370,120.Fox_Sparrow,135,54,440,346,287,200,305,292
../../CUB_200_2011/images\120.Fox_Sparrow/Fox_Sparrow_0103_115038.jpg,500,334,120.Fox_Sparrow,95,54,298,290,196,172,203,236
../../CUB_200_2011/images\120.Fox_Sparrow/Fox_Sparrow_0020_114744.jpg,500,333,120.Fox_Sparrow,140,84,339,269,239,176,199,185
../../CUB_200_2011/images\120.Fox_Sparrow/Fox_Sparrow_0044_114747.jpg,500,375,120.Fox_Sparrow,42,60,367,351,204,205,325,291
../../CUB_200_2011/images\120.Fox_Sparrow/Fox_Sparrow_0093_114757.jpg,500,321,120.Fox_Sparrow,99,52,462,299,280,175,363,247
../../CUB_200_2011/images\120.Fox_Sparrow/Fox_Sparrow_0136_115278.jpg,500,365,120.Fox_Sparrow,96,80,313,260,204,170,217,180
../../CUB_200_2011/images\120.Fox_Sparrow/Fox_Sparrow_0026_115281.jpg,500,333,120.Fox_Sparrow,115,72,470,284,292,178,355,212
../../CUB_200_2011/images\120.Fox_Sparrow/Fox_Sparrow_0092_114774.jpg,500,408,120.Fox_Sparrow,4,73,385,391,194,232,381,318
../../CUB_200_2011/images\120.Fox_Sparrow/Fox_Sparrow_0122_114776.jpg,500,339,120.Fox_Sparrow,230,41,445,246,337,143,215,205
../../CUB_200_2011/images\120.Fox_Sparrow/Fox_Sparrow_0053_114780.jpg,500,400,120.Fox_Sparrow,43,46,414,328,228,187,371,282
../../CUB_200_2011/images\120.Fox_Sparrow/Fox_Sparrow_0058_114789.jpg,500,332,120.Fox_Sparrow,24,9,416,317,220,163,392,308
../../CUB_200_2011/images\120.Fox_Sparrow/Fox_Sparrow_0009_114796.jpg,500,375,120.Fox_Sparrow,20,26,438,361,229,193,418,335
../../CUB_200_2011/images\120.Fox_Sparrow/Fox_Sparrow_0116_115311.jpg,500,356,120.Fox_Sparrow,100,95,399,269,249,182,299,174
../../CUB_200_2011/images\120.Fox_Sparrow/Fox_Sparrow_0055_114809.jpg,500,357,120.Fox_Sparrow,165,108,365,311,265,209,200,203
../../CUB_200_2011/images\120.Fox_Sparrow/Fox_Sparrow_0039_114816.jpg,500,357,120.Fox_Sparrow,52,64,410,290,231,177,358,226
../../CUB_200_2011/images\120.Fox_Sparrow/Fox_Sparrow_0115_114855.jpg,500,400,120.Fox_Sparrow,69,84,475,346,272,215,406,262
../../CUB_200_2011/images\120.Fox_Sparrow/Fox_Sparrow_0013_114344.jpg,500,355,120.Fox_Sparrow,108,30,471,337,289,183,363,307
../../CUB_200_2011/images\120.Fox_Sparrow/Fox_Sparrow_0109_114859.jpg,500,332,120.Fox_Sparrow,192,93,472,278,332,185,280,185
../../CUB_200_2011/images\120.Fox_Sparrow/Fox_Sparrow_0063_114350.jpg,500,333,120.Fox_Sparrow,30,38,328,306,179,172,298,268
../../CUB_200_2011/images\120.Fox_Sparrow/Fox_Sparrow_0035_114866.jpg,500,333,120.Fox_Sparrow,41,50,418,261,229,155,377,211
../../CUB_200_2011/images\120.Fox_Sparrow/Fox_Sparrow_0057_114355.jpg,500,374,120.Fox_Sparrow,21,35,433,300,227,167,412,265
../../CUB_200_2011/images\120.Fox_Sparrow/Fox_Sparrow_0052_114878.jpg,500,357,120.Fox_Sparrow,44,105,351,314,197,209,307,209
../../CUB_200_2011/images\120.Fox_Sparrow/Fox_Sparrow_0118_114884.jpg,500,375,120.Fox_Sparrow,141,59,409,352,275,205,268,293
../../CUB_200_2011/images\120.Fox_Sparrow/Fox_Sparrow_0121_114886.jpg,327,500,120.Fox_Sparrow,79,143,254,487,166,315,175,344
../../CUB_200_2011/images\120.Fox_Sparrow/Fox_Sparrow_0099_115399.jpg,500,394,120.Fox_Sparrow,143,52,484,365,313,208,341,313
../../CUB_200_2011/images\120.Fox_Sparrow/Fox_Sparrow_0113_114389.jpg,500,334,120.Fox_Sparrow,99,19,341,327,220,173,242,308
../../CUB_200_2011/images\120.Fox_Sparrow/Fox_Sparrow_0104_114908.jpg,428,323,120.Fox_Sparrow,168,75,337,265,252,170,169,190
../../CUB_200_2011/images\120.Fox_Sparrow/Fox_Sparrow_0075_114920.jpg,500,398,120.Fox_Sparrow,171,114,363,317,267,215,192,203
../../CUB_200_2011/images\120.Fox_Sparrow/Fox_Sparrow_0012_115324.jpg,492,500,120.Fox_Sparrow,90,150,293,295,191,222,203,145
../../CUB_200_2011/images\120.Fox_Sparrow/Fox_Sparrow_0125_114557.jpg,500,333,120.Fox_Sparrow,235,136,340,256,287,196,105,120
../../CUB_200_2011/images\120.Fox_Sparrow/Fox_Sparrow_0077_114944.jpg,500,333,120.Fox_Sparrow,63,29,383,320,223,174,320,291
../../CUB_200_2011/images\120.Fox_Sparrow/Fox_Sparrow_0068_114967.jpg,500,333,120.Fox_Sparrow,191,81,380,279,285,180,189,198
../../CUB_200_2011/images\120.Fox_Sparrow/Fox_Sparrow_0086_115484.jpg,500,376,120.Fox_Sparrow,190,105,468,328,329,216,278,223
../../CUB_200_2011/images\120.Fox_Sparrow/Fox_Sparrow_0018_114468.jpg,345,500,120.Fox_Sparrow,42,128,226,313,134,220,184,185
../../CUB_200_2011/images\120.Fox_Sparrow/Fox_Sparrow_0114_114481.jpg,398,500,120.Fox_Sparrow,59,142,365,464,212,303,306,322
../../CUB_200_2011/images\120.Fox_Sparrow/Fox_Sparrow_0123_114488.jpg,500,333,120.Fox_Sparrow,173,98,333,298,253,198,160,200
../../CUB_200_2011/images\120.Fox_Sparrow/Fox_Sparrow_0083_114496.jpg,500,341,120.Fox_Sparrow,83,78,315,288,199,183,232,210
../../CUB_200_2011/images\120.Fox_Sparrow/Fox_Sparrow_0047_115022.jpg,500,333,120.Fox_Sparrow,131,43,372,294,251,168,241,251
../../CUB_200_2011/images\120.Fox_Sparrow/Fox_Sparrow_0119_115512.jpg,495,500,120.Fox_Sparrow,120,210,285,357,202,283,165,147
../../CUB_200_2011/images\120.Fox_Sparrow/Fox_Sparrow_0040_115034.jpg,500,254,120.Fox_Sparrow,141,53,259,212,200,132,118,159
../../CUB_200_2011/images\120.Fox_Sparrow/Fox_Sparrow_0091_115550.jpg,500,386,120.Fox_Sparrow,98,42,409,322,253,182,311,280
../../CUB_200_2011/images\120.Fox_Sparrow/Fox_Sparrow_0111_114527.jpg,500,409,120.Fox_Sparrow,174,80,411,263,292,171,237,183
../../CUB_200_2011/images\120.Fox_Sparrow/Fox_Sparrow_0067_114528.jpg,448,500,120.Fox_Sparrow,23,133,401,408,212,270,378,275
../../CUB_200_2011/images\120.Fox_Sparrow/Fox_Sparrow_0054_114541.jpg,500,367,120.Fox_Sparrow,80,80,385,267,232,173,305,187
../../CUB_200_2011/images\120.Fox_Sparrow/Fox_Sparrow_0062_115056.jpg,357,500,120.Fox_Sparrow,51,119,327,378,189,248,276,259
../../CUB_200_2011/images\120.Fox_Sparrow/Fox_Sparrow_0025_114555.jpg,500,375,120.Fox_Sparrow,120,55,357,285,238,170,237,230
../../CUB_200_2011/images\120.Fox_Sparrow/Fox_Sparrow_0036_115581.jpg,500,356,120.Fox_Sparrow,188,120,355,270,271,195,167,150
../../CUB_200_2011/images\120.Fox_Sparrow/Fox_Sparrow_0078_114582.jpg,500,400,120.Fox_Sparrow,89,77,347,290,218,183,258,213
../../CUB_200_2011/images\120.Fox_Sparrow/Fox_Sparrow_0138_114586.jpg,375,500,120.Fox_Sparrow,32,58,366,461,199,259,334,403
../../CUB_200_2011/images\120.Fox_Sparrow/Fox_Sparrow_0081_115630.jpg,500,335,120.Fox_Sparrow,244,89,458,264,351,176,214,175
../../CUB_200_2011/images\120.Fox_Sparrow/Fox_Sparrow_0094_114634.jpg,500,302,120.Fox_Sparrow,77,30,360,286,218,158,283,256
../../CUB_200_2011/images\120.Fox_Sparrow/Fox_Sparrow_0015_114650.jpg,338,500,120.Fox_Sparrow,63,32,275,465,169,248,212,433
../../CUB_200_2011/images\120.Fox_Sparrow/Fox_Sparrow_0110_115172.jpg,500,333,120.Fox_Sparrow,104,66,342,325,223,195,238,259
../../CUB_200_2011/images\120.Fox_Sparrow/Fox_Sparrow_0124_114662.jpg,225,217,120.Fox_Sparrow,7,29,222,167,114,98,215,138
../../CUB_200_2011/images\121.Grasshopper_Sparrow/Grasshopper_Sparrow_0067_115979.jpg,332,500,121.Grasshopper_Sparrow,43,89,254,252,148,170,211,163
../../CUB_200_2011/images\121.Grasshopper_Sparrow/Grasshopper_Sparrow_0039_115980.jpg,500,375,121.Grasshopper_Sparrow,2,53,447,366,224,209,445,313
../../CUB_200_2011/images\121.Grasshopper_Sparrow/Grasshopper_Sparrow_0117_115983.jpg,500,448,121.Grasshopper_Sparrow,80,23,435,395,257,209,355,372
../../CUB_200_2011/images\121.Grasshopper_Sparrow/Grasshopper_Sparrow_0009_115984.jpg,500,331,121.Grasshopper_Sparrow,81,108,305,266,193,187,224,158
../../CUB_200_2011/images\121.Grasshopper_Sparrow/Grasshopper_Sparrow_0053_115991.jpg,500,445,121.Grasshopper_Sparrow,152,136,278,330,215,233,126,194
../../CUB_200_2011/images\121.Grasshopper_Sparrow/Grasshopper_Sparrow_0073_115996.jpg,500,414,121.Grasshopper_Sparrow,176,133,439,375,307,254,263,242
../../CUB_200_2011/images\121.Grasshopper_Sparrow/Grasshopper_Sparrow_0075_116260.jpg,500,375,121.Grasshopper_Sparrow,269,83,439,208,354,145,170,125
../../CUB_200_2011/images\121.Grasshopper_Sparrow/Grasshopper_Sparrow_0109_115750.jpg,500,333,121.Grasshopper_Sparrow,196,88,375,307,285,197,179,219
../../CUB_200_2011/images\121.Grasshopper_Sparrow/Grasshopper_Sparrow_0029_115761.jpg,500,333,121.Grasshopper_Sparrow,96,60,229,295,162,177,133,235
../../CUB_200_2011/images\121.Grasshopper_Sparrow/Grasshopper_Sparrow_0040_115696.jpg,333,500,121.Grasshopper_Sparrow,46,126,309,479,177,302,263,353
../../CUB_200_2011/images\121.Grasshopper_Sparrow/Grasshopper_Sparrow_0120_116021.jpg,500,333,121.Grasshopper_Sparrow,238,128,391,262,314,195,153,134
../../CUB_200_2011/images\121.Grasshopper_Sparrow/Grasshopper_Sparrow_0060_15159.jpg,403,500,121.Grasshopper_Sparrow,178,67,383,454,280,260,205,387
../../CUB_200_2011/images\121.Grasshopper_Sparrow/Grasshopper_Sparrow_0126_116029.jpg,500,335,121.Grasshopper_Sparrow,227,51,394,298,310,174,167,247
../../CUB_200_2011/images\121.Grasshopper_Sparrow/Grasshopper_Sparrow_0107_116286.jpg,500,281,121.Grasshopper_Sparrow,184,36,468,253,326,144,284,217
../../CUB_200_2011/images\121.Grasshopper_Sparrow/Grasshopper_Sparrow_0125_116031.jpg,500,327,121.Grasshopper_Sparrow,184,85,488,320,336,202,304,235
../../CUB_200_2011/images\121.Grasshopper_Sparrow/Grasshopper_Sparrow_0041_116288.jpg,500,375,121.Grasshopper_Sparrow,70,114,291,245,180,179,221,131
../../CUB_200_2011/images\121.Grasshopper_Sparrow/Grasshopper_Sparrow_0020_116289.jpg,400,500,121.Grasshopper_Sparrow,183,192,298,348,240,270,115,156
../../CUB_200_2011/images\121.Grasshopper_Sparrow/Grasshopper_Sparrow_0044_115681.jpg,500,357,121.Grasshopper_Sparrow,111,109,282,276,196,192,171,167
../../CUB_200_2011/images\121.Grasshopper_Sparrow/Grasshopper_Sparrow_0082_116300.jpg,500,369,121.Grasshopper_Sparrow,84,106,253,268,168,187,169,162
../../CUB_200_2011/images\121.Grasshopper_Sparrow/Grasshopper_Sparrow_0050_116301.jpg,500,334,121.Grasshopper_Sparrow,133,127,304,248,218,187,171,121
../../CUB_200_2011/images\121.Grasshopper_Sparrow/Grasshopper_Sparrow_0035_116049.jpg,500,383,121.Grasshopper_Sparrow,162,83,459,368,310,225,297,285
../../CUB_200_2011/images\121.Grasshopper_Sparrow/Grasshopper_Sparrow_0078_116052.jpg,500,418,121.Grasshopper_Sparrow,177,103,320,334,248,218,143,231
../../CUB_200_2011/images\121.Grasshopper_Sparrow/Grasshopper_Sparrow_0068_115799.jpg,500,500,121.Grasshopper_Sparrow,138,127,337,351,237,239,199,224
../../CUB_200_2011/images\121.Grasshopper_Sparrow/Grasshopper_Sparrow_0018_116056.jpg,500,333,121.Grasshopper_Sparrow,59,58,173,237,116,147,114,179
../../CUB_200_2011/images\121.Grasshopper_Sparrow/Grasshopper_Sparrow_0116_116066.jpg,500,436,121.Grasshopper_Sparrow,19,115,439,371,229,243,420,256
../../CUB_200_2011/images\121.Grasshopper_Sparrow/Grasshopper_Sparrow_0098_116027.jpg,500,346,121.Grasshopper_Sparrow,102,66,312,262,207,164,210,196
../../CUB_200_2011/images\121.Grasshopper_Sparrow/Grasshopper_Sparrow_0099_116069.jpg,500,297,121.Grasshopper_Sparrow,2,12,278,247,140,129,276,235
../../CUB_200_2011/images\121.Grasshopper_Sparrow/Grasshopper_Sparrow_0081_116326.jpg,261,261,121.Grasshopper_Sparrow,9,11,257,255,133,133,248,244
../../CUB_200_2011/images\121.Grasshopper_Sparrow/Grasshopper_Sparrow_0069_116332.jpg,500,494,121.Grasshopper_Sparrow,245,203,382,439,313,321,137,236
../../CUB_200_2011/images\121.Grasshopper_Sparrow/Grasshopper_Sparrow_0042_115638.jpg,500,400,121.Grasshopper_Sparrow,39,120,267,326,153,223,228,206
../../CUB_200_2011/images\121.Grasshopper_Sparrow/Grasshopper_Sparrow_0015_116352.jpg,500,385,121.Grasshopper_Sparrow,125,122,284,230,204,176,159,108
../../CUB_200_2011/images\121.Grasshopper_Sparrow/Grasshopper_Sparrow_0106_116028.jpg,500,332,121.Grasshopper_Sparrow,119,74,404,238,261,156,285,164
../../CUB_200_2011/images\121.Grasshopper_Sparrow/Grasshopper_Sparrow_0012_115849.jpg,500,336,121.Grasshopper_Sparrow,25,82,350,305,187,193,325,223
../../CUB_200_2011/images\121.Grasshopper_Sparrow/Grasshopper_Sparrow_0064_116106.jpg,500,333,121.Grasshopper_Sparrow,83,93,306,274,194,183,223,181
../../CUB_200_2011/images\121.Grasshopper_Sparrow/Grasshopper_Sparrow_0021_116107.jpg,500,478,121.Grasshopper_Sparrow,184,76,397,347,290,211,213,271
../../CUB_200_2011/images\121.Grasshopper_Sparrow/Grasshopper_Sparrow_0121_116110.jpg,364,500,121.Grasshopper_Sparrow,34,104,309,427,171,265,275,323
../../CUB_200_2011/images\121.Grasshopper_Sparrow/Grasshopper_Sparrow_0058_115862.jpg,499,500,121.Grasshopper_Sparrow,64,76,424,443,244,259,360,367
../../CUB_200_2011/images\121.Grasshopper_Sparrow/Grasshopper_Sparrow_0006_115864.jpg,500,333,121.Grasshopper_Sparrow,213,102,409,298,311,200,196,196
../../CUB_200_2011/images\121.Grasshopper_Sparrow/Grasshopper_Sparrow_0016_115695.jpg,500,333,121.Grasshopper_Sparrow,108,87,459,258,283,172,351,171
../../CUB_200_2011/images\121.Grasshopper_Sparrow/Grasshopper_Sparrow_0077_116127.jpg,500,375,121.Grasshopper_Sparrow,158,127,324,301,241,214,166,174
../../CUB_200_2011/images\121.Grasshopper_Sparrow/Grasshopper_Sparrow_0014_116129.jpg,421,480,121.Grasshopper_Sparrow,91,122,371,411,231,266,280,289
../../CUB_200_2011/images\121.Grasshopper_Sparrow/Grasshopper_Sparrow_0119_116081.jpg,500,333,121.Grasshopper_Sparrow,212,54,443,269,327,161,231,215
../../CUB_200_2011/images\121.Grasshopper_Sparrow/Grasshopper_Sparrow_0043_115880.jpg,500,333,121.Grasshopper_Sparrow,169,108,369,217,269,162,200,109
../../CUB_200_2011/images\121.Grasshopper_Sparrow/Grasshopper_Sparrow_0108_115894.jpg,500,394,121.Grasshopper_Sparrow,110,118,350,260,230,189,240,142
../../CUB_200_2011/images\121.Grasshopper_Sparrow/Grasshopper_Sparrow_0110_115644.jpg,500,333,121.Grasshopper_Sparrow,226,121,470,306,348,213,244,185
../../CUB_200_2011/images\121.Grasshopper_Sparrow/Grasshopper_Sparrow_0070_115645.jpg,500,333,121.Grasshopper_Sparrow,159,93,459,294,309,193,300,201
../../CUB_200_2011/images\121.Grasshopper_Sparrow/Grasshopper_Sparrow_0114_116160.jpg,500,375,121.Grasshopper_Sparrow,167,130,495,310,331,220,328,180
../../CUB_200_2011/images\121.Grasshopper_Sparrow/Grasshopper_Sparrow_0017_115908.jpg,400,500,121.Grasshopper_Sparrow,114,102,364,380,239,241,250,278
../../CUB_200_2011/images\121.Grasshopper_Sparrow/Grasshopper_Sparrow_0102_116101.jpg,500,334,121.Grasshopper_Sparrow,38,53,328,324,183,188,290,271
../../CUB_200_2011/images\121.Grasshopper_Sparrow/Grasshopper_Sparrow_0115_115914.jpg,430,500,121.Grasshopper_Sparrow,233,76,365,257,299,166,132,181
../../CUB_200_2011/images\121.Grasshopper_Sparrow/Grasshopper_Sparrow_0026_115915.jpg,500,500,121.Grasshopper_Sparrow,80,68,427,477,253,272,347,409
../../CUB_200_2011/images\121.Grasshopper_Sparrow/Grasshopper_Sparrow_0049_115918.jpg,500,361,121.Grasshopper_Sparrow,71,33,305,342,188,187,234,309
../../CUB_200_2011/images\121.Grasshopper_Sparrow/Grasshopper_Sparrow_0072_115663.jpg,387,500,121.Grasshopper_Sparrow,131,117,367,290,249,203,236,173
../../CUB_200_2011/images\121.Grasshopper_Sparrow/Grasshopper_Sparrow_0051_115923.jpg,500,334,121.Grasshopper_Sparrow,231,88,439,199,335,143,208,111
../../CUB_200_2011/images\121.Grasshopper_Sparrow/Grasshopper_Sparrow_0003_115676.jpg,500,333,121.Grasshopper_Sparrow,83,49,283,260,183,154,200,211
../../CUB_200_2011/images\121.Grasshopper_Sparrow/Grasshopper_Sparrow_0011_115937.jpg,459,500,121.Grasshopper_Sparrow,97,87,419,409,258,248,322,322
../../CUB_200_2011/images\121.Grasshopper_Sparrow/Grasshopper_Sparrow_0001_115938.jpg,500,375,121.Grasshopper_Sparrow,100,87,427,343,263,215,327,256
../../CUB_200_2011/images\121.Grasshopper_Sparrow/Grasshopper_Sparrow_0101_116094.jpg,500,375,121.Grasshopper_Sparrow,131,118,304,293,217,205,173,175
../../CUB_200_2011/images\121.Grasshopper_Sparrow/Grasshopper_Sparrow_0019_115958.jpg,500,400,121.Grasshopper_Sparrow,167,95,440,323,303,209,273,228
../../CUB_200_2011/images\121.Grasshopper_Sparrow/Grasshopper_Sparrow_0038_115704.jpg,401,500,121.Grasshopper_Sparrow,56,38,308,460,182,249,252,422
../../CUB_200_2011/images\122.Harris_Sparrow/Harris_Sparrow_0024_116480.jpg,500,431,122.Harris_Sparrow,73,74,480,290,276,182,407,216
../../CUB_200_2011/images\122.Harris_Sparrow/Harris_Sparrow_0007_116484.jpg,500,387,122.Harris_Sparrow,41,122,337,315,189,218,296,193
../../CUB_200_2011/images\122.Harris_Sparrow/Harris_Sparrow_0087_116490.jpg,500,402,122.Harris_Sparrow,118,90,353,312,235,201,235,222
../../CUB_200_2011/images\122.Harris_Sparrow/Harris_Sparrow_0038_116610.jpg,500,333,122.Harris_Sparrow,71,38,466,330,268,184,395,292
../../CUB_200_2011/images\122.Harris_Sparrow/Harris_Sparrow_0014_116494.jpg,500,343,122.Harris_Sparrow,29,41,397,202,213,121,368,161
../../CUB_200_2011/images\122.Harris_Sparrow/Harris_Sparrow_0042_116499.jpg,500,334,122.Harris_Sparrow,125,119,354,278,239,198,229,159
../../CUB_200_2011/images\122.Harris_Sparrow/Harris_Sparrow_0076_116509.jpg,500,388,122.Harris_Sparrow,5,49,337,375,171,212,332,326
../../CUB_200_2011/images\122.Harris_Sparrow/Harris_Sparrow_0055_116512.jpg,500,332,122.Harris_Sparrow,79,127,381,296,230,211,302,169
../../CUB_200_2011/images\122.Harris_Sparrow/Harris_Sparrow_0028_116656.jpg,375,500,122.Harris_Sparrow,98,59,269,418,183,238,171,359
../../CUB_200_2011/images\122.Harris_Sparrow/Harris_Sparrow_0029_116516.jpg,500,376,122.Harris_Sparrow,73,55,380,365,226,210,307,310
../../CUB_200_2011/images\122.Harris_Sparrow/Harris_Sparrow_0084_116519.jpg,500,333,122.Harris_Sparrow,53,55,387,300,220,177,334,245
../../CUB_200_2011/images\122.Harris_Sparrow/Harris_Sparrow_0035_116529.jpg,500,333,122.Harris_Sparrow,77,72,499,327,288,199,422,255
../../CUB_200_2011/images\122.Harris_Sparrow/Harris_Sparrow_0089_116531.jpg,500,401,122.Harris_Sparrow,19,105,405,290,212,197,386,185
../../CUB_200_2011/images\122.Harris_Sparrow/Harris_Sparrow_0056_116532.jpg,500,414,122.Harris_Sparrow,151,94,434,271,292,182,283,177
../../CUB_200_2011/images\122.Harris_Sparrow/Harris_Sparrow_0085_116534.jpg,500,383,122.Harris_Sparrow,161,80,457,309,309,194,296,229
../../CUB_200_2011/images\122.Harris_Sparrow/Harris_Sparrow_0082_116660.jpg,500,438,122.Harris_Sparrow,156,183,285,301,220,242,129,118
../../CUB_200_2011/images\122.Harris_Sparrow/Harris_Sparrow_0074_116539.jpg,500,375,122.Harris_Sparrow,221,79,371,201,296,140,150,122
../../CUB_200_2011/images\122.Harris_Sparrow/Harris_Sparrow_0016_116661.jpg,500,465,122.Harris_Sparrow,191,146,308,393,249,269,117,247
../../CUB_200_2011/images\122.Harris_Sparrow/Harris_Sparrow_0052_116544.jpg,500,332,122.Harris_Sparrow,250,11,413,277,331,144,163,266
../../CUB_200_2011/images\122.Harris_Sparrow/Harris_Sparrow_0026_116620.jpg,500,332,122.Harris_Sparrow,161,71,431,289,296,180,270,218
../../CUB_200_2011/images\122.Harris_Sparrow/Harris_Sparrow_0090_116664.jpg,358,500,122.Harris_Sparrow,118,149,233,415,175,282,115,266
../../CUB_200_2011/images\122.Harris_Sparrow/Harris_Sparrow_0081_116574.jpg,500,415,122.Harris_Sparrow,20,74,405,327,212,200,385,253
../../CUB_200_2011/images\122.Harris_Sparrow/Harris_Sparrow_0060_116576.jpg,500,375,122.Harris_Sparrow,9,96,297,289,153,192,288,193
../../CUB_200_2011/images\122.Harris_Sparrow/Harris_Sparrow_0073_116577.jpg,500,375,122.Harris_Sparrow,177,110,289,276,233,193,112,166
../../CUB_200_2011/images\122.Harris_Sparrow/Harris_Sparrow_0004_116581.jpg,500,333,122.Harris_Sparrow,208,123,323,238,265,180,115,115
../../CUB_200_2011/images\122.Harris_Sparrow/Harris_Sparrow_0083_116588.jpg,500,333,122.Harris_Sparrow,211,98,431,254,321,176,220,156
../../CUB_200_2011/images\122.Harris_Sparrow/Harris_Sparrow_0053_116595.jpg,500,365,122.Harris_Sparrow,86,54,366,303,226,178,280,249
../../CUB_200_2011/images\122.Harris_Sparrow/Harris_Sparrow_0011_116597.jpg,500,323,122.Harris_Sparrow,76,128,331,254,203,191,255,126
../../CUB_200_2011/images\122.Harris_Sparrow/Harris_Sparrow_0045_116603.jpg,500,377,122.Harris_Sparrow,52,55,312,356,182,205,260,301
../../CUB_200_2011/images\122.Harris_Sparrow/Harris_Sparrow_0059_116608.jpg,500,357,122.Harris_Sparrow,39,71,303,312,171,191,264,241
../../CUB_200_2011/images\122.Harris_Sparrow/Harris_Sparrow_0041_116611.jpg,500,333,122.Harris_Sparrow,38,61,271,296,154,178,233,235
../../CUB_200_2011/images\122.Harris_Sparrow/Harris_Sparrow_0002_116356.jpg,500,358,122.Harris_Sparrow,89,82,379,300,234,191,290,218
../../CUB_200_2011/images\122.Harris_Sparrow/Harris_Sparrow_0066_116362.jpg,500,446,122.Harris_Sparrow,110,128,320,360,215,244,210,232
../../CUB_200_2011/images\122.Harris_Sparrow/Harris_Sparrow_0023_116363.jpg,367,500,122.Harris_Sparrow,17,134,305,453,161,293,288,319
../../CUB_200_2011/images\122.Harris_Sparrow/Harris_Sparrow_0006_116364.jpg,500,382,122.Harris_Sparrow,102,117,303,317,202,217,201,200
../../CUB_200_2011/images\122.Harris_Sparrow/Harris_Sparrow_0050_116369.jpg,500,333,122.Harris_Sparrow,131,85,445,277,288,181,314,192
../../CUB_200_2011/images\122.Harris_Sparrow/Harris_Sparrow_0086_116373.jpg,500,350,122.Harris_Sparrow,108,54,347,298,227,176,239,244
../../CUB_200_2011/images\122.Harris_Sparrow/Harris_Sparrow_0057_116374.jpg,500,458,122.Harris_Sparrow,2,177,170,330,86,253,168,153
../../CUB_200_2011/images\122.Harris_Sparrow/Harris_Sparrow_0010_116376.jpg,500,333,122.Harris_Sparrow,187,73,487,277,337,175,300,204
../../CUB_200_2011/images\122.Harris_Sparrow/Harris_Sparrow_0020_116379.jpg,500,411,122.Harris_Sparrow,0,106,382,350,191,228,382,244
../../CUB_200_2011/images\122.Harris_Sparrow/Harris_Sparrow_0033_116380.jpg,500,347,122.Harris_Sparrow,136,73,329,217,232,145,193,144
../../CUB_200_2011/images\122.Harris_Sparrow/Harris_Sparrow_0063_116383.jpg,500,426,122.Harris_Sparrow,260,139,370,311,315,225,110,172
../../CUB_200_2011/images\122.Harris_Sparrow/Harris_Sparrow_0025_116648.jpg,500,375,122.Harris_Sparrow,143,126,380,363,261,244,237,237
../../CUB_200_2011/images\122.Harris_Sparrow/Harris_Sparrow_0001_116398.jpg,500,358,122.Harris_Sparrow,106,147,269,263,187,205,163,116
../../CUB_200_2011/images\122.Harris_Sparrow/Harris_Sparrow_0021_116399.jpg,500,333,122.Harris_Sparrow,92,83,340,265,216,174,248,182
../../CUB_200_2011/images\122.Harris_Sparrow/Harris_Sparrow_0070_116400.jpg,500,333,122.Harris_Sparrow,42,53,489,305,265,179,447,252
../../CUB_200_2011/images\122.Harris_Sparrow/Harris_Sparrow_0018_116402.jpg,500,333,122.Harris_Sparrow,77,98,220,310,148,204,143,212
../../CUB_200_2011/images\122.Harris_Sparrow/Harris_Sparrow_0075_116404.jpg,500,499,122.Harris_Sparrow,159,221,276,411,217,316,117,190
../../CUB_200_2011/images\122.Harris_Sparrow/Harris_Sparrow_0048_116405.jpg,500,333,122.Harris_Sparrow,203,81,480,259,341,170,277,178
../../CUB_200_2011/images\122.Harris_Sparrow/Harris_Sparrow_0072_116662.jpg,500,375,122.Harris_Sparrow,180,105,373,305,276,205,193,200
../../CUB_200_2011/images\122.Harris_Sparrow/Harris_Sparrow_0017_116636.jpg,500,500,122.Harris_Sparrow,24,176,433,407,228,291,409,231
../../CUB_200_2011/images\122.Harris_Sparrow/Harris_Sparrow_0039_116409.jpg,382,500,122.Harris_Sparrow,137,125,307,419,222,272,170,294
../../CUB_200_2011/images\122.Harris_Sparrow/Harris_Sparrow_0046_116425.jpg,500,389,122.Harris_Sparrow,135,75,360,336,247,205,225,261
../../CUB_200_2011/images\122.Harris_Sparrow/Harris_Sparrow_0027_116687.jpg,500,333,122.Harris_Sparrow,72,92,468,271,270,181,396,179
../../CUB_200_2011/images\122.Harris_Sparrow/Harris_Sparrow_0065_116435.jpg,500,403,122.Harris_Sparrow,192,52,441,383,316,217,249,331
../../CUB_200_2011/images\122.Harris_Sparrow/Harris_Sparrow_0005_116694.jpg,500,455,122.Harris_Sparrow,191,137,471,392,331,264,280,255
../../CUB_200_2011/images\122.Harris_Sparrow/Harris_Sparrow_0034_116439.jpg,500,486,122.Harris_Sparrow,165,133,363,326,264,229,198,193
../../CUB_200_2011/images\122.Harris_Sparrow/Harris_Sparrow_0088_116445.jpg,500,333,122.Harris_Sparrow,36,89,369,263,202,176,333,174
../../CUB_200_2011/images\122.Harris_Sparrow/Harris_Sparrow_0067_116707.jpg,454,341,122.Harris_Sparrow,119,11,373,267,246,139,254,256
../../CUB_200_2011/images\122.Harris_Sparrow/Harris_Sparrow_0071_116476.jpg,333,500,122.Harris_Sparrow,101,154,292,330,196,242,191,176
../../CUB_200_2011/images\123.Henslow_Sparrow/Henslow_Sparrow_0046_116740.jpg,500,375,123.Henslow_Sparrow,251,49,401,264,326,156,150,215
../../CUB_200_2011/images\123.Henslow_Sparrow/Henslow_Sparrow_0061_116751.jpg,337,500,123.Henslow_Sparrow,40,173,234,396,137,284,194,223
../../CUB_200_2011/images\123.Henslow_Sparrow/Henslow_Sparrow_0081_116755.jpg,500,336,123.Henslow_Sparrow,50,61,308,243,179,152,258,182
../../CUB_200_2011/images\123.Henslow_Sparrow/Henslow_Sparrow_0043_116756.jpg,400,500,123.Henslow_Sparrow,123,182,342,417,232,299,219,235
../../CUB_200_2011/images\123.Henslow_Sparrow/Henslow_Sparrow_0096_116758.jpg,500,380,123.Henslow_Sparrow,77,110,341,340,209,225,264,230
../../CUB_200_2011/images\123.Henslow_Sparrow/Henslow_Sparrow_0017_796591.jpg,500,382,123.Henslow_Sparrow,163,47,430,319,296,183,267,272
../../CUB_200_2011/images\123.Henslow_Sparrow/Henslow_Sparrow_0009_796611.jpg,194,181,123.Henslow_Sparrow,23,13,190,168,106,90,167,155
../../CUB_200_2011/images\123.Henslow_Sparrow/Henslow_Sparrow_0042_796595.jpg,357,500,123.Henslow_Sparrow,73,125,275,444,174,284,202,319
../../CUB_200_2011/images\123.Henslow_Sparrow/Henslow_Sparrow_0113_116801.jpg,500,387,123.Henslow_Sparrow,162,73,470,327,316,200,308,254
../../CUB_200_2011/images\123.Henslow_Sparrow/Henslow_Sparrow_0073_116803.jpg,375,500,123.Henslow_Sparrow,127,139,345,335,236,237,218,196
../../CUB_200_2011/images\123.Henslow_Sparrow/Henslow_Sparrow_0075_116805.jpg,500,367,123.Henslow_Sparrow,179,121,357,257,268,189,178,136
../../CUB_200_2011/images\123.Henslow_Sparrow/Henslow_Sparrow_0076_116810.jpg,357,500,123.Henslow_Sparrow,69,99,294,303,181,201,225,204
../../CUB_200_2011/images\123.Henslow_Sparrow/Henslow_Sparrow_0080_11360.jpg,500,333,123.Henslow_Sparrow,211,78,394,199,302,138,183,121
../../CUB_200_2011/images\123.Henslow_Sparrow/Henslow_Sparrow_0069_116832.jpg,450,343,123.Henslow_Sparrow,46,19,445,340,245,179,399,321
../../CUB_200_2011/images\123.Henslow_Sparrow/Henslow_Sparrow_0018_116834.jpg,410,500,123.Henslow_Sparrow,61,128,328,431,194,279,267,303
../../CUB_200_2011/images\123.Henslow_Sparrow/Henslow_Sparrow_0022_116835.jpg,400,500,123.Henslow_Sparrow,97,113,248,257,172,185,151,144
../../CUB_200_2011/images\123.Henslow_Sparrow/Henslow_Sparrow_0083_116844.jpg,436,500,123.Henslow_Sparrow,56,170,247,337,151,253,191,167
../../CUB_200_2011/images\123.Henslow_Sparrow/Henslow_Sparrow_0112_116845.jpg,500,375,123.Henslow_Sparrow,167,115,392,300,279,207,225,185
../../CUB_200_2011/images\123.Henslow_Sparrow/Henslow_Sparrow_0054_116850.jpg,500,333,123.Henslow_Sparrow,202,114,304,225,253,169,102,111
../../CUB_200_2011/images\123.Henslow_Sparrow/Henslow_Sparrow_0104_796541.jpg,214,234,123.Henslow_Sparrow,31,36,150,180,90,108,119,144
../../CUB_200_2011/images\123.Henslow_Sparrow/Henslow_Sparrow_0026_796542.jpg,330,219,123.Henslow_Sparrow,33,22,279,194,156,108,246,172
../../CUB_200_2011/images\123.Henslow_Sparrow/Henslow_Sparrow_0027_796543.jpg,391,242,123.Henslow_Sparrow,106,64,376,194,241,129,270,130
../../CUB_200_2011/images\123.Henslow_Sparrow/Henslow_Sparrow_0086_796545.jpg,250,247,123.Henslow_Sparrow,35,25,242,213,138,119,207,188
../../CUB_200_2011/images\123.Henslow_Sparrow/Henslow_Sparrow_0055_796557.jpg,362,500,123.Henslow_Sparrow,70,41,239,483,154,262,169,442
../../CUB_200_2011/images\123.Henslow_Sparrow/Henslow_Sparrow_0040_116882.jpg,500,394,123.Henslow_Sparrow,153,70,371,341,262,205,218,271
../../CUB_200_2011/images\123.Henslow_Sparrow/Henslow_Sparrow_0100_796565.jpg,400,361,123.Henslow_Sparrow,19,53,293,310,156,181,274,257
../../CUB_200_2011/images\123.Henslow_Sparrow/Henslow_Sparrow_0099_796567.jpg,375,500,123.Henslow_Sparrow,128,80,290,284,209,182,162,204
../../CUB_200_2011/images\123.Henslow_Sparrow/Henslow_Sparrow_0011_796568.jpg,500,355,123.Henslow_Sparrow,103,31,335,214,219,122,232,183
../../CUB_200_2011/images\123.Henslow_Sparrow/Henslow_Sparrow_0059_796569.jpg,418,328,123.Henslow_Sparrow,37,68,292,318,164,193,255,250
../../CUB_200_2011/images\123.Henslow_Sparrow/Henslow_Sparrow_0030_116890.jpg,500,375,123.Henslow_Sparrow,95,115,232,310,163,212,137,195
../../CUB_200_2011/images\123.Henslow_Sparrow/Henslow_Sparrow_0070_796571.jpg,500,375,123.Henslow_Sparrow,147,41,352,281,249,161,205,240
../../CUB_200_2011/images\123.Henslow_Sparrow/Henslow_Sparrow_0041_796572.jpg,500,375,123.Henslow_Sparrow,99,108,255,278,177,193,156,170
../../CUB_200_2011/images\123.Henslow_Sparrow/Henslow_Sparrow_0028_796570.jpg,500,479,123.Henslow_Sparrow,14,56,382,475,198,265,368,419
../../CUB_200_2011/images\123.Henslow_Sparrow/Henslow_Sparrow_0109_796577.jpg,500,371,123.Henslow_Sparrow,151,73,462,307,306,190,311,234
../../CUB_200_2011/images\123.Henslow_Sparrow/Henslow_Sparrow_0013_796578.jpg,288,298,123.Henslow_Sparrow,46,19,268,288,157,153,222,269
../../CUB_200_2011/images\123.Henslow_Sparrow/Henslow_Sparrow_0037_796579.jpg,300,361,123.Henslow_Sparrow,50,50,276,334,163,192,226,284
../../CUB_200_2011/images\123.Henslow_Sparrow/Henslow_Sparrow_0106_796580.jpg,500,383,123.Henslow_Sparrow,79,58,474,339,276,198,395,281
../../CUB_200_2011/images\123.Henslow_Sparrow/Henslow_Sparrow_0023_796582.jpg,500,403,123.Henslow_Sparrow,130,78,433,350,281,214,303,272
../../CUB_200_2011/images\123.Henslow_Sparrow/Henslow_Sparrow_0074_116905.jpg,461,489,123.Henslow_Sparrow,136,123,347,364,241,243,211,241
../../CUB_200_2011/images\123.Henslow_Sparrow/Henslow_Sparrow_0084_796587.jpg,500,371,123.Henslow_Sparrow,94,36,463,348,278,192,369,312
../../CUB_200_2011/images\123.Henslow_Sparrow/Henslow_Sparrow_0039_796589.jpg,340,500,123.Henslow_Sparrow,92,108,297,384,194,246,205,276
../../CUB_200_2011/images\123.Henslow_Sparrow/Henslow_Sparrow_0064_796573.jpg,500,373,123.Henslow_Sparrow,186,87,313,279,249,183,127,192
../../CUB_200_2011/images\123.Henslow_Sparrow/Henslow_Sparrow_0108_796592.jpg,479,500,123.Henslow_Sparrow,150,129,414,417,282,273,264,288
../../CUB_200_2011/images\123.Henslow_Sparrow/Henslow_Sparrow_0015_796593.jpg,256,320,123.Henslow_Sparrow,60,87,166,258,113,172,106,171
../../CUB_200_2011/images\123.Henslow_Sparrow/Henslow_Sparrow_0031_796594.jpg,400,274,123.Henslow_Sparrow,60,35,219,267,139,151,159,232
../../CUB_200_2011/images\123.Henslow_Sparrow/Henslow_Sparrow_0052_796599.jpg,403,500,123.Henslow_Sparrow,73,43,392,493,232,268,319,450
../../CUB_200_2011/images\123.Henslow_Sparrow/Henslow_Sparrow_0010_796600.jpg,500,375,123.Henslow_Sparrow,151,48,322,314,236,181,171,266
../../CUB_200_2011/images\123.Henslow_Sparrow/Henslow_Sparrow_0098_796601.jpg,500,375,123.Henslow_Sparrow,28,31,318,352,173,191,290,321
../../CUB_200_2011/images\123.Henslow_Sparrow/Henslow_Sparrow_0034_796602.jpg,500,398,123.Henslow_Sparrow,180,95,308,309,244,202,128,214
../../CUB_200_2011/images\123.Henslow_Sparrow/Henslow_Sparrow_0033_796605.jpg,477,500,123.Henslow_Sparrow,32,59,383,423,207,241,351,364
../../CUB_200_2011/images\123.Henslow_Sparrow/Henslow_Sparrow_0006_796607.jpg,500,375,123.Henslow_Sparrow,138,32,394,301,266,166,256,269
../../CUB_200_2011/images\123.Henslow_Sparrow/Henslow_Sparrow_0002_116930.jpg,500,333,123.Henslow_Sparrow,168,92,351,282,259,187,183,190
../../CUB_200_2011/images\123.Henslow_Sparrow/Henslow_Sparrow_0021_116931.jpg,500,375,123.Henslow_Sparrow,155,32,389,254,272,143,234,222
../../CUB_200_2011/images\123.Henslow_Sparrow/Henslow_Sparrow_0107_796614.jpg,300,237,123.Henslow_Sparrow,7,59,164,223,85,141,157,164
../../CUB_200_2011/images\123.Henslow_Sparrow/Henslow_Sparrow_0068_796615.jpg,250,212,123.Henslow_Sparrow,55,33,214,201,134,117,159,168
../../CUB_200_2011/images\123.Henslow_Sparrow/Henslow_Sparrow_0058_796616.jpg,300,380,123.Henslow_Sparrow,86,79,296,315,191,197,210,236
../../CUB_200_2011/images\123.Henslow_Sparrow/Henslow_Sparrow_0060_796619.jpg,500,333,123.Henslow_Sparrow,140,107,314,216,227,161,174,109
../../CUB_200_2011/images\123.Henslow_Sparrow/Henslow_Sparrow_0087_116942.jpg,500,333,123.Henslow_Sparrow,200,117,339,308,269,212,139,191
../../CUB_200_2011/images\123.Henslow_Sparrow/Henslow_Sparrow_0085_116971.jpg,500,500,123.Henslow_Sparrow,138,156,474,421,306,288,336,265
../../CUB_200_2011/images\123.Henslow_Sparrow/Henslow_Sparrow_0056_796585.jpg,500,394,123.Henslow_Sparrow,148,127,368,292,258,209,220,165
../../CUB_200_2011/images\124.Le_Conte_Sparrow/Le_Conte_Sparrow_0005_795137.jpg,500,361,124.Le_Conte_Sparrow,35,105,364,283,199,194,329,178
../../CUB_200_2011/images\124.Le_Conte_Sparrow/Le_Conte_Sparrow_0020_117035.jpg,500,500,124.Le_Conte_Sparrow,119,166,312,418,215,292,193,252
../../CUB_200_2011/images\124.Le_Conte_Sparrow/Le_Conte_Sparrow_0050_795143.jpg,500,368,124.Le_Conte_Sparrow,118,73,285,337,201,205,167,264
../../CUB_200_2011/images\124.Le_Conte_Sparrow/Le_Conte_Sparrow_0006_795146.jpg,400,500,124.Le_Conte_Sparrow,106,125,352,414,229,269,246,289
../../CUB_200_2011/images\124.Le_Conte_Sparrow/Le_Conte_Sparrow_0007_795148.jpg,500,396,124.Le_Conte_Sparrow,115,118,491,387,303,252,376,269
../../CUB_200_2011/images\124.Le_Conte_Sparrow/Le_Conte_Sparrow_0063_795149.jpg,350,332,124.Le_Conte_Sparrow,106,86,276,253,191,169,170,167
../../CUB_200_2011/images\124.Le_Conte_Sparrow/Le_Conte_Sparrow_0034_795150.jpg,500,400,124.Le_Conte_Sparrow,70,155,216,327,143,241,146,172
../../CUB_200_2011/images\124.Le_Conte_Sparrow/Le_Conte_Sparrow_0015_795152.jpg,500,333,124.Le_Conte_Sparrow,72,43,436,320,254,181,364,277
../../CUB_200_2011/images\124.Le_Conte_Sparrow/Le_Conte_Sparrow_0089_795154.jpg,341,400,124.Le_Conte_Sparrow,111,63,240,188,175,125,129,125
../../CUB_200_2011/images\124.Le_Conte_Sparrow/Le_Conte_Sparrow_0023_795156.jpg,500,363,124.Le_Conte_Sparrow,186,67,407,292,296,179,221,225
../../CUB_200_2011/images\124.Le_Conte_Sparrow/Le_Conte_Sparrow_0060_795160.jpg,500,429,124.Le_Conte_Sparrow,46,67,375,323,210,195,329,256
../../CUB_200_2011/images\124.Le_Conte_Sparrow/Le_Conte_Sparrow_0045_795162.jpg,500,359,124.Le_Conte_Sparrow,16,86,378,295,197,190,362,209
../../CUB_200_2011/images\124.Le_Conte_Sparrow/Le_Conte_Sparrow_0083_795163.jpg,500,369,124.Le_Conte_Sparrow,18,80,329,292,173,186,311,212
../../CUB_200_2011/images\124.Le_Conte_Sparrow/Le_Conte_Sparrow_0010_795166.jpg,500,444,124.Le_Conte_Sparrow,180,73,383,402,281,237,203,329
../../CUB_200_2011/images\124.Le_Conte_Sparrow/Le_Conte_Sparrow_0085_795167.jpg,230,286,124.Le_Conte_Sparrow,25,53,196,244,110,148,171,191
../../CUB_200_2011/images\124.Le_Conte_Sparrow/Le_Conte_Sparrow_0088_117040.jpg,500,328,124.Le_Conte_Sparrow,152,115,338,291,245,203,186,176
../../CUB_200_2011/images\124.Le_Conte_Sparrow/Le_Conte_Sparrow_0086_795170.jpg,240,171,124.Le_Conte_Sparrow,31,15,235,153,133,84,204,138
../../CUB_200_2011/images\124.Le_Conte_Sparrow/Le_Conte_Sparrow_0003_795175.jpg,500,384,124.Le_Conte_Sparrow,60,92,428,317,244,204,368,225
../../CUB_200_2011/images\124.Le_Conte_Sparrow/Le_Conte_Sparrow_0013_795176.jpg,500,349,124.Le_Conte_Sparrow,190,67,446,270,318,168,256,203
../../CUB_200_2011/images\124.Le_Conte_Sparrow/Le_Conte_Sparrow_0056_795178.jpg,500,471,124.Le_Conte_Sparrow,94,174,325,327,209,250,231,153
../../CUB_200_2011/images\124.Le_Conte_Sparrow/Le_Conte_Sparrow_0068_795180.jpg,500,343,124.Le_Conte_Sparrow,150,83,333,281,241,182,183,198
../../CUB_200_2011/images\124.Le_Conte_Sparrow/Le_Conte_Sparrow_0058_795181.jpg,483,384,124.Le_Conte_Sparrow,28,21,415,366,221,193,387,345
../../CUB_200_2011/images\124.Le_Conte_Sparrow/Le_Conte_Sparrow_0099_795182.jpg,500,373,124.Le_Conte_Sparrow,3,99,344,307,173,203,341,208
../../CUB_200_2011/images\124.Le_Conte_Sparrow/Le_Conte_Sparrow_0097_795183.jpg,500,380,124.Le_Conte_Sparrow,122,94,432,322,277,208,310,228
../../CUB_200_2011/images\124.Le_Conte_Sparrow/Le_Conte_Sparrow_0071_795185.jpg,140,191,124.Le_Conte_Sparrow,17,21,128,182,72,101,111,161
../../CUB_200_2011/images\124.Le_Conte_Sparrow/Le_Conte_Sparrow_0032_795186.jpg,500,366,124.Le_Conte_Sparrow,36,96,310,287,173,191,274,191
../../CUB_200_2011/images\124.Le_Conte_Sparrow/Le_Conte_Sparrow_0053_795187.jpg,500,468,124.Le_Conte_Sparrow,106,134,331,425,218,279,225,291
../../CUB_200_2011/images\124.Le_Conte_Sparrow/Le_Conte_Sparrow_0025_795188.jpg,436,500,124.Le_Conte_Sparrow,25,65,353,481,189,273,328,416
../../CUB_200_2011/images\124.Le_Conte_Sparrow/Le_Conte_Sparrow_0084_795189.jpg,488,500,124.Le_Conte_Sparrow,22,101,410,454,216,277,388,353
../../CUB_200_2011/images\124.Le_Conte_Sparrow/Le_Conte_Sparrow_0024_795190.jpg,500,356,124.Le_Conte_Sparrow,37,76,367,340,202,208,330,264
../../CUB_200_2011/images\124.Le_Conte_Sparrow/Le_Conte_Sparrow_0047_795192.jpg,175,134,124.Le_Conte_Sparrow,7,8,162,127,84,67,155,119
../../CUB_200_2011/images\124.Le_Conte_Sparrow/Le_Conte_Sparrow_0061_795194.jpg,500,478,124.Le_Conte_Sparrow,187,128,448,439,317,283,261,311
../../CUB_200_2011/images\124.Le_Conte_Sparrow/Le_Conte_Sparrow_0102_795195.jpg,500,350,124.Le_Conte_Sparrow,49,55,364,299,206,177,315,244
../../CUB_200_2011/images\124.Le_Conte_Sparrow/Le_Conte_Sparrow_0078_117052.jpg,500,352,124.Le_Conte_Sparrow,137,61,371,294,254,177,234,233
../../CUB_200_2011/images\124.Le_Conte_Sparrow/Le_Conte_Sparrow_0087_795198.jpg,300,263,124.Le_Conte_Sparrow,33,37,272,246,152,141,239,209
../../CUB_200_2011/images\124.Le_Conte_Sparrow/Le_Conte_Sparrow_0040_117088.jpg,500,332,124.Le_Conte_Sparrow,265,107,416,291,340,199,151,184
../../CUB_200_2011/images\124.Le_Conte_Sparrow/Le_Conte_Sparrow_0066_795206.jpg,352,500,124.Le_Conte_Sparrow,61,105,196,382,128,243,135,277
../../CUB_200_2011/images\124.Le_Conte_Sparrow/Le_Conte_Sparrow_0012_795211.jpg,500,333,124.Le_Conte_Sparrow,238,71,413,326,325,198,175,255
../../CUB_200_2011/images\124.Le_Conte_Sparrow/Le_Conte_Sparrow_0043_795213.jpg,333,500,124.Le_Conte_Sparrow,58,158,323,484,190,321,265,326
../../CUB_200_2011/images\124.Le_Conte_Sparrow/Le_Conte_Sparrow_0035_795214.jpg,500,382,124.Le_Conte_Sparrow,51,85,374,374,212,229,323,289
../../CUB_200_2011/images\124.Le_Conte_Sparrow/Le_Conte_Sparrow_0081_795215.jpg,500,357,124.Le_Conte_Sparrow,165,61,431,328,298,194,266,267
../../CUB_200_2011/images\124.Le_Conte_Sparrow/Le_Conte_Sparrow_0041_795218.jpg,500,333,124.Le_Conte_Sparrow,222,68,417,208,319,138,195,140
../../CUB_200_2011/images\124.Le_Conte_Sparrow/Le_Conte_Sparrow_0049_795220.jpg,500,375,124.Le_Conte_Sparrow,237,104,393,320,315,212,156,216
../../CUB_200_2011/images\124.Le_Conte_Sparrow/Le_Conte_Sparrow_0092_795221.jpg,500,333,124.Le_Conte_Sparrow,216,124,383,300,299,212,167,176
../../CUB_200_2011/images\124.Le_Conte_Sparrow/Le_Conte_Sparrow_0016_795223.jpg,320,214,124.Le_Conte_Sparrow,67,19,286,201,176,110,219,182
../../CUB_200_2011/images\124.Le_Conte_Sparrow/Le_Conte_Sparrow_0046_795227.jpg,372,500,124.Le_Conte_Sparrow,131,141,240,384,185,262,109,243
../../CUB_200_2011/images\124.Le_Conte_Sparrow/Le_Conte_Sparrow_0072_795230.jpg,500,500,124.Le_Conte_Sparrow,161,135,333,407,247,271,172,272
../../CUB_200_2011/images\124.Le_Conte_Sparrow/Le_Conte_Sparrow_0098_795231.jpg,500,378,124.Le_Conte_Sparrow,182,88,393,361,287,224,211,273
../../CUB_200_2011/images\124.Le_Conte_Sparrow/Le_Conte_Sparrow_0075_795234.jpg,500,342,124.Le_Conte_Sparrow,195,89,334,238,264,163,139,149
../../CUB_200_2011/images\124.Le_Conte_Sparrow/Le_Conte_Sparrow_0064_795235.jpg,500,337,124.Le_Conte_Sparrow,246,72,418,296,332,184,172,224
../../CUB_200_2011/images\124.Le_Conte_Sparrow/Le_Conte_Sparrow_0021_117105.jpg,500,400,124.Le_Conte_Sparrow,155,128,265,301,210,214,110,173
../../CUB_200_2011/images\124.Le_Conte_Sparrow/Le_Conte_Sparrow_0039_117054.jpg,500,499,124.Le_Conte_Sparrow,11,26,403,470,207,248,392,444
../../CUB_200_2011/images\124.Le_Conte_Sparrow/Le_Conte_Sparrow_0055_117036.jpg,500,369,124.Le_Conte_Sparrow,50,23,486,296,268,159,436,273
../../CUB_200_2011/images\124.Le_Conte_Sparrow/Le_Conte_Sparrow_0044_117116.jpg,500,367,124.Le_Conte_Sparrow,52,41,383,333,217,187,331,292
../../CUB_200_2011/images\124.Le_Conte_Sparrow/Le_Conte_Sparrow_0073_117127.jpg,500,333,124.Le_Conte_Sparrow,32,104,304,265,168,184,272,161
../../CUB_200_2011/images\124.Le_Conte_Sparrow/Le_Conte_Sparrow_0067_117146.jpg,500,372,124.Le_Conte_Sparrow,177,120,304,334,240,227,127,214
../../CUB_200_2011/images\124.Le_Conte_Sparrow/Le_Conte_Sparrow_0011_117038.jpg,500,375,124.Le_Conte_Sparrow,192,76,467,335,329,205,275,259
../../CUB_200_2011/images\124.Le_Conte_Sparrow/Le_Conte_Sparrow_0022_117039.jpg,500,333,124.Le_Conte_Sparrow,133,57,453,297,293,177,320,240
../../CUB_200_2011/images\124.Le_Conte_Sparrow/Le_Conte_Sparrow_0070_795135.jpg,500,363,124.Le_Conte_Sparrow,10,111,365,295,187,203,355,184
../../CUB_200_2011/images\125.Lincoln_Sparrow/Lincoln_Sparrow_0094_117762.jpg,500,318,125.Lincoln_Sparrow,130,102,333,206,231,154,203,104
../../CUB_200_2011/images\125.Lincoln_Sparrow/Lincoln_Sparrow_0108_117773.jpg,500,340,125.Lincoln_Sparrow,178,121,470,306,324,213,292,185
../../CUB_200_2011/images\125.Lincoln_Sparrow/Lincoln_Sparrow_0010_117263.jpg,500,357,125.Lincoln_Sparrow,127,87,279,279,203,183,152,192
../../CUB_200_2011/images\125.Lincoln_Sparrow/Lincoln_Sparrow_0110_117264.jpg,500,374,125.Lincoln_Sparrow,88,68,419,343,253,205,331,275
../../CUB_200_2011/images\125.Lincoln_Sparrow/Lincoln_Sparrow_0049_117265.jpg,500,400,125.Lincoln_Sparrow,187,104,429,359,308,231,242,255
../../CUB_200_2011/images\125.Lincoln_Sparrow/Lincoln_Sparrow_0119_117270.jpg,500,333,125.Lincoln_Sparrow,171,84,390,280,280,182,219,196
../../CUB_200_2011/images\125.Lincoln_Sparrow/Lincoln_Sparrow_0059_117271.jpg,500,370,125.Lincoln_Sparrow,107,32,423,286,265,159,316,254
../../CUB_200_2011/images\125.Lincoln_Sparrow/Lincoln_Sparrow_0083_117272.jpg,500,333,125.Lincoln_Sparrow,111,26,345,299,228,162,234,273
../../CUB_200_2011/images\125.Lincoln_Sparrow/Lincoln_Sparrow_0131_117277.jpg,500,334,125.Lincoln_Sparrow,50,61,333,255,191,158,283,194
../../CUB_200_2011/images\125.Lincoln_Sparrow/Lincoln_Sparrow_0036_117280.jpg,500,350,125.Lincoln_Sparrow,68,81,293,259,180,170,225,178
../../CUB_200_2011/images\125.Lincoln_Sparrow/Lincoln_Sparrow_0092_117294.jpg,500,375,125.Lincoln_Sparrow,173,85,409,288,291,186,236,203
../../CUB_200_2011/images\125.Lincoln_Sparrow/Lincoln_Sparrow_0069_117812.jpg,500,424,125.Lincoln_Sparrow,19,27,381,333,200,180,362,306
../../CUB_200_2011/images\125.Lincoln_Sparrow/Lincoln_Sparrow_0033_117303.jpg,500,399,125.Lincoln_Sparrow,64,120,406,303,235,211,342,183
../../CUB_200_2011/images\125.Lincoln_Sparrow/Lincoln_Sparrow_0100_117835.jpg,500,333,125.Lincoln_Sparrow,188,85,339,296,263,190,151,211
../../CUB_200_2011/images\125.Lincoln_Sparrow/Lincoln_Sparrow_0037_117837.jpg,500,376,125.Lincoln_Sparrow,90,107,348,244,219,175,258,137
../../CUB_200_2011/images\125.Lincoln_Sparrow/Lincoln_Sparrow_0113_117603.jpg,500,333,125.Lincoln_Sparrow,71,87,363,283,217,185,292,196
../../CUB_200_2011/images\125.Lincoln_Sparrow/Lincoln_Sparrow_0057_117334.jpg,500,334,125.Lincoln_Sparrow,83,67,296,265,189,166,213,198
../../CUB_200_2011/images\125.Lincoln_Sparrow/Lincoln_Sparrow_0128_117851.jpg,343,500,125.Lincoln_Sparrow,76,102,255,305,165,203,179,203
../../CUB_200_2011/images\125.Lincoln_Sparrow/Lincoln_Sparrow_0070_117342.jpg,500,332,125.Lincoln_Sparrow,25,88,214,307,119,197,189,219
../../CUB_200_2011/images\125.Lincoln_Sparrow/Lincoln_Sparrow_0090_117857.jpg,500,375,125.Lincoln_Sparrow,104,61,352,277,228,169,248,216
../../CUB_200_2011/images\125.Lincoln_Sparrow/Lincoln_Sparrow_0066_117875.jpg,500,328,125.Lincoln_Sparrow,70,86,336,295,203,190,266,209
../../CUB_200_2011/images\125.Lincoln_Sparrow/Lincoln_Sparrow_0014_117883.jpg,432,288,125.Lincoln_Sparrow,74,64,274,249,174,156,200,185
../../CUB_200_2011/images\125.Lincoln_Sparrow/Lincoln_Sparrow_0116_117372.jpg,335,500,125.Lincoln_Sparrow,102,106,330,468,216,287,228,362
../../CUB_200_2011/images\125.Lincoln_Sparrow/Lincoln_Sparrow_0035_117383.jpg,375,500,125.Lincoln_Sparrow,91,151,236,314,163,232,145,163
../../CUB_200_2011/images\125.Lincoln_Sparrow/Lincoln_Sparrow_0129_117898.jpg,500,407,125.Lincoln_Sparrow,184,113,324,291,254,202,140,178
../../CUB_200_2011/images\125.Lincoln_Sparrow/Lincoln_Sparrow_0046_117405.jpg,500,417,125.Lincoln_Sparrow,4,123,322,411,163,267,318,288
../../CUB_200_2011/images\125.Lincoln_Sparrow/Lincoln_Sparrow_0079_117919.jpg,500,471,125.Lincoln_Sparrow,40,41,494,418,267,229,454,377
../../CUB_200_2011/images\125.Lincoln_Sparrow/Lincoln_Sparrow_0109_117940.jpg,500,350,125.Lincoln_Sparrow,29,1,458,338,243,169,429,337
../../CUB_200_2011/images\125.Lincoln_Sparrow/Lincoln_Sparrow_0017_117432.jpg,500,333,125.Lincoln_Sparrow,51,89,305,261,178,175,254,172
../../CUB_200_2011/images\125.Lincoln_Sparrow/Lincoln_Sparrow_0072_117951.jpg,500,333,125.Lincoln_Sparrow,216,24,498,210,357,117,282,186
../../CUB_200_2011/images\125.Lincoln_Sparrow/Lincoln_Sparrow_0047_117442.jpg,500,377,125.Lincoln_Sparrow,96,20,395,320,245,170,299,300
../../CUB_200_2011/images\125.Lincoln_Sparrow/Lincoln_Sparrow_0087_117444.jpg,500,404,125.Lincoln_Sparrow,156,117,382,338,269,227,226,221
../../CUB_200_2011/images\125.Lincoln_Sparrow/Lincoln_Sparrow_0038_117461.jpg,500,333,125.Lincoln_Sparrow,173,68,498,282,335,175,325,214
../../CUB_200_2011/images\125.Lincoln_Sparrow/Lincoln_Sparrow_0099_117482.jpg,500,334,125.Lincoln_Sparrow,172,66,472,252,322,159,300,186
../../CUB_200_2011/images\125.Lincoln_Sparrow/Lincoln_Sparrow_0078_117483.jpg,500,333,125.Lincoln_Sparrow,166,70,460,284,313,177,294,214
../../CUB_200_2011/images\125.Lincoln_Sparrow/Lincoln_Sparrow_0084_117492.jpg,439,500,125.Lincoln_Sparrow,39,175,369,384,204,279,330,209
../../CUB_200_2011/images\125.Lincoln_Sparrow/Lincoln_Sparrow_0058_117503.jpg,402,500,125.Lincoln_Sparrow,141,142,324,337,232,239,183,195
../../CUB_200_2011/images\125.Lincoln_Sparrow/Lincoln_Sparrow_0055_117506.jpg,500,344,125.Lincoln_Sparrow,56,78,363,332,209,205,307,254
../../CUB_200_2011/images\125.Lincoln_Sparrow/Lincoln_Sparrow_0042_117507.jpg,354,500,125.Lincoln_Sparrow,99,201,220,343,159,272,121,142
../../CUB_200_2011/images\125.Lincoln_Sparrow/Lincoln_Sparrow_0063_117509.jpg,500,333,125.Lincoln_Sparrow,163,62,323,298,243,180,160,236
../../CUB_200_2011/images\125.Lincoln_Sparrow/Lincoln_Sparrow_0052_117521.jpg,500,418,125.Lincoln_Sparrow,113,95,420,365,266,230,307,270
../../CUB_200_2011/images\125.Lincoln_Sparrow/Lincoln_Sparrow_0089_117527.jpg,500,375,125.Lincoln_Sparrow,143,152,271,261,207,206,128,109
../../CUB_200_2011/images\125.Lincoln_Sparrow/Lincoln_Sparrow_0061_117529.jpg,500,375,125.Lincoln_Sparrow,105,93,347,311,226,202,242,218
../../CUB_200_2011/images\125.Lincoln_Sparrow/Lincoln_Sparrow_0009_117535.jpg,500,370,125.Lincoln_Sparrow,172,107,405,259,288,183,233,152
../../CUB_200_2011/images\125.Lincoln_Sparrow/Lincoln_Sparrow_0020_117542.jpg,500,368,125.Lincoln_Sparrow,119,129,375,279,247,204,256,150
../../CUB_200_2011/images\125.Lincoln_Sparrow/Lincoln_Sparrow_0045_117547.jpg,500,333,125.Lincoln_Sparrow,68,101,316,274,192,187,248,173
../../CUB_200_2011/images\125.Lincoln_Sparrow/Lincoln_Sparrow_0074_117584.jpg,500,333,125.Lincoln_Sparrow,145,76,410,269,277,172,265,193
../../CUB_200_2011/images\125.Lincoln_Sparrow/Lincoln_Sparrow_0064_117602.jpg,500,333,125.Lincoln_Sparrow,161,95,444,312,302,203,283,217
../../CUB_200_2011/images\125.Lincoln_Sparrow/Lincoln_Sparrow_0112_117631.jpg,500,454,125.Lincoln_Sparrow,141,164,339,317,240,240,198,153
../../CUB_200_2011/images\125.Lincoln_Sparrow/Lincoln_Sparrow_0088_117634.jpg,500,357,125.Lincoln_Sparrow,215,51,330,196,272,123,115,145
../../CUB_200_2011/images\125.Lincoln_Sparrow/Lincoln_Sparrow_0041_117636.jpg,500,376,125.Lincoln_Sparrow,132,127,436,267,284,197,304,140
../../CUB_200_2011/images\125.Lincoln_Sparrow/Lincoln_Sparrow_0044_117687.jpg,500,397,125.Lincoln_Sparrow,86,92,344,360,215,226,258,268
../../CUB_200_2011/images\125.Lincoln_Sparrow/Lincoln_Sparrow_0013_117202.jpg,357,500,125.Lincoln_Sparrow,18,86,305,292,161,189,287,206
../../CUB_200_2011/images\125.Lincoln_Sparrow/Lincoln_Sparrow_0040_117721.jpg,500,333,125.Lincoln_Sparrow,153,60,499,317,326,188,346,257
../../CUB_200_2011/images\125.Lincoln_Sparrow/Lincoln_Sparrow_0115_117216.jpg,500,389,125.Lincoln_Sparrow,61,110,479,371,270,240,418,261
../../CUB_200_2011/images\125.Lincoln_Sparrow/Lincoln_Sparrow_0050_117744.jpg,500,375,125.Lincoln_Sparrow,62,117,304,322,183,219,242,205
../../CUB_200_2011/images\125.Lincoln_Sparrow/Lincoln_Sparrow_0032_117747.jpg,500,408,125.Lincoln_Sparrow,92,61,443,396,267,228,351,335
../../CUB_200_2011/images\125.Lincoln_Sparrow/Lincoln_Sparrow_0026_117754.jpg,461,500,125.Lincoln_Sparrow,103,91,337,448,220,269,234,357
../../CUB_200_2011/images\125.Lincoln_Sparrow/Lincoln_Sparrow_0022_117759.jpg,500,430,125.Lincoln_Sparrow,160,62,339,359,249,210,179,297
../../CUB_200_2011/images\126.Nelson_Sharp_tailed_Sparrow/Nelson_Sharp_Tailed_Sparrow_0068_796930.jpg,500,412,126.Nelson_Sharp_tailed_Sparrow,31,52,397,390,214,221,366,338
../../CUB_200_2011/images\126.Nelson_Sharp_tailed_Sparrow/Nelson_Sharp_Tailed_Sparrow_0001_796931.jpg,350,350,126.Nelson_Sharp_tailed_Sparrow,82,36,278,334,180,185,196,298
../../CUB_200_2011/images\126.Nelson_Sharp_tailed_Sparrow/Nelson_Sharp_Tailed_Sparrow_0044_796932.jpg,350,389,126.Nelson_Sharp_tailed_Sparrow,91,27,284,367,187,197,193,340
../../CUB_200_2011/images\126.Nelson_Sharp_tailed_Sparrow/Nelson_Sharp_Tailed_Sparrow_0065_796933.jpg,400,291,126.Nelson_Sharp_tailed_Sparrow,182,27,337,283,259,155,155,256
../../CUB_200_2011/images\126.Nelson_Sharp_tailed_Sparrow/Nelson_Sharp_Tailed_Sparrow_0079_796934.jpg,500,402,126.Nelson_Sharp_tailed_Sparrow,77,95,361,358,219,226,284,263
../../CUB_200_2011/images\126.Nelson_Sharp_tailed_Sparrow/Nelson_Sharp_Tailed_Sparrow_0058_118023.jpg,333,500,126.Nelson_Sharp_tailed_Sparrow,66,121,255,464,160,292,189,343
../../CUB_200_2011/images\126.Nelson_Sharp_tailed_Sparrow/Nelson_Sharp_Tailed_Sparrow_0033_118024.jpg,500,333,126.Nelson_Sharp_tailed_Sparrow,174,67,337,242,255,154,163,175
../../CUB_200_2011/images\126.Nelson_Sharp_tailed_Sparrow/Nelson_Sharp_Tailed_Sparrow_0027_118028.jpg,500,333,126.Nelson_Sharp_tailed_Sparrow,190,33,404,324,297,178,214,291
../../CUB_200_2011/images\126.Nelson_Sharp_tailed_Sparrow/Nelson_Sharp_Tailed_Sparrow_0004_796941.jpg,500,424,126.Nelson_Sharp_tailed_Sparrow,135,119,430,414,282,266,295,295
../../CUB_200_2011/images\126.Nelson_Sharp_tailed_Sparrow/Nelson_Sharp_Tailed_Sparrow_0013_796942.jpg,400,429,126.Nelson_Sharp_tailed_Sparrow,75,59,352,378,213,218,277,319
../../CUB_200_2011/images\126.Nelson_Sharp_tailed_Sparrow/Nelson_Sharp_Tailed_Sparrow_0046_118032.jpg,357,500,126.Nelson_Sharp_tailed_Sparrow,150,166,342,412,246,289,192,246
../../CUB_200_2011/images\126.Nelson_Sharp_tailed_Sparrow/Nelson_Sharp_Tailed_Sparrow_0049_118033.jpg,500,384,126.Nelson_Sharp_tailed_Sparrow,231,151,369,284,300,217,138,133
../../CUB_200_2011/images\126.Nelson_Sharp_tailed_Sparrow/Nelson_Sharp_Tailed_Sparrow_0032_118036.jpg,500,345,126.Nelson_Sharp_tailed_Sparrow,185,104,315,280,250,192,130,176
../../CUB_200_2011/images\126.Nelson_Sharp_tailed_Sparrow/Nelson_Sharp_Tailed_Sparrow_0057_796949.jpg,230,158,126.Nelson_Sharp_tailed_Sparrow,6,14,155,143,80,78,149,129
../../CUB_200_2011/images\126.Nelson_Sharp_tailed_Sparrow/Nelson_Sharp_Tailed_Sparrow_0034_796950.jpg,369,500,126.Nelson_Sharp_tailed_Sparrow,6,68,277,450,141,259,271,382
../../CUB_200_2011/images\126.Nelson_Sharp_tailed_Sparrow/Nelson_Sharp_Tailed_Sparrow_0030_118064.jpg,334,500,126.Nelson_Sharp_tailed_Sparrow,38,67,303,450,170,258,265,383
../../CUB_200_2011/images\126.Nelson_Sharp_tailed_Sparrow/Nelson_Sharp_Tailed_Sparrow_0054_796936.jpg,407,500,126.Nelson_Sharp_tailed_Sparrow,209,54,371,388,290,221,162,334
../../CUB_200_2011/images\126.Nelson_Sharp_tailed_Sparrow/Nelson_Sharp_Tailed_Sparrow_0019_118066.jpg,406,500,126.Nelson_Sharp_tailed_Sparrow,84,88,390,424,237,256,306,336
../../CUB_200_2011/images\126.Nelson_Sharp_tailed_Sparrow/Nelson_Sharp_Tailed_Sparrow_0072_118012.jpg,401,500,126.Nelson_Sharp_tailed_Sparrow,97,101,284,442,190,271,187,341
../../CUB_200_2011/images\126.Nelson_Sharp_tailed_Sparrow/Nelson_Sharp_Tailed_Sparrow_0053_118069.jpg,500,333,126.Nelson_Sharp_tailed_Sparrow,156,70,285,282,220,176,129,212
../../CUB_200_2011/images\126.Nelson_Sharp_tailed_Sparrow/Nelson_Sharp_Tailed_Sparrow_0055_796937.jpg,500,344,126.Nelson_Sharp_tailed_Sparrow,245,107,403,283,324,195,158,176
../../CUB_200_2011/images\126.Nelson_Sharp_tailed_Sparrow/Nelson_Sharp_Tailed_Sparrow_0039_118074.jpg,500,333,126.Nelson_Sharp_tailed_Sparrow,187,93,367,253,277,173,180,160
../../CUB_200_2011/images\126.Nelson_Sharp_tailed_Sparrow/Nelson_Sharp_Tailed_Sparrow_0036_118075.jpg,451,374,126.Nelson_Sharp_tailed_Sparrow,118,73,350,288,234,180,232,215
../../CUB_200_2011/images\126.Nelson_Sharp_tailed_Sparrow/Nelson_Sharp_Tailed_Sparrow_0016_118077.jpg,500,440,126.Nelson_Sharp_tailed_Sparrow,35,54,477,412,256,233,442,358
../../CUB_200_2011/images\126.Nelson_Sharp_tailed_Sparrow/Nelson_Sharp_Tailed_Sparrow_0005_118078.jpg,500,368,126.Nelson_Sharp_tailed_Sparrow,172,107,293,216,232,161,121,109
../../CUB_200_2011/images\126.Nelson_Sharp_tailed_Sparrow/Nelson_Sharp_Tailed_Sparrow_0066_118088.jpg,375,500,126.Nelson_Sharp_tailed_Sparrow,62,71,194,196,128,133,132,125
../../CUB_200_2011/images\126.Nelson_Sharp_tailed_Sparrow/Nelson_Sharp_Tailed_Sparrow_0009_796940.jpg,500,334,126.Nelson_Sharp_tailed_Sparrow,106,44,324,291,215,167,218,247
../../CUB_200_2011/images\126.Nelson_Sharp_tailed_Sparrow/Nelson_Sharp_Tailed_Sparrow_0024_118010.jpg,500,375,126.Nelson_Sharp_tailed_Sparrow,145,54,432,311,288,182,287,257
../../CUB_200_2011/images\126.Nelson_Sharp_tailed_Sparrow/Nelson_Sharp_Tailed_Sparrow_0008_796944.jpg,500,330,126.Nelson_Sharp_tailed_Sparrow,147,83,480,284,313,183,333,201
../../CUB_200_2011/images\126.Nelson_Sharp_tailed_Sparrow/Nelson_Sharp_Tailed_Sparrow_0025_796945.jpg,333,500,126.Nelson_Sharp_tailed_Sparrow,146,130,297,417,221,273,151,287
../../CUB_200_2011/images\126.Nelson_Sharp_tailed_Sparrow/Nelson_Sharp_Tailed_Sparrow_0052_796903.jpg,356,500,126.Nelson_Sharp_tailed_Sparrow,171,220,306,373,238,296,135,153
../../CUB_200_2011/images\126.Nelson_Sharp_tailed_Sparrow/Nelson_Sharp_Tailed_Sparrow_0071_796946.jpg,489,500,126.Nelson_Sharp_tailed_Sparrow,98,71,207,367,152,219,109,296
../../CUB_200_2011/images\126.Nelson_Sharp_tailed_Sparrow/Nelson_Sharp_Tailed_Sparrow_0045_118004.jpg,363,500,126.Nelson_Sharp_tailed_Sparrow,150,203,286,386,218,294,136,183
../../CUB_200_2011/images\126.Nelson_Sharp_tailed_Sparrow/Nelson_Sharp_Tailed_Sparrow_0076_117964.jpg,500,334,126.Nelson_Sharp_tailed_Sparrow,280,57,412,323,346,190,132,266
../../CUB_200_2011/images\126.Nelson_Sharp_tailed_Sparrow/Nelson_Sharp_Tailed_Sparrow_0064_117965.jpg,473,500,126.Nelson_Sharp_tailed_Sparrow,122,143,235,299,178,221,113,156
../../CUB_200_2011/images\126.Nelson_Sharp_tailed_Sparrow/Nelson_Sharp_Tailed_Sparrow_0056_117974.jpg,333,500,126.Nelson_Sharp_tailed_Sparrow,63,126,185,285,124,205,122,159
../../CUB_200_2011/images\126.Nelson_Sharp_tailed_Sparrow/Nelson_Sharp_Tailed_Sparrow_0018_118011.jpg,333,500,126.Nelson_Sharp_tailed_Sparrow,44,137,165,308,104,222,121,171
../../CUB_200_2011/images\126.Nelson_Sharp_tailed_Sparrow/Nelson_Sharp_Tailed_Sparrow_0037_117986.jpg,500,333,126.Nelson_Sharp_tailed_Sparrow,41,64,306,319,173,191,265,255
../../CUB_200_2011/images\126.Nelson_Sharp_tailed_Sparrow/Nelson_Sharp_Tailed_Sparrow_0023_796899.jpg,500,383,126.Nelson_Sharp_tailed_Sparrow,52,46,461,282,256,164,409,236
../../CUB_200_2011/images\126.Nelson_Sharp_tailed_Sparrow/Nelson_Sharp_Tailed_Sparrow_0074_796901.jpg,500,400,126.Nelson_Sharp_tailed_Sparrow,203,131,328,279,265,205,125,148
../../CUB_200_2011/images\126.Nelson_Sharp_tailed_Sparrow/Nelson_Sharp_Tailed_Sparrow_0051_796902.jpg,433,500,126.Nelson_Sharp_tailed_Sparrow,99,161,294,471,196,316,195,310
../../CUB_200_2011/images\126.Nelson_Sharp_tailed_Sparrow/Nelson_Sharp_Tailed_Sparrow_0047_117991.jpg,341,477,126.Nelson_Sharp_tailed_Sparrow,52,126,274,360,163,243,222,234
../../CUB_200_2011/images\126.Nelson_Sharp_tailed_Sparrow/Nelson_Sharp_Tailed_Sparrow_0022_796905.jpg,275,275,126.Nelson_Sharp_tailed_Sparrow,26,33,242,237,134,135,216,204
../../CUB_200_2011/images\126.Nelson_Sharp_tailed_Sparrow/Nelson_Sharp_Tailed_Sparrow_0014_796906.jpg,500,364,126.Nelson_Sharp_tailed_Sparrow,185,141,322,290,253,215,137,149
../../CUB_200_2011/images\126.Nelson_Sharp_tailed_Sparrow/Nelson_Sharp_Tailed_Sparrow_0061_796907.jpg,500,335,126.Nelson_Sharp_tailed_Sparrow,214,81,369,263,291,172,155,182
../../CUB_200_2011/images\126.Nelson_Sharp_tailed_Sparrow/Nelson_Sharp_Tailed_Sparrow_0002_796908.jpg,500,400,126.Nelson_Sharp_tailed_Sparrow,52,87,397,340,224,213,345,253
../../CUB_200_2011/images\126.Nelson_Sharp_tailed_Sparrow/Nelson_Sharp_Tailed_Sparrow_0006_796909.jpg,500,368,126.Nelson_Sharp_tailed_Sparrow,200,57,419,348,309,202,219,291
../../CUB_200_2011/images\126.Nelson_Sharp_tailed_Sparrow/Nelson_Sharp_Tailed_Sparrow_0017_796910.jpg,350,261,126.Nelson_Sharp_tailed_Sparrow,41,17,323,222,182,119,282,205
../../CUB_200_2011/images\126.Nelson_Sharp_tailed_Sparrow/Nelson_Sharp_Tailed_Sparrow_0042_796911.jpg,500,448,126.Nelson_Sharp_tailed_Sparrow,81,72,311,413,196,242,230,341
../../CUB_200_2011/images\126.Nelson_Sharp_tailed_Sparrow/Nelson_Sharp_Tailed_Sparrow_0067_796912.jpg,368,500,126.Nelson_Sharp_tailed_Sparrow,39,155,259,446,149,300,220,291
../../CUB_200_2011/images\126.Nelson_Sharp_tailed_Sparrow/Nelson_Sharp_Tailed_Sparrow_0077_796913.jpg,333,500,126.Nelson_Sharp_tailed_Sparrow,51,141,208,300,129,220,157,159
../../CUB_200_2011/images\126.Nelson_Sharp_tailed_Sparrow/Nelson_Sharp_Tailed_Sparrow_0003_796917.jpg,400,500,126.Nelson_Sharp_tailed_Sparrow,120,70,313,366,216,218,193,296
../../CUB_200_2011/images\126.Nelson_Sharp_tailed_Sparrow/Nelson_Sharp_Tailed_Sparrow_0062_796919.jpg,500,417,126.Nelson_Sharp_tailed_Sparrow,193,96,364,372,278,234,171,276
../../CUB_200_2011/images\126.Nelson_Sharp_tailed_Sparrow/Nelson_Sharp_Tailed_Sparrow_0038_796920.jpg,389,500,126.Nelson_Sharp_tailed_Sparrow,110,134,270,402,190,268,160,268
../../CUB_200_2011/images\126.Nelson_Sharp_tailed_Sparrow/Nelson_Sharp_Tailed_Sparrow_0015_796922.jpg,500,488,126.Nelson_Sharp_tailed_Sparrow,183,131,429,379,306,255,246,248
../../CUB_200_2011/images\126.Nelson_Sharp_tailed_Sparrow/Nelson_Sharp_Tailed_Sparrow_0029_796923.jpg,500,390,126.Nelson_Sharp_tailed_Sparrow,221,142,419,280,320,211,198,138
../../CUB_200_2011/images\126.Nelson_Sharp_tailed_Sparrow/Nelson_Sharp_Tailed_Sparrow_0035_796924.jpg,500,416,126.Nelson_Sharp_tailed_Sparrow,135,77,416,362,275,219,281,285
../../CUB_200_2011/images\126.Nelson_Sharp_tailed_Sparrow/Nelson_Sharp_Tailed_Sparrow_0070_796925.jpg,484,500,126.Nelson_Sharp_tailed_Sparrow,142,82,414,441,278,261,272,359
../../CUB_200_2011/images\126.Nelson_Sharp_tailed_Sparrow/Nelson_Sharp_Tailed_Sparrow_0041_796926.jpg,461,500,126.Nelson_Sharp_tailed_Sparrow,70,93,371,411,220,252,301,318
../../CUB_200_2011/images\127.Savannah_Sparrow/Savannah_Sparrow_0048_120321.jpg,500,333,127.Savannah_Sparrow,104,74,367,304,235,189,263,230
../../CUB_200_2011/images\127.Savannah_Sparrow/Savannah_Sparrow_0023_120326.jpg,500,333,127.Savannah_Sparrow,85,27,373,294,229,160,288,267
../../CUB_200_2011/images\127.Savannah_Sparrow/Savannah_Sparrow_0059_119810.jpg,469,500,127.Savannah_Sparrow,86,118,312,404,199,261,226,286
../../CUB_200_2011/images\127.Savannah_Sparrow/Savannah_Sparrow_0064_119316.jpg,500,392,127.Savannah_Sparrow,169,117,291,257,230,187,122,140
../../CUB_200_2011/images\127.Savannah_Sparrow/Savannah_Sparrow_0106_118294.jpg,500,375,127.Savannah_Sparrow,125,65,482,298,303,181,357,233
../../CUB_200_2011/images\127.Savannah_Sparrow/Savannah_Sparrow_0079_118817.jpg,500,315,127.Savannah_Sparrow,24,106,237,289,130,197,213,183
../../CUB_200_2011/images\127.Savannah_Sparrow/Savannah_Sparrow_0124_118820.jpg,500,306,127.Savannah_Sparrow,180,74,377,265,278,169,197,191
../../CUB_200_2011/images\127.Savannah_Sparrow/Savannah_Sparrow_0058_118323.jpg,500,387,127.Savannah_Sparrow,1,26,367,385,184,205,366,359
../../CUB_200_2011/images\127.Savannah_Sparrow/Savannah_Sparrow_0096_120376.jpg,400,500,127.Savannah_Sparrow,63,101,307,325,185,213,244,224
../../CUB_200_2011/images\127.Savannah_Sparrow/Savannah_Sparrow_0043_119362.jpg,500,375,127.Savannah_Sparrow,99,64,334,313,216,188,235,249
../../CUB_200_2011/images\127.Savannah_Sparrow/Savannah_Sparrow_0047_119365.jpg,500,268,127.Savannah_Sparrow,96,7,346,264,221,135,250,257
../../CUB_200_2011/images\127.Savannah_Sparrow/Savannah_Sparrow_0075_116305.jpg,500,334,127.Savannah_Sparrow,84,89,205,232,144,160,121,143
../../CUB_200_2011/images\127.Savannah_Sparrow/Savannah_Sparrow_0033_118871.jpg,500,483,127.Savannah_Sparrow,187,164,396,337,291,250,209,173
../../CUB_200_2011/images\127.Savannah_Sparrow/Savannah_Sparrow_0115_118882.jpg,500,333,127.Savannah_Sparrow,84,33,406,321,245,177,322,288
../../CUB_200_2011/images\127.Savannah_Sparrow/Savannah_Sparrow_0045_119398.jpg,500,333,127.Savannah_Sparrow,266,103,438,239,352,171,172,136
../../CUB_200_2011/images\127.Savannah_Sparrow/Savannah_Sparrow_0021_118886.jpg,400,500,127.Savannah_Sparrow,78,135,360,316,219,225,282,181
../../CUB_200_2011/images\127.Savannah_Sparrow/Savannah_Sparrow_0117_119917.jpg,500,346,127.Savannah_Sparrow,68,68,261,319,164,193,193,251
../../CUB_200_2011/images\127.Savannah_Sparrow/Savannah_Sparrow_0015_118910.jpg,500,394,127.Savannah_Sparrow,157,109,283,377,220,243,126,268
../../CUB_200_2011/images\127.Savannah_Sparrow/Savannah_Sparrow_0131_119946.jpg,333,500,127.Savannah_Sparrow,35,121,307,391,171,256,272,270
../../CUB_200_2011/images\127.Savannah_Sparrow/Savannah_Sparrow_0066_119949.jpg,500,334,127.Savannah_Sparrow,162,28,337,304,249,166,175,276
../../CUB_200_2011/images\127.Savannah_Sparrow/Savannah_Sparrow_0008_118929.jpg,500,375,127.Savannah_Sparrow,196,112,498,374,347,243,302,262
../../CUB_200_2011/images\127.Savannah_Sparrow/Savannah_Sparrow_0139_119444.jpg,500,400,127.Savannah_Sparrow,189,75,358,246,273,160,169,171
../../CUB_200_2011/images\127.Savannah_Sparrow/Savannah_Sparrow_0132_119962.jpg,500,375,127.Savannah_Sparrow,191,90,297,303,244,196,106,213
../../CUB_200_2011/images\127.Savannah_Sparrow/Savannah_Sparrow_0011_119459.jpg,500,357,127.Savannah_Sparrow,89,110,242,307,165,208,153,197
../../CUB_200_2011/images\127.Savannah_Sparrow/Savannah_Sparrow_0068_119972.jpg,500,431,127.Savannah_Sparrow,65,60,383,390,224,225,318,330
../../CUB_200_2011/images\127.Savannah_Sparrow/Savannah_Sparrow_0001_118956.jpg,500,351,127.Savannah_Sparrow,37,35,324,303,180,169,287,268
../../CUB_200_2011/images\127.Savannah_Sparrow/Savannah_Sparrow_0028_119982.jpg,497,398,127.Savannah_Sparrow,13,54,334,281,173,167,321,227
../../CUB_200_2011/images\127.Savannah_Sparrow/Savannah_Sparrow_0022_118989.jpg,500,334,127.Savannah_Sparrow,69,59,353,320,211,189,284,261
../../CUB_200_2011/images\127.Savannah_Sparrow/Savannah_Sparrow_0057_120016.jpg,500,399,127.Savannah_Sparrow,149,87,375,337,262,212,226,250
../../CUB_200_2011/images\127.Savannah_Sparrow/Savannah_Sparrow_0067_118491.jpg,500,377,127.Savannah_Sparrow,163,51,416,323,289,187,253,272
../../CUB_200_2011/images\127.Savannah_Sparrow/Savannah_Sparrow_0054_120057.jpg,432,346,127.Savannah_Sparrow,37,82,348,284,192,183,311,202
../../CUB_200_2011/images\127.Savannah_Sparrow/Savannah_Sparrow_0084_120063.jpg,500,411,127.Savannah_Sparrow,227,134,364,254,295,194,137,120
../../CUB_200_2011/images\127.Savannah_Sparrow/Savannah_Sparrow_0094_119040.jpg,500,334,127.Savannah_Sparrow,110,44,321,282,215,163,211,238
../../CUB_200_2011/images\127.Savannah_Sparrow/Savannah_Sparrow_0014_120072.jpg,400,500,127.Savannah_Sparrow,71,77,313,374,192,225,242,297
../../CUB_200_2011/images\127.Savannah_Sparrow/Savannah_Sparrow_0136_119581.jpg,500,317,127.Savannah_Sparrow,82,100,260,273,171,186,178,173
../../CUB_200_2011/images\127.Savannah_Sparrow/Savannah_Sparrow_0035_120099.jpg,500,357,127.Savannah_Sparrow,168,117,459,275,313,196,291,158
../../CUB_200_2011/images\127.Savannah_Sparrow/Savannah_Sparrow_0049_119596.jpg,500,332,127.Savannah_Sparrow,236,100,392,251,314,175,156,151
../../CUB_200_2011/images\127.Savannah_Sparrow/Savannah_Sparrow_0032_120109.jpg,500,333,127.Savannah_Sparrow,197,102,384,246,290,174,187,144
../../CUB_200_2011/images\127.Savannah_Sparrow/Savannah_Sparrow_0051_118574.jpg,500,333,127.Savannah_Sparrow,223,114,346,286,284,200,123,172
../../CUB_200_2011/images\127.Savannah_Sparrow/Savannah_Sparrow_0091_120630.jpg,500,488,127.Savannah_Sparrow,69,142,258,457,163,299,189,315
../../CUB_200_2011/images\127.Savannah_Sparrow/Savannah_Sparrow_0052_118583.jpg,500,347,127.Savannah_Sparrow,29,92,306,262,167,177,277,170
../../CUB_200_2011/images\127.Savannah_Sparrow/Savannah_Sparrow_0135_119620.jpg,500,333,127.Savannah_Sparrow,119,113,311,252,215,182,192,139
../../CUB_200_2011/images\127.Savannah_Sparrow/Savannah_Sparrow_0029_119621.jpg,500,365,127.Savannah_Sparrow,187,103,404,305,295,204,217,202
../../CUB_200_2011/images\127.Savannah_Sparrow/Savannah_Sparrow_0118_118603.jpg,500,500,127.Savannah_Sparrow,18,21,376,359,197,190,358,338
../../CUB_200_2011/images\127.Savannah_Sparrow/Savannah_Sparrow_0025_119124.jpg,500,334,127.Savannah_Sparrow,152,57,393,303,272,180,241,246
../../CUB_200_2011/images\127.Savannah_Sparrow/Savannah_Sparrow_0116_118108.jpg,500,389,127.Savannah_Sparrow,141,66,419,321,280,193,278,255
../../CUB_200_2011/images\127.Savannah_Sparrow/Savannah_Sparrow_0080_118120.jpg,500,500,127.Savannah_Sparrow,114,238,452,464,283,351,338,226
../../CUB_200_2011/images\127.Savannah_Sparrow/Savannah_Sparrow_0095_119670.jpg,420,280,127.Savannah_Sparrow,94,42,303,238,198,140,209,196
../../CUB_200_2011/images\127.Savannah_Sparrow/Savannah_Sparrow_0107_119671.jpg,500,361,127.Savannah_Sparrow,284,120,448,304,366,212,164,184
../../CUB_200_2011/images\127.Savannah_Sparrow/Savannah_Sparrow_0062_120185.jpg,333,500,127.Savannah_Sparrow,65,158,237,326,151,242,172,168
../../CUB_200_2011/images\127.Savannah_Sparrow/Savannah_Sparrow_0109_119674.jpg,500,333,127.Savannah_Sparrow,23,59,366,273,194,166,343,214
../../CUB_200_2011/images\127.Savannah_Sparrow/Savannah_Sparrow_0017_119171.jpg,500,375,127.Savannah_Sparrow,128,87,448,342,288,214,320,255
../../CUB_200_2011/images\127.Savannah_Sparrow/Savannah_Sparrow_0009_120205.jpg,500,375,127.Savannah_Sparrow,196,72,400,284,298,178,204,212
../../CUB_200_2011/images\127.Savannah_Sparrow/Savannah_Sparrow_0005_119735.jpg,500,379,127.Savannah_Sparrow,36,58,394,324,215,191,358,266
../../CUB_200_2011/images\127.Savannah_Sparrow/Savannah_Sparrow_0019_118200.jpg,386,500,127.Savannah_Sparrow,137,138,327,370,232,254,190,232
../../CUB_200_2011/images\127.Savannah_Sparrow/Savannah_Sparrow_0114_119750.jpg,500,375,127.Savannah_Sparrow,143,133,302,289,222,211,159,156
../../CUB_200_2011/images\127.Savannah_Sparrow/Savannah_Sparrow_0076_120267.jpg,500,375,127.Savannah_Sparrow,199,5,354,329,276,167,155,324
../../CUB_200_2011/images\127.Savannah_Sparrow/Savannah_Sparrow_0137_119757.jpg,500,375,127.Savannah_Sparrow,123,3,322,351,222,177,199,348
../../CUB_200_2011/images\127.Savannah_Sparrow/Savannah_Sparrow_0061_119783.jpg,500,333,127.Savannah_Sparrow,134,18,413,262,273,140,279,244
../../CUB_200_2011/images\127.Savannah_Sparrow/Savannah_Sparrow_0093_118267.jpg,384,500,127.Savannah_Sparrow,163,95,296,373,229,234,133,278
../../CUB_200_2011/images\128.Seaside_Sparrow/Seaside_Sparrow_0052_796498.jpg,333,500,128.Seaside_Sparrow,33,81,229,368,131,224,196,287
../../CUB_200_2011/images\128.Seaside_Sparrow/Seaside_Sparrow_0015_796500.jpg,446,408,128.Seaside_Sparrow,78,46,304,362,191,204,226,316
../../CUB_200_2011/images\128.Seaside_Sparrow/Seaside_Sparrow_0062_796503.jpg,375,500,128.Seaside_Sparrow,143,99,358,487,250,293,215,388
../../CUB_200_2011/images\128.Seaside_Sparrow/Seaside_Sparrow_0065_796504.jpg,381,500,128.Seaside_Sparrow,129,144,327,426,228,285,198,282
../../CUB_200_2011/images\128.Seaside_Sparrow/Seaside_Sparrow_0033_796506.jpg,500,333,128.Seaside_Sparrow,197,46,411,330,304,188,214,284
../../CUB_200_2011/images\128.Seaside_Sparrow/Seaside_Sparrow_0054_796507.jpg,333,500,128.Seaside_Sparrow,39,111,220,430,129,270,181,319
../../CUB_200_2011/images\128.Seaside_Sparrow/Seaside_Sparrow_0050_796508.jpg,500,332,128.Seaside_Sparrow,170,43,335,220,252,131,165,177
../../CUB_200_2011/images\128.Seaside_Sparrow/Seaside_Sparrow_0043_796510.jpg,500,332,128.Seaside_Sparrow,58,26,295,198,176,112,237,172
../../CUB_200_2011/images\128.Seaside_Sparrow/Seaside_Sparrow_0027_796512.jpg,333,500,128.Seaside_Sparrow,46,201,170,463,108,332,124,262
../../CUB_200_2011/images\128.Seaside_Sparrow/Seaside_Sparrow_0017_796513.jpg,450,295,128.Seaside_Sparrow,11,27,434,288,222,157,423,261
../../CUB_200_2011/images\128.Seaside_Sparrow/Seaside_Sparrow_0004_796514.jpg,336,500,128.Seaside_Sparrow,132,104,236,377,184,240,104,273
../../CUB_200_2011/images\128.Seaside_Sparrow/Seaside_Sparrow_0068_796515.jpg,500,345,128.Seaside_Sparrow,134,114,286,246,210,180,152,132
../../CUB_200_2011/images\128.Seaside_Sparrow/Seaside_Sparrow_0005_796516.jpg,328,500,128.Seaside_Sparrow,51,70,253,445,152,257,202,375
../../CUB_200_2011/images\128.Seaside_Sparrow/Seaside_Sparrow_0025_796518.jpg,500,332,128.Seaside_Sparrow,20,28,328,288,174,158,308,260
../../CUB_200_2011/images\128.Seaside_Sparrow/Seaside_Sparrow_0071_796519.jpg,420,315,128.Seaside_Sparrow,88,81,375,310,231,195,287,229
../../CUB_200_2011/images\128.Seaside_Sparrow/Seaside_Sparrow_0047_796520.jpg,230,307,128.Seaside_Sparrow,11,53,177,221,94,137,166,168
../../CUB_200_2011/images\128.Seaside_Sparrow/Seaside_Sparrow_0034_796521.jpg,500,332,128.Seaside_Sparrow,46,61,292,244,169,152,246,183
../../CUB_200_2011/images\128.Seaside_Sparrow/Seaside_Sparrow_0051_796522.jpg,500,500,128.Seaside_Sparrow,128,27,447,461,287,244,319,434
../../CUB_200_2011/images\128.Seaside_Sparrow/Seaside_Sparrow_0023_796525.jpg,500,400,128.Seaside_Sparrow,159,62,303,325,231,193,144,263
../../CUB_200_2011/images\128.Seaside_Sparrow/Seaside_Sparrow_0031_796526.jpg,250,310,128.Seaside_Sparrow,58,42,200,282,129,162,142,240
../../CUB_200_2011/images\128.Seaside_Sparrow/Seaside_Sparrow_0042_796528.jpg,500,400,128.Seaside_Sparrow,133,53,292,321,212,187,159,268
../../CUB_200_2011/images\128.Seaside_Sparrow/Seaside_Sparrow_0041_796529.jpg,333,500,128.Seaside_Sparrow,39,93,228,367,133,230,189,274
../../CUB_200_2011/images\128.Seaside_Sparrow/Seaside_Sparrow_0039_796530.jpg,500,341,128.Seaside_Sparrow,45,74,343,300,194,187,298,226
../../CUB_200_2011/images\128.Seaside_Sparrow/Seaside_Sparrow_0037_796531.jpg,500,200,128.Seaside_Sparrow,26,13,346,169,186,91,320,156
../../CUB_200_2011/images\128.Seaside_Sparrow/Seaside_Sparrow_0067_796532.jpg,418,500,128.Seaside_Sparrow,144,131,383,470,263,300,239,339
../../CUB_200_2011/images\128.Seaside_Sparrow/Seaside_Sparrow_0035_796533.jpg,450,305,128.Seaside_Sparrow,30,61,291,241,160,151,261,180
../../CUB_200_2011/images\128.Seaside_Sparrow/Seaside_Sparrow_0013_796535.jpg,500,200,128.Seaside_Sparrow,101,6,244,194,172,100,143,188
../../CUB_200_2011/images\128.Seaside_Sparrow/Seaside_Sparrow_0002_796536.jpg,332,500,128.Seaside_Sparrow,28,113,261,376,144,244,233,263
../../CUB_200_2011/images\128.Seaside_Sparrow/Seaside_Sparrow_0008_796538.jpg,334,500,128.Seaside_Sparrow,82,203,184,390,133,296,102,187
../../CUB_200_2011/images\128.Seaside_Sparrow/Seaside_Sparrow_0003_796539.jpg,500,375,128.Seaside_Sparrow,186,94,446,301,316,197,260,207
../../CUB_200_2011/images\128.Seaside_Sparrow/Seaside_Sparrow_0070_796540.jpg,332,500,128.Seaside_Sparrow,121,68,294,409,207,238,173,341
../../CUB_200_2011/images\128.Seaside_Sparrow/Seaside_Sparrow_0063_120707.jpg,500,401,128.Seaside_Sparrow,108,79,300,267,204,173,192,188
../../CUB_200_2011/images\128.Seaside_Sparrow/Seaside_Sparrow_0056_120710.jpg,386,500,128.Seaside_Sparrow,76,147,238,407,157,277,162,260
../../CUB_200_2011/images\128.Seaside_Sparrow/Seaside_Sparrow_0045_120696.jpg,500,474,128.Seaside_Sparrow,154,126,305,340,229,233,151,214
../../CUB_200_2011/images\128.Seaside_Sparrow/Seaside_Sparrow_0018_120716.jpg,500,375,128.Seaside_Sparrow,169,10,326,362,247,186,157,352
../../CUB_200_2011/images\128.Seaside_Sparrow/Seaside_Sparrow_0001_120720.jpg,357,500,128.Seaside_Sparrow,72,144,243,334,157,239,171,190
../../CUB_200_2011/images\128.Seaside_Sparrow/Seaside_Sparrow_0022_120721.jpg,500,375,128.Seaside_Sparrow,179,106,342,280,260,193,163,174
../../CUB_200_2011/images\128.Seaside_Sparrow/Seaside_Sparrow_0012_120732.jpg,500,438,128.Seaside_Sparrow,38,101,383,379,210,240,345,278
../../CUB_200_2011/images\128.Seaside_Sparrow/Seaside_Sparrow_0049_120735.jpg,400,500,128.Seaside_Sparrow,80,127,301,411,190,269,221,284
../../CUB_200_2011/images\128.Seaside_Sparrow/Seaside_Sparrow_0020_120743.jpg,500,333,128.Seaside_Sparrow,63,85,300,314,181,199,237,229
../../CUB_200_2011/images\128.Seaside_Sparrow/Seaside_Sparrow_0058_120744.jpg,500,424,128.Seaside_Sparrow,103,107,386,342,244,224,283,235
../../CUB_200_2011/images\128.Seaside_Sparrow/Seaside_Sparrow_0007_120690.jpg,337,500,128.Seaside_Sparrow,114,152,286,339,200,245,172,187
../../CUB_200_2011/images\128.Seaside_Sparrow/Seaside_Sparrow_0024_120751.jpg,500,375,128.Seaside_Sparrow,155,44,356,373,255,208,201,329
../../CUB_200_2011/images\128.Seaside_Sparrow/Seaside_Sparrow_0048_120758.jpg,500,333,128.Seaside_Sparrow,247,57,456,207,351,132,209,150
../../CUB_200_2011/images\128.Seaside_Sparrow/Seaside_Sparrow_0028_120766.jpg,333,500,128.Seaside_Sparrow,108,202,232,409,170,305,124,207
../../CUB_200_2011/images\128.Seaside_Sparrow/Seaside_Sparrow_0032_120767.jpg,500,376,128.Seaside_Sparrow,320,133,469,321,394,227,149,188
../../CUB_200_2011/images\128.Seaside_Sparrow/Seaside_Sparrow_0046_120768.jpg,466,500,128.Seaside_Sparrow,36,98,369,451,202,274,333,353
../../CUB_200_2011/images\128.Seaside_Sparrow/Seaside_Sparrow_0030_120780.jpg,500,348,128.Seaside_Sparrow,145,96,461,303,303,199,316,207
../../CUB_200_2011/images\128.Seaside_Sparrow/Seaside_Sparrow_0036_120785.jpg,333,500,128.Seaside_Sparrow,136,114,249,259,192,186,113,145
../../CUB_200_2011/images\128.Seaside_Sparrow/Seaside_Sparrow_0066_120791.jpg,500,409,128.Seaside_Sparrow,142,81,338,313,240,197,196,232
../../CUB_200_2011/images\128.Seaside_Sparrow/Seaside_Sparrow_0059_120794.jpg,500,376,128.Seaside_Sparrow,147,78,339,309,243,193,192,231
../../CUB_200_2011/images\128.Seaside_Sparrow/Seaside_Sparrow_0026_120798.jpg,500,333,128.Seaside_Sparrow,156,128,261,258,208,193,105,130
../../CUB_200_2011/images\128.Seaside_Sparrow/Seaside_Sparrow_0021_120699.jpg,414,500,128.Seaside_Sparrow,58,50,284,488,171,269,226,438
../../CUB_200_2011/images\128.Seaside_Sparrow/Seaside_Sparrow_0069_120700.jpg,500,332,128.Seaside_Sparrow,191,78,498,264,344,171,307,186
../../CUB_200_2011/images\128.Seaside_Sparrow/Seaside_Sparrow_0064_120813.jpg,500,334,128.Seaside_Sparrow,176,87,280,268,228,177,104,181
../../CUB_200_2011/images\128.Seaside_Sparrow/Seaside_Sparrow_0038_120819.jpg,500,347,128.Seaside_Sparrow,116,121,237,275,176,198,121,154
../../CUB_200_2011/images\128.Seaside_Sparrow/Seaside_Sparrow_0011_120820.jpg,500,335,128.Seaside_Sparrow,101,62,352,302,226,182,251,240
../../CUB_200_2011/images\128.Seaside_Sparrow/Seaside_Sparrow_0044_119287.jpg,499,500,128.Seaside_Sparrow,131,90,319,377,225,233,188,287
../../CUB_200_2011/images\128.Seaside_Sparrow/Seaside_Sparrow_0019_120826.jpg,500,357,128.Seaside_Sparrow,221,135,435,328,328,231,214,193
../../CUB_200_2011/images\128.Seaside_Sparrow/Seaside_Sparrow_0029_120828.jpg,500,436,128.Seaside_Sparrow,126,102,349,345,237,223,223,243
../../CUB_200_2011/images\129.Song_Sparrow/Song_Sparrow_0060_122371.jpg,333,500,129.Song_Sparrow,27,181,195,472,111,326,168,291
../../CUB_200_2011/images\129.Song_Sparrow/Song_Sparrow_0110_120872.jpg,500,336,129.Song_Sparrow,100,12,285,334,192,173,185,322
../../CUB_200_2011/images\129.Song_Sparrow/Song_Sparrow_0118_121905.jpg,500,375,129.Song_Sparrow,234,116,408,319,321,217,174,203
../../CUB_200_2011/images\129.Song_Sparrow/Song_Sparrow_0059_120885.jpg,500,333,129.Song_Sparrow,86,87,487,307,286,197,401,220
../../CUB_200_2011/images\129.Song_Sparrow/Song_Sparrow_0067_122424.jpg,500,383,129.Song_Sparrow,93,52,426,308,259,180,333,256
../../CUB_200_2011/images\129.Song_Sparrow/Song_Sparrow_0003_122425.jpg,500,352,129.Song_Sparrow,39,114,268,334,153,224,229,220
../../CUB_200_2011/images\129.Song_Sparrow/Song_Sparrow_0061_120891.jpg,500,420,129.Song_Sparrow,105,118,413,334,259,226,308,216
../../CUB_200_2011/images\129.Song_Sparrow/Song_Sparrow_0089_120894.jpg,500,333,129.Song_Sparrow,40,71,326,281,183,176,286,210
../../CUB_200_2011/images\129.Song_Sparrow/Song_Sparrow_0125_122435.jpg,398,500,129.Song_Sparrow,83,114,306,447,194,280,223,333
../../CUB_200_2011/images\129.Song_Sparrow/Song_Sparrow_0126_120901.jpg,500,380,129.Song_Sparrow,36,53,463,367,249,210,427,314
../../CUB_200_2011/images\129.Song_Sparrow/Song_Sparrow_0044_121931.jpg,500,334,129.Song_Sparrow,36,78,368,300,202,189,332,222
../../CUB_200_2011/images\129.Song_Sparrow/Song_Sparrow_0071_122446.jpg,500,269,129.Song_Sparrow,207,30,387,201,297,115,180,171
../../CUB_200_2011/images\129.Song_Sparrow/Song_Sparrow_0101_120920.jpg,500,368,129.Song_Sparrow,45,121,325,317,185,219,280,196
../../CUB_200_2011/images\129.Song_Sparrow/Song_Sparrow_0097_121438.jpg,354,500,129.Song_Sparrow,59,41,277,416,168,228,218,375
../../CUB_200_2011/images\129.Song_Sparrow/Song_Sparrow_0045_121951.jpg,428,500,129.Song_Sparrow,113,94,393,443,253,268,280,349
../../CUB_200_2011/images\129.Song_Sparrow/Song_Sparrow_0092_121969.jpg,463,500,129.Song_Sparrow,148,87,391,492,269,289,243,405
../../CUB_200_2011/images\129.Song_Sparrow/Song_Sparrow_0009_121025.jpg,357,500,129.Song_Sparrow,81,138,349,408,215,273,268,270
../../CUB_200_2011/images\129.Song_Sparrow/Song_Sparrow_0086_121999.jpg,500,375,129.Song_Sparrow,257,39,498,355,377,197,241,316
../../CUB_200_2011/images\129.Song_Sparrow/Song_Sparrow_0020_121490.jpg,500,327,129.Song_Sparrow,183,67,466,263,324,165,283,196
../../CUB_200_2011/images\129.Song_Sparrow/Song_Sparrow_0035_120986.jpg,500,333,129.Song_Sparrow,177,109,404,234,290,171,227,125
../../CUB_200_2011/images\129.Song_Sparrow/Song_Sparrow_0029_120989.jpg,500,357,129.Song_Sparrow,152,101,398,288,275,194,246,187
../../CUB_200_2011/images\129.Song_Sparrow/Song_Sparrow_0107_120990.jpg,356,500,129.Song_Sparrow,73,81,329,431,201,256,256,350
../../CUB_200_2011/images\129.Song_Sparrow/Song_Sparrow_0050_121514.jpg,500,375,129.Song_Sparrow,118,96,471,305,294,200,353,209
../../CUB_200_2011/images\129.Song_Sparrow/Song_Sparrow_0112_121027.jpg,500,415,129.Song_Sparrow,129,98,415,313,272,205,286,215
../../CUB_200_2011/images\129.Song_Sparrow/Song_Sparrow_0080_121033.jpg,500,333,129.Song_Sparrow,195,79,306,268,250,173,111,189
../../CUB_200_2011/images\129.Song_Sparrow/Song_Sparrow_0069_122065.jpg,421,500,129.Song_Sparrow,74,122,330,391,202,256,256,269
../../CUB_200_2011/images\129.Song_Sparrow/Song_Sparrow_0053_121554.jpg,500,366,129.Song_Sparrow,39,122,242,309,140,215,203,187
../../CUB_200_2011/images\129.Song_Sparrow/Song_Sparrow_0013_121056.jpg,500,342,129.Song_Sparrow,124,60,446,327,285,193,322,267
../../CUB_200_2011/images\129.Song_Sparrow/Song_Sparrow_0090_121057.jpg,500,333,129.Song_Sparrow,112,76,301,326,206,201,189,250
../../CUB_200_2011/images\129.Song_Sparrow/Song_Sparrow_0087_121062.jpg,500,358,129.Song_Sparrow,57,30,478,336,267,183,421,306
../../CUB_200_2011/images\129.Song_Sparrow/Song_Sparrow_0102_122090.jpg,500,339,129.Song_Sparrow,81,161,209,319,145,240,128,158
../../CUB_200_2011/images\129.Song_Sparrow/Song_Sparrow_0130_121583.jpg,500,335,129.Song_Sparrow,245,154,462,287,353,220,217,133
../../CUB_200_2011/images\129.Song_Sparrow/Song_Sparrow_0037_121078.jpg,500,333,129.Song_Sparrow,26,79,401,311,213,195,375,232
../../CUB_200_2011/images\129.Song_Sparrow/Song_Sparrow_0057_121090.jpg,500,401,129.Song_Sparrow,65,122,376,327,220,224,311,205
../../CUB_200_2011/images\129.Song_Sparrow/Song_Sparrow_0088_121615.jpg,500,375,129.Song_Sparrow,48,62,378,347,213,204,330,285
../../CUB_200_2011/images\129.Song_Sparrow/Song_Sparrow_0040_121617.jpg,500,333,129.Song_Sparrow,163,18,474,308,318,163,311,290
../../CUB_200_2011/images\129.Song_Sparrow/Song_Sparrow_0046_121903.jpg,500,333,129.Song_Sparrow,206,111,336,234,271,172,130,123
../../CUB_200_2011/images\129.Song_Sparrow/Song_Sparrow_0007_121133.jpg,475,500,129.Song_Sparrow,141,134,362,350,251,242,221,216
../../CUB_200_2011/images\129.Song_Sparrow/Song_Sparrow_0091_121651.jpg,500,363,129.Song_Sparrow,23,63,429,328,226,195,406,265
../../CUB_200_2011/images\129.Song_Sparrow/Song_Sparrow_0001_122169.jpg,500,333,129.Song_Sparrow,84,87,329,258,206,172,245,171
../../CUB_200_2011/images\129.Song_Sparrow/Song_Sparrow_0132_121153.jpg,500,333,129.Song_Sparrow,115,115,313,284,214,199,198,169
../../CUB_200_2011/images\129.Song_Sparrow/Song_Sparrow_0038_121666.jpg,415,500,129.Song_Sparrow,60,105,252,444,156,274,192,339
../../CUB_200_2011/images\129.Song_Sparrow/Song_Sparrow_0055_121158.jpg,500,351,129.Song_Sparrow,81,33,371,273,226,153,290,240
../../CUB_200_2011/images\129.Song_Sparrow/Song_Sparrow_0015_122081.jpg,500,281,129.Song_Sparrow,100,105,277,228,188,166,177,123
../../CUB_200_2011/images\129.Song_Sparrow/Song_Sparrow_0036_121679.jpg,500,357,129.Song_Sparrow,172,38,322,354,247,196,150,316
../../CUB_200_2011/images\129.Song_Sparrow/Song_Sparrow_0113_121683.jpg,500,324,129.Song_Sparrow,31,60,366,253,198,156,335,193
../../CUB_200_2011/images\129.Song_Sparrow/Song_Sparrow_0099_121193.jpg,500,410,129.Song_Sparrow,64,25,236,400,150,212,172,375
../../CUB_200_2011/images\129.Song_Sparrow/Song_Sparrow_0077_121196.jpg,500,400,129.Song_Sparrow,218,99,463,385,340,242,245,286
../../CUB_200_2011/images\129.Song_Sparrow/Song_Sparrow_0121_121203.jpg,333,500,129.Song_Sparrow,117,116,287,403,202,259,170,287
../../CUB_200_2011/images\129.Song_Sparrow/Song_Sparrow_0116_121211.jpg,431,500,129.Song_Sparrow,98,136,292,425,195,280,194,289
../../CUB_200_2011/images\129.Song_Sparrow/Song_Sparrow_0106_121154.jpg,379,500,129.Song_Sparrow,102,41,338,351,220,196,236,310
../../CUB_200_2011/images\129.Song_Sparrow/Song_Sparrow_0114_121233.jpg,404,500,129.Song_Sparrow,13,119,218,315,115,217,205,196
../../CUB_200_2011/images\129.Song_Sparrow/Song_Sparrow_0123_121249.jpg,500,344,129.Song_Sparrow,148,62,424,323,286,192,276,261
../../CUB_200_2011/images\129.Song_Sparrow/Song_Sparrow_0034_121255.jpg,400,500,129.Song_Sparrow,68,158,382,349,225,253,314,191
../../CUB_200_2011/images\129.Song_Sparrow/Song_Sparrow_0135_121261.jpg,500,333,129.Song_Sparrow,197,53,464,266,330,159,267,213
../../CUB_200_2011/images\129.Song_Sparrow/Song_Sparrow_0096_121313.jpg,500,400,129.Song_Sparrow,80,114,272,274,176,194,192,160
../../CUB_200_2011/images\129.Song_Sparrow/Song_Sparrow_0042_121314.jpg,500,417,129.Song_Sparrow,171,96,392,319,281,207,221,223
../../CUB_200_2011/images\129.Song_Sparrow/Song_Sparrow_0058_121832.jpg,500,357,129.Song_Sparrow,21,56,385,348,203,202,364,292
../../CUB_200_2011/images\129.Song_Sparrow/Song_Sparrow_0108_121327.jpg,500,415,129.Song_Sparrow,120,66,416,332,268,199,296,266
../../CUB_200_2011/images\129.Song_Sparrow/Song_Sparrow_0010_121331.jpg,372,500,129.Song_Sparrow,75,88,298,440,186,264,223,352
../../CUB_200_2011/images\130.Tree_Sparrow/Tree_Sparrow_0130_124932.jpg,332,500,130.Tree_Sparrow,20,81,310,446,165,263,290,365
../../CUB_200_2011/images\130.Tree_Sparrow/Tree_Sparrow_0122_123927.jpg,500,465,130.Tree_Sparrow,40,60,428,420,234,240,388,360
../../CUB_200_2011/images\130.Tree_Sparrow/Tree_Sparrow_0077_123417.jpg,500,375,130.Tree_Sparrow,88,43,460,335,274,189,372,292
../../CUB_200_2011/images\130.Tree_Sparrow/Tree_Sparrow_0023_124956.jpg,500,500,130.Tree_Sparrow,185,169,391,305,288,237,206,136
../../CUB_200_2011/images\130.Tree_Sparrow/Tree_Sparrow_0007_122911.jpg,419,500,130.Tree_Sparrow,57,109,324,328,190,218,267,219
../../CUB_200_2011/images\130.Tree_Sparrow/Tree_Sparrow_0129_124960.jpg,500,407,130.Tree_Sparrow,127,63,345,291,236,177,218,228
../../CUB_200_2011/images\130.Tree_Sparrow/Tree_Sparrow_0066_123569.jpg,333,500,130.Tree_Sparrow,29,238,327,495,178,366,298,257
../../CUB_200_2011/images\130.Tree_Sparrow/Tree_Sparrow_0053_122933.jpg,500,334,130.Tree_Sparrow,204,62,431,292,317,177,227,230
../../CUB_200_2011/images\130.Tree_Sparrow/Tree_Sparrow_0100_122945.jpg,500,334,130.Tree_Sparrow,116,100,319,229,217,164,203,129
../../CUB_200_2011/images\130.Tree_Sparrow/Tree_Sparrow_0044_122946.jpg,500,362,130.Tree_Sparrow,128,88,426,251,277,169,298,163
../../CUB_200_2011/images\130.Tree_Sparrow/Tree_Sparrow_0005_122949.jpg,397,500,130.Tree_Sparrow,166,127,287,401,226,264,121,274
../../CUB_200_2011/images\130.Tree_Sparrow/Tree_Sparrow_0097_123462.jpg,500,421,130.Tree_Sparrow,29,84,417,343,223,213,388,259
../../CUB_200_2011/images\130.Tree_Sparrow/Tree_Sparrow_0032_123489.jpg,500,429,130.Tree_Sparrow,89,70,447,385,268,227,358,315
../../CUB_200_2011/images\130.Tree_Sparrow/Tree_Sparrow_0011_122964.jpg,500,374,130.Tree_Sparrow,223,92,461,253,342,172,238,161
../../CUB_200_2011/images\130.Tree_Sparrow/Tree_Sparrow_0112_125014.jpg,500,333,130.Tree_Sparrow,71,100,388,248,229,174,317,148
../../CUB_200_2011/images\130.Tree_Sparrow/Tree_Sparrow_0072_123991.jpg,500,333,130.Tree_Sparrow,53,83,361,248,207,165,308,165
../../CUB_200_2011/images\130.Tree_Sparrow/Tree_Sparrow_0042_124512.jpg,500,333,130.Tree_Sparrow,160,94,482,303,321,198,322,209
../../CUB_200_2011/images\130.Tree_Sparrow/Tree_Sparrow_0022_123496.jpg,500,375,130.Tree_Sparrow,48,1,324,375,186,188,276,374
../../CUB_200_2011/images\130.Tree_Sparrow/Tree_Sparrow_0041_123497.jpg,500,462,130.Tree_Sparrow,84,45,400,417,242,231,316,372
../../CUB_200_2011/images\130.Tree_Sparrow/Tree_Sparrow_0062_123000.jpg,500,342,130.Tree_Sparrow,110,70,443,289,276,179,333,219
../../CUB_200_2011/images\130.Tree_Sparrow/Tree_Sparrow_0076_123669.jpg,500,400,130.Tree_Sparrow,160,56,464,355,312,205,304,299
../../CUB_200_2011/images\130.Tree_Sparrow/Tree_Sparrow_0043_124034.jpg,500,400,130.Tree_Sparrow,241,113,443,370,342,241,202,257
../../CUB_200_2011/images\130.Tree_Sparrow/Tree_Sparrow_0015_125105.jpg,334,500,130.Tree_Sparrow,73,89,229,368,151,228,156,279
../../CUB_200_2011/images\130.Tree_Sparrow/Tree_Sparrow_0018_123574.jpg,500,320,130.Tree_Sparrow,30,57,302,278,166,167,272,221
../../CUB_200_2011/images\130.Tree_Sparrow/Tree_Sparrow_0095_124090.jpg,500,361,130.Tree_Sparrow,200,60,402,246,301,153,202,186
../../CUB_200_2011/images\130.Tree_Sparrow/Tree_Sparrow_0125_123078.jpg,500,435,130.Tree_Sparrow,47,11,450,427,248,219,403,416
../../CUB_200_2011/images\130.Tree_Sparrow/Tree_Sparrow_0058_123591.jpg,400,500,130.Tree_Sparrow,35,157,299,420,167,288,264,263
../../CUB_200_2011/images\130.Tree_Sparrow/Tree_Sparrow_0101_124104.jpg,500,485,130.Tree_Sparrow,81,122,314,416,197,269,233,294
../../CUB_200_2011/images\130.Tree_Sparrow/Tree_Sparrow_0119_124114.jpg,500,337,130.Tree_Sparrow,79,83,336,333,207,208,257,250
../../CUB_200_2011/images\130.Tree_Sparrow/Tree_Sparrow_0080_124120.jpg,500,334,130.Tree_Sparrow,3,45,424,318,213,181,421,273
../../CUB_200_2011/images\130.Tree_Sparrow/Tree_Sparrow_0113_123613.jpg,500,400,130.Tree_Sparrow,15,103,406,353,210,228,391,250
../../CUB_200_2011/images\130.Tree_Sparrow/Tree_Sparrow_0039_124140.jpg,500,484,130.Tree_Sparrow,181,109,439,452,310,280,258,343
../../CUB_200_2011/images\130.Tree_Sparrow/Tree_Sparrow_0057_123665.jpg,500,333,130.Tree_Sparrow,109,74,270,297,189,185,161,223
../../CUB_200_2011/images\130.Tree_Sparrow/Tree_Sparrow_0094_124974.jpg,356,500,130.Tree_Sparrow,23,86,341,413,182,249,318,327
../../CUB_200_2011/images\130.Tree_Sparrow/Tree_Sparrow_0068_125230.jpg,500,405,130.Tree_Sparrow,128,53,414,384,271,218,286,331
../../CUB_200_2011/images\130.Tree_Sparrow/Tree_Sparrow_0025_124233.jpg,480,320,130.Tree_Sparrow,124,46,474,273,299,159,350,227
../../CUB_200_2011/images\130.Tree_Sparrow/Tree_Sparrow_0105_123227.jpg,500,400,130.Tree_Sparrow,76,54,489,349,282,201,413,295
../../CUB_200_2011/images\130.Tree_Sparrow/Tree_Sparrow_0060_123743.jpg,439,500,130.Tree_Sparrow,96,90,322,351,209,220,226,261
../../CUB_200_2011/images\130.Tree_Sparrow/Tree_Sparrow_0086_123751.jpg,500,333,130.Tree_Sparrow,45,142,255,291,150,216,210,149
../../CUB_200_2011/images\130.Tree_Sparrow/Tree_Sparrow_0088_125305.jpg,500,309,130.Tree_Sparrow,108,102,250,263,179,182,142,161
../../CUB_200_2011/images\130.Tree_Sparrow/Tree_Sparrow_0090_110145.jpg,500,475,130.Tree_Sparrow,138,66,334,308,236,187,196,242
../../CUB_200_2011/images\130.Tree_Sparrow/Tree_Sparrow_0121_124296.jpg,500,375,130.Tree_Sparrow,140,86,436,323,288,204,296,237
../../CUB_200_2011/images\130.Tree_Sparrow/Tree_Sparrow_0127_125322.jpg,500,333,130.Tree_Sparrow,65,44,288,313,176,178,223,269
../../CUB_200_2011/images\130.Tree_Sparrow/Tree_Sparrow_0123_125324.jpg,500,375,130.Tree_Sparrow,168,103,316,275,242,189,148,172
../../CUB_200_2011/images\130.Tree_Sparrow/Tree_Sparrow_0036_122772.jpg,500,400,130.Tree_Sparrow,141,104,434,326,287,215,293,222
../../CUB_200_2011/images\130.Tree_Sparrow/Tree_Sparrow_0034_123799.jpg,500,372,130.Tree_Sparrow,28,80,350,358,189,219,322,278
../../CUB_200_2011/images\130.Tree_Sparrow/Tree_Sparrow_0109_123802.jpg,500,473,130.Tree_Sparrow,221,120,467,409,344,264,246,289
../../CUB_200_2011/images\130.Tree_Sparrow/Tree_Sparrow_0024_123805.jpg,500,374,130.Tree_Sparrow,115,101,438,325,276,213,323,224
../../CUB_200_2011/images\130.Tree_Sparrow/Tree_Sparrow_0009_123294.jpg,334,500,130.Tree_Sparrow,87,142,320,339,203,240,233,197
../../CUB_200_2011/images\130.Tree_Sparrow/Tree_Sparrow_0046_125344.jpg,500,355,130.Tree_Sparrow,29,125,320,335,174,230,291,210
../../CUB_200_2011/images\130.Tree_Sparrow/Tree_Sparrow_0107_123822.jpg,500,284,130.Tree_Sparrow,18,71,280,220,149,145,262,149
../../CUB_200_2011/images\130.Tree_Sparrow/Tree_Sparrow_0081_124348.jpg,333,500,130.Tree_Sparrow,49,95,325,412,187,253,276,317
../../CUB_200_2011/images\130.Tree_Sparrow/Tree_Sparrow_0035_123211.jpg,500,333,130.Tree_Sparrow,63,64,341,275,202,169,278,211
../../CUB_200_2011/images\130.Tree_Sparrow/Tree_Sparrow_0028_122829.jpg,500,350,130.Tree_Sparrow,110,107,344,218,227,162,234,111
../../CUB_200_2011/images\130.Tree_Sparrow/Tree_Sparrow_0052_123869.jpg,500,409,130.Tree_Sparrow,64,30,478,404,271,217,414,374
../../CUB_200_2011/images\130.Tree_Sparrow/Tree_Sparrow_0073_123871.jpg,500,354,130.Tree_Sparrow,152,92,451,288,301,190,299,196
../../CUB_200_2011/images\130.Tree_Sparrow/Tree_Sparrow_0030_122850.jpg,500,333,130.Tree_Sparrow,115,106,438,310,276,208,323,204
../../CUB_200_2011/images\130.Tree_Sparrow/Tree_Sparrow_0108_124754.jpg,500,400,130.Tree_Sparrow,22,63,369,220,195,141,347,157
../../CUB_200_2011/images\130.Tree_Sparrow/Tree_Sparrow_0128_123979.jpg,500,375,130.Tree_Sparrow,88,75,420,238,254,156,332,163
../../CUB_200_2011/images\130.Tree_Sparrow/Tree_Sparrow_0074_124408.jpg,500,435,130.Tree_Sparrow,150,72,404,350,277,211,254,278
../../CUB_200_2011/images\131.Vesper_Sparrow/Vesper_Sparrow_0005_125440.jpg,500,392,131.Vesper_Sparrow,99,104,401,278,250,191,302,174
../../CUB_200_2011/images\131.Vesper_Sparrow/Vesper_Sparrow_0040_125441.jpg,467,500,131.Vesper_Sparrow,134,127,379,409,256,268,245,282
../../CUB_200_2011/images\131.Vesper_Sparrow/Vesper_Sparrow_0052_125444.jpg,500,333,131.Vesper_Sparrow,90,52,285,300,187,176,195,248
../../CUB_200_2011/images\131.Vesper_Sparrow/Vesper_Sparrow_0065_125446.jpg,500,333,131.Vesper_Sparrow,49,52,343,299,196,175,294,247
../../CUB_200_2011/images\131.Vesper_Sparrow/Vesper_Sparrow_0043_125703.jpg,500,334,131.Vesper_Sparrow,102,129,257,253,179,191,155,124
../../CUB_200_2011/images\131.Vesper_Sparrow/Vesper_Sparrow_0002_125454.jpg,367,500,131.Vesper_Sparrow,56,32,311,479,183,255,255,447
../../CUB_200_2011/images\131.Vesper_Sparrow/Vesper_Sparrow_0087_125712.jpg,500,331,131.Vesper_Sparrow,43,71,368,271,205,171,325,200
../../CUB_200_2011/images\131.Vesper_Sparrow/Vesper_Sparrow_0009_125713.jpg,500,375,131.Vesper_Sparrow,181,124,351,258,266,191,170,134
../../CUB_200_2011/images\131.Vesper_Sparrow/Vesper_Sparrow_0041_125458.jpg,500,309,131.Vesper_Sparrow,244,86,377,217,310,151,133,131
../../CUB_200_2011/images\131.Vesper_Sparrow/Vesper_Sparrow_0095_125459.jpg,382,500,131.Vesper_Sparrow,116,14,341,207,228,110,225,193
../../CUB_200_2011/images\131.Vesper_Sparrow/Vesper_Sparrow_0083_125718.jpg,454,500,131.Vesper_Sparrow,65,96,404,391,234,243,339,295
../../CUB_200_2011/images\131.Vesper_Sparrow/Vesper_Sparrow_0023_125465.jpg,500,364,131.Vesper_Sparrow,200,91,425,351,312,221,225,260
../../CUB_200_2011/images\131.Vesper_Sparrow/Vesper_Sparrow_0044_125470.jpg,500,363,131.Vesper_Sparrow,88,75,235,302,161,188,147,227
../../CUB_200_2011/images\131.Vesper_Sparrow/Vesper_Sparrow_0047_125788.jpg,500,383,131.Vesper_Sparrow,121,67,398,279,259,173,277,212
../../CUB_200_2011/images\131.Vesper_Sparrow/Vesper_Sparrow_0076_125737.jpg,500,440,131.Vesper_Sparrow,62,158,347,387,204,272,285,229
../../CUB_200_2011/images\131.Vesper_Sparrow/Vesper_Sparrow_0089_125705.jpg,500,375,131.Vesper_Sparrow,76,105,350,258,213,181,274,153
../../CUB_200_2011/images\131.Vesper_Sparrow/Vesper_Sparrow_0029_125498.jpg,500,333,131.Vesper_Sparrow,243,62,439,253,341,157,196,191
../../CUB_200_2011/images\131.Vesper_Sparrow/Vesper_Sparrow_0082_125503.jpg,500,338,131.Vesper_Sparrow,216,88,348,216,282,152,132,128
../../CUB_200_2011/images\131.Vesper_Sparrow/Vesper_Sparrow_0020_125794.jpg,387,500,131.Vesper_Sparrow,133,70,336,458,234,264,203,388
../../CUB_200_2011/images\131.Vesper_Sparrow/Vesper_Sparrow_0086_125776.jpg,500,333,131.Vesper_Sparrow,261,99,383,213,322,156,122,114
../../CUB_200_2011/images\131.Vesper_Sparrow/Vesper_Sparrow_0004_125787.jpg,500,375,131.Vesper_Sparrow,179,33,377,306,278,169,198,273
../../CUB_200_2011/images\131.Vesper_Sparrow/Vesper_Sparrow_0084_125532.jpg,500,400,131.Vesper_Sparrow,132,118,326,337,229,227,194,219
../../CUB_200_2011/images\131.Vesper_Sparrow/Vesper_Sparrow_0017_125534.jpg,373,500,131.Vesper_Sparrow,74,131,263,401,168,266,189,270
../../CUB_200_2011/images\131.Vesper_Sparrow/Vesper_Sparrow_0081_125541.jpg,500,500,131.Vesper_Sparrow,117,193,490,436,303,314,373,243
../../CUB_200_2011/images\131.Vesper_Sparrow/Vesper_Sparrow_0049_125806.jpg,333,500,131.Vesper_Sparrow,23,65,292,467,157,266,269,402
../../CUB_200_2011/images\131.Vesper_Sparrow/Vesper_Sparrow_0013_109937.jpg,500,357,131.Vesper_Sparrow,41,19,409,331,225,175,368,312
../../CUB_200_2011/images\131.Vesper_Sparrow/Vesper_Sparrow_0070_125555.jpg,357,500,131.Vesper_Sparrow,92,177,216,319,154,248,124,142
../../CUB_200_2011/images\131.Vesper_Sparrow/Vesper_Sparrow_0019_125558.jpg,500,451,131.Vesper_Sparrow,109,71,438,379,273,225,329,308
../../CUB_200_2011/images\131.Vesper_Sparrow/Vesper_Sparrow_0032_125564.jpg,500,334,131.Vesper_Sparrow,204,77,391,261,297,169,187,184
../../CUB_200_2011/images\131.Vesper_Sparrow/Vesper_Sparrow_0033_125568.jpg,500,375,131.Vesper_Sparrow,78,105,256,302,167,203,178,197
../../CUB_200_2011/images\131.Vesper_Sparrow/Vesper_Sparrow_0046_125575.jpg,500,387,131.Vesper_Sparrow,99,78,295,295,197,186,196,217
../../CUB_200_2011/images\131.Vesper_Sparrow/Vesper_Sparrow_0079_125579.jpg,500,334,131.Vesper_Sparrow,83,168,256,284,169,226,173,116
../../CUB_200_2011/images\131.Vesper_Sparrow/Vesper_Sparrow_0051_125587.jpg,500,382,131.Vesper_Sparrow,80,78,450,285,265,181,370,207
../../CUB_200_2011/images\131.Vesper_Sparrow/Vesper_Sparrow_0077_125597.jpg,500,478,131.Vesper_Sparrow,219,103,465,431,342,267,246,328
../../CUB_200_2011/images\131.Vesper_Sparrow/Vesper_Sparrow_0091_125598.jpg,500,436,131.Vesper_Sparrow,143,78,481,354,312,216,338,276
../../CUB_200_2011/images\131.Vesper_Sparrow/Vesper_Sparrow_0007_125630.jpg,427,500,131.Vesper_Sparrow,73,144,287,373,180,258,214,229
../../CUB_200_2011/images\131.Vesper_Sparrow/Vesper_Sparrow_0068_125601.jpg,500,325,131.Vesper_Sparrow,15,92,230,294,122,193,215,202
../../CUB_200_2011/images\131.Vesper_Sparrow/Vesper_Sparrow_0094_125602.jpg,357,500,131.Vesper_Sparrow,101,134,251,271,176,202,150,137
../../CUB_200_2011/images\131.Vesper_Sparrow/Vesper_Sparrow_0073_125605.jpg,500,364,131.Vesper_Sparrow,164,92,354,316,259,204,190,224
../../CUB_200_2011/images\131.Vesper_Sparrow/Vesper_Sparrow_0080_125606.jpg,500,333,131.Vesper_Sparrow,176,119,319,235,247,177,143,116
../../CUB_200_2011/images\131.Vesper_Sparrow/Vesper_Sparrow_0011_125608.jpg,500,375,131.Vesper_Sparrow,149,27,457,263,303,145,308,236
../../CUB_200_2011/images\131.Vesper_Sparrow/Vesper_Sparrow_0055_125611.jpg,500,330,131.Vesper_Sparrow,96,77,345,237,220,157,249,160
../../CUB_200_2011/images\131.Vesper_Sparrow/Vesper_Sparrow_0016_125615.jpg,500,375,131.Vesper_Sparrow,169,81,316,311,242,196,147,230
../../CUB_200_2011/images\131.Vesper_Sparrow/Vesper_Sparrow_0066_125619.jpg,401,500,131.Vesper_Sparrow,79,111,360,294,219,202,281,183
../../CUB_200_2011/images\131.Vesper_Sparrow/Vesper_Sparrow_0028_118217.jpg,440,500,131.Vesper_Sparrow,143,154,260,292,201,223,117,138
../../CUB_200_2011/images\131.Vesper_Sparrow/Vesper_Sparrow_0031_125631.jpg,387,500,131.Vesper_Sparrow,113,178,254,358,183,268,141,180
../../CUB_200_2011/images\131.Vesper_Sparrow/Vesper_Sparrow_0053_125641.jpg,441,500,131.Vesper_Sparrow,136,155,380,419,258,287,244,264
../../CUB_200_2011/images\131.Vesper_Sparrow/Vesper_Sparrow_0045_125643.jpg,401,500,131.Vesper_Sparrow,56,60,295,406,175,233,239,346
../../CUB_200_2011/images\131.Vesper_Sparrow/Vesper_Sparrow_0037_125648.jpg,500,410,131.Vesper_Sparrow,147,110,489,382,318,246,342,272
../../CUB_200_2011/images\131.Vesper_Sparrow/Vesper_Sparrow_0057_125649.jpg,500,360,131.Vesper_Sparrow,186,103,452,273,319,188,266,170
../../CUB_200_2011/images\131.Vesper_Sparrow/Vesper_Sparrow_0018_125651.jpg,500,334,131.Vesper_Sparrow,75,83,327,272,201,177,252,189
../../CUB_200_2011/images\131.Vesper_Sparrow/Vesper_Sparrow_0015_125653.jpg,500,372,131.Vesper_Sparrow,42,37,431,338,236,187,389,301
../../CUB_200_2011/images\131.Vesper_Sparrow/Vesper_Sparrow_0056_125657.jpg,500,353,131.Vesper_Sparrow,183,115,369,288,276,201,186,173
../../CUB_200_2011/images\131.Vesper_Sparrow/Vesper_Sparrow_0058_125661.jpg,500,357,131.Vesper_Sparrow,73,84,349,293,211,188,276,209
../../CUB_200_2011/images\131.Vesper_Sparrow/Vesper_Sparrow_0030_125663.jpg,500,333,131.Vesper_Sparrow,92,63,261,174,176,118,169,111
../../CUB_200_2011/images\131.Vesper_Sparrow/Vesper_Sparrow_0062_125669.jpg,500,389,131.Vesper_Sparrow,122,153,368,310,245,231,246,157
../../CUB_200_2011/images\131.Vesper_Sparrow/Vesper_Sparrow_0003_125427.jpg,500,375,131.Vesper_Sparrow,141,107,358,254,249,180,217,147
../../CUB_200_2011/images\131.Vesper_Sparrow/Vesper_Sparrow_0067_125429.jpg,500,375,131.Vesper_Sparrow,226,117,448,316,337,216,222,199
../../CUB_200_2011/images\131.Vesper_Sparrow/Vesper_Sparrow_0090_125690.jpg,500,333,131.Vesper_Sparrow,43,72,368,262,205,167,325,190
../../CUB_200_2011/images\131.Vesper_Sparrow/Vesper_Sparrow_0022_125719.jpg,475,500,131.Vesper_Sparrow,109,51,293,188,201,119,184,137
../../CUB_200_2011/images\132.White_crowned_Sparrow/White_Crowned_Sparrow_0064_126467.jpg,375,500,132.White_crowned_Sparrow,117,185,372,368,244,276,255,183
../../CUB_200_2011/images\132.White_crowned_Sparrow/White_Crowned_Sparrow_0087_128008.jpg,500,460,132.White_crowned_Sparrow,48,48,435,428,241,238,387,380
../../CUB_200_2011/images\132.White_crowned_Sparrow/White_Crowned_Sparrow_0047_127575.jpg,469,500,132.White_crowned_Sparrow,83,68,355,452,219,260,272,384
../../CUB_200_2011/images\132.White_crowned_Sparrow/White_Crowned_Sparrow_0140_125967.jpg,500,375,132.White_crowned_Sparrow,86,68,340,343,213,205,254,275
../../CUB_200_2011/images\132.White_crowned_Sparrow/White_Crowned_Sparrow_0067_127576.jpg,500,333,132.White_crowned_Sparrow,198,113,479,292,338,202,281,179
../../CUB_200_2011/images\132.White_crowned_Sparrow/White_Crowned_Sparrow_0116_127512.jpg,500,375,132.White_crowned_Sparrow,186,145,423,337,304,241,237,192
../../CUB_200_2011/images\132.White_crowned_Sparrow/White_Crowned_Sparrow_0098_127019.jpg,500,333,132.White_crowned_Sparrow,108,69,420,276,264,172,312,207
../../CUB_200_2011/images\132.White_crowned_Sparrow/White_Crowned_Sparrow_0101_127058.jpg,500,400,132.White_crowned_Sparrow,28,47,387,381,207,214,359,334
../../CUB_200_2011/images\132.White_crowned_Sparrow/White_Crowned_Sparrow_0114_127027.jpg,500,333,132.White_crowned_Sparrow,98,45,380,292,239,168,282,247
../../CUB_200_2011/images\132.White_crowned_Sparrow/White_Crowned_Sparrow_0122_128577.jpg,500,304,132.White_crowned_Sparrow,244,114,489,297,366,205,245,183
../../CUB_200_2011/images\132.White_crowned_Sparrow/White_Crowned_Sparrow_0093_126531.jpg,500,375,132.White_crowned_Sparrow,189,117,342,258,265,187,153,141
../../CUB_200_2011/images\132.White_crowned_Sparrow/White_Crowned_Sparrow_0115_126027.jpg,500,362,132.White_crowned_Sparrow,17,105,457,342,237,223,440,237
../../CUB_200_2011/images\132.White_crowned_Sparrow/White_Crowned_Sparrow_0029_127503.jpg,500,333,132.White_crowned_Sparrow,131,92,285,215,208,153,154,123
../../CUB_200_2011/images\132.White_crowned_Sparrow/White_Crowned_Sparrow_0113_128095.jpg,437,500,132.White_crowned_Sparrow,10,140,359,450,184,295,349,310
../../CUB_200_2011/images\132.White_crowned_Sparrow/White_Crowned_Sparrow_0109_128529.jpg,500,333,132.White_crowned_Sparrow,93,122,275,257,184,189,182,135
../../CUB_200_2011/images\132.White_crowned_Sparrow/White_Crowned_Sparrow_0072_127080.jpg,500,357,132.White_crowned_Sparrow,109,48,297,270,203,159,188,222
../../CUB_200_2011/images\132.White_crowned_Sparrow/White_Crowned_Sparrow_0078_127603.jpg,500,358,132.White_crowned_Sparrow,99,66,220,307,159,186,121,241
../../CUB_200_2011/images\132.White_crowned_Sparrow/White_Crowned_Sparrow_0021_127092.jpg,500,387,132.White_crowned_Sparrow,35,101,364,321,199,211,329,220
../../CUB_200_2011/images\132.White_crowned_Sparrow/White_Crowned_Sparrow_0043_127096.jpg,500,376,132.White_crowned_Sparrow,153,92,285,364,219,228,132,272
../../CUB_200_2011/images\132.White_crowned_Sparrow/White_Crowned_Sparrow_0001_127115.jpg,500,343,132.White_crowned_Sparrow,53,62,325,301,189,181,272,239
../../CUB_200_2011/images\132.White_crowned_Sparrow/White_Crowned_Sparrow_0095_127118.jpg,500,376,132.White_crowned_Sparrow,143,28,466,350,304,189,323,322
../../CUB_200_2011/images\132.White_crowned_Sparrow/White_Crowned_Sparrow_0010_127651.jpg,500,375,132.White_crowned_Sparrow,117,74,490,332,303,203,373,258
../../CUB_200_2011/images\132.White_crowned_Sparrow/White_Crowned_Sparrow_0019_127652.jpg,355,500,132.White_crowned_Sparrow,39,103,234,408,136,255,195,305
../../CUB_200_2011/images\132.White_crowned_Sparrow/White_Crowned_Sparrow_0009_127658.jpg,500,366,132.White_crowned_Sparrow,102,23,398,344,250,183,296,321
../../CUB_200_2011/images\132.White_crowned_Sparrow/White_Crowned_Sparrow_0094_128627.jpg,465,500,132.White_crowned_Sparrow,224,249,394,371,309,310,170,122
../../CUB_200_2011/images\132.White_crowned_Sparrow/White_Crowned_Sparrow_0076_127604.jpg,500,406,132.White_crowned_Sparrow,46,100,412,291,229,195,366,191
../../CUB_200_2011/images\132.White_crowned_Sparrow/White_Crowned_Sparrow_0068_126156.jpg,500,335,132.White_crowned_Sparrow,102,109,299,312,200,210,197,203
../../CUB_200_2011/images\132.White_crowned_Sparrow/White_Crowned_Sparrow_0085_127194.jpg,393,500,132.White_crowned_Sparrow,77,78,316,395,196,236,239,317
../../CUB_200_2011/images\132.White_crowned_Sparrow/White_Crowned_Sparrow_0102_127708.jpg,500,368,132.White_crowned_Sparrow,92,103,247,285,169,194,155,182
../../CUB_200_2011/images\132.White_crowned_Sparrow/White_Crowned_Sparrow_0099_127213.jpg,500,309,132.White_crowned_Sparrow,175,63,321,249,248,156,146,186
../../CUB_200_2011/images\132.White_crowned_Sparrow/White_Crowned_Sparrow_0033_127728.jpg,500,357,132.White_crowned_Sparrow,189,60,477,319,333,189,288,259
../../CUB_200_2011/images\132.White_crowned_Sparrow/White_Crowned_Sparrow_0034_126199.jpg,500,357,132.White_crowned_Sparrow,104,67,471,288,287,177,367,221
../../CUB_200_2011/images\132.White_crowned_Sparrow/White_Crowned_Sparrow_0054_126068.jpg,500,334,132.White_crowned_Sparrow,178,32,405,321,291,176,227,289
../../CUB_200_2011/images\132.White_crowned_Sparrow/White_Crowned_Sparrow_0083_128777.jpg,500,333,132.White_crowned_Sparrow,19,128,256,305,137,216,237,177
../../CUB_200_2011/images\132.White_crowned_Sparrow/White_Crowned_Sparrow_0141_127766.jpg,373,500,132.White_crowned_Sparrow,84,148,319,440,201,294,235,292
../../CUB_200_2011/images\132.White_crowned_Sparrow/White_Crowned_Sparrow_0002_127774.jpg,437,500,132.White_crowned_Sparrow,109,39,423,451,266,245,314,412
../../CUB_200_2011/images\132.White_crowned_Sparrow/White_Crowned_Sparrow_0017_125829.jpg,500,409,132.White_crowned_Sparrow,24,77,346,309,185,193,322,232
../../CUB_200_2011/images\132.White_crowned_Sparrow/White_Crowned_Sparrow_0089_127778.jpg,500,298,132.White_crowned_Sparrow,170,88,344,214,257,151,174,126
../../CUB_200_2011/images\132.White_crowned_Sparrow/White_Crowned_Sparrow_0049_128311.jpg,500,334,132.White_crowned_Sparrow,150,140,469,320,309,230,319,180
../../CUB_200_2011/images\132.White_crowned_Sparrow/White_Crowned_Sparrow_0100_126267.jpg,333,500,132.White_crowned_Sparrow,18,110,221,474,119,292,203,364
../../CUB_200_2011/images\132.White_crowned_Sparrow/White_Crowned_Sparrow_0040_127313.jpg,500,400,132.White_crowned_Sparrow,185,73,323,311,254,192,138,238
../../CUB_200_2011/images\132.White_crowned_Sparrow/White_Crowned_Sparrow_0105_126818.jpg,500,333,132.White_crowned_Sparrow,215,113,477,331,346,222,262,218
../../CUB_200_2011/images\132.White_crowned_Sparrow/White_Crowned_Sparrow_0061_126315.jpg,423,500,132.White_crowned_Sparrow,122,78,363,431,242,254,241,353
../../CUB_200_2011/images\132.White_crowned_Sparrow/White_Crowned_Sparrow_0012_127853.jpg,500,333,132.White_crowned_Sparrow,126,44,499,331,312,187,373,287
../../CUB_200_2011/images\132.White_crowned_Sparrow/White_Crowned_Sparrow_0129_127860.jpg,500,322,132.White_crowned_Sparrow,22,79,331,261,176,170,309,182
../../CUB_200_2011/images\132.White_crowned_Sparrow/White_Crowned_Sparrow_0107_128662.jpg,333,500,132.White_crowned_Sparrow,106,219,228,409,167,314,122,190
../../CUB_200_2011/images\132.White_crowned_Sparrow/White_Crowned_Sparrow_0042_128395.jpg,500,350,132.White_crowned_Sparrow,131,106,371,258,251,182,240,152
../../CUB_200_2011/images\132.White_crowned_Sparrow/White_Crowned_Sparrow_0142_128237.jpg,333,500,132.White_crowned_Sparrow,3,90,246,261,124,175,243,171
../../CUB_200_2011/images\132.White_crowned_Sparrow/White_Crowned_Sparrow_0044_127386.jpg,500,400,132.White_crowned_Sparrow,3,67,363,379,183,223,360,312
../../CUB_200_2011/images\132.White_crowned_Sparrow/White_Crowned_Sparrow_0090_125864.jpg,500,375,132.White_crowned_Sparrow,278,124,437,306,357,215,159,182
../../CUB_200_2011/images\132.White_crowned_Sparrow/White_Crowned_Sparrow_0111_127404.jpg,500,375,132.White_crowned_Sparrow,26,78,364,289,195,183,338,211
../../CUB_200_2011/images\132.White_crowned_Sparrow/White_Crowned_Sparrow_0118_127919.jpg,500,362,132.White_crowned_Sparrow,40,90,301,322,170,206,261,232
../../CUB_200_2011/images\132.White_crowned_Sparrow/White_Crowned_Sparrow_0071_127922.jpg,500,357,132.White_crowned_Sparrow,38,89,287,351,162,220,249,262
../../CUB_200_2011/images\132.White_crowned_Sparrow/White_Crowned_Sparrow_0057_127927.jpg,500,443,132.White_crowned_Sparrow,36,60,319,424,177,242,283,364
../../CUB_200_2011/images\132.White_crowned_Sparrow/White_Crowned_Sparrow_0127_126923.jpg,500,375,132.White_crowned_Sparrow,83,62,327,233,205,147,244,171
../../CUB_200_2011/images\132.White_crowned_Sparrow/White_Crowned_Sparrow_0119_126932.jpg,400,307,132.White_crowned_Sparrow,21,41,363,270,192,155,342,229
../../CUB_200_2011/images\132.White_crowned_Sparrow/White_Crowned_Sparrow_0037_126969.jpg,500,375,132.White_crowned_Sparrow,5,84,364,335,184,209,359,251
../../CUB_200_2011/images\132.White_crowned_Sparrow/White_Crowned_Sparrow_0124_128082.jpg,500,405,132.White_crowned_Sparrow,71,89,340,322,205,205,269,233
../../CUB_200_2011/images\132.White_crowned_Sparrow/White_Crowned_Sparrow_0092_125934.jpg,500,469,132.White_crowned_Sparrow,131,79,477,448,304,263,346,369
../../CUB_200_2011/images\132.White_crowned_Sparrow/White_Crowned_Sparrow_0031_126457.jpg,500,336,132.White_crowned_Sparrow,90,72,470,316,280,194,380,244
../../CUB_200_2011/images\133.White_throated_Sparrow/White_Throated_Sparrow_0078_129041.jpg,448,500,133.White_throated_Sparrow,131,127,396,485,263,306,265,358
../../CUB_200_2011/images\133.White_throated_Sparrow/White_Throated_Sparrow_0107_129046.jpg,500,346,133.White_throated_Sparrow,53,87,326,268,189,177,273,181
../../CUB_200_2011/images\133.White_throated_Sparrow/White_Throated_Sparrow_0082_129048.jpg,500,334,133.White_throated_Sparrow,48,67,354,262,201,164,306,195
../../CUB_200_2011/images\133.White_throated_Sparrow/White_Throated_Sparrow_0050_129051.jpg,500,375,133.White_throated_Sparrow,171,96,390,307,280,201,219,211
../../CUB_200_2011/images\133.White_throated_Sparrow/White_Throated_Sparrow_0034_129054.jpg,500,334,133.White_throated_Sparrow,209,114,356,214,282,164,147,100
../../CUB_200_2011/images\133.White_throated_Sparrow/White_Throated_Sparrow_0002_129057.jpg,500,332,133.White_throated_Sparrow,58,96,308,239,183,167,250,143
../../CUB_200_2011/images\133.White_throated_Sparrow/White_Throated_Sparrow_0109_129066.jpg,500,420,133.White_throated_Sparrow,32,63,397,316,214,189,365,253
../../CUB_200_2011/images\133.White_throated_Sparrow/White_Throated_Sparrow_0030_129076.jpg,500,324,133.White_throated_Sparrow,63,127,347,260,205,193,284,133
../../CUB_200_2011/images\133.White_throated_Sparrow/White_Throated_Sparrow_0118_129084.jpg,500,332,133.White_throated_Sparrow,13,71,414,261,213,166,401,190
../../CUB_200_2011/images\133.White_throated_Sparrow/White_Throated_Sparrow_0076_129088.jpg,500,335,133.White_throated_Sparrow,177,88,288,295,232,191,111,207
../../CUB_200_2011/images\133.White_throated_Sparrow/White_Throated_Sparrow_0098_129089.jpg,500,333,133.White_throated_Sparrow,175,80,343,280,259,180,168,200
../../CUB_200_2011/images\133.White_throated_Sparrow/White_Throated_Sparrow_0112_129101.jpg,500,376,133.White_throated_Sparrow,65,79,486,254,275,166,421,175
../../CUB_200_2011/images\133.White_throated_Sparrow/White_Throated_Sparrow_0073_129110.jpg,500,396,133.White_throated_Sparrow,51,66,407,289,229,177,356,223
../../CUB_200_2011/images\133.White_throated_Sparrow/White_Throated_Sparrow_0028_129118.jpg,500,375,133.White_throated_Sparrow,166,62,293,309,229,185,127,247
../../CUB_200_2011/images\133.White_throated_Sparrow/White_Throated_Sparrow_0015_129138.jpg,500,313,133.White_throated_Sparrow,38,100,357,281,197,190,319,181
../../CUB_200_2011/images\133.White_throated_Sparrow/White_Throated_Sparrow_0014_129148.jpg,500,333,133.White_throated_Sparrow,85,37,326,329,205,183,241,292
../../CUB_200_2011/images\133.White_throated_Sparrow/White_Throated_Sparrow_0016_129158.jpg,500,374,133.White_throated_Sparrow,76,64,279,353,177,208,203,289
../../CUB_200_2011/images\133.White_throated_Sparrow/White_Throated_Sparrow_0023_129179.jpg,500,333,133.White_throated_Sparrow,113,47,442,289,277,168,329,242
../../CUB_200_2011/images\133.White_throated_Sparrow/White_Throated_Sparrow_0085_129180.jpg,500,350,133.White_throated_Sparrow,121,88,374,349,247,218,253,261
../../CUB_200_2011/images\133.White_throated_Sparrow/White_Throated_Sparrow_0108_129184.jpg,500,384,133.White_throated_Sparrow,76,52,291,329,183,190,215,277
../../CUB_200_2011/images\133.White_throated_Sparrow/White_Throated_Sparrow_0134_129190.jpg,500,442,133.White_throated_Sparrow,36,43,474,418,255,230,438,375
../../CUB_200_2011/images\133.White_throated_Sparrow/White_Throated_Sparrow_0121_129201.jpg,500,333,133.White_throated_Sparrow,77,115,286,257,181,186,209,142
../../CUB_200_2011/images\133.White_throated_Sparrow/White_Throated_Sparrow_0072_129203.jpg,500,279,133.White_throated_Sparrow,83,40,496,263,289,151,413,223
../../CUB_200_2011/images\133.White_throated_Sparrow/White_Throated_Sparrow_0124_128801.jpg,500,332,133.White_throated_Sparrow,65,146,277,281,171,213,212,135
../../CUB_200_2011/images\133.White_throated_Sparrow/White_Throated_Sparrow_0060_128802.jpg,403,500,133.White_throated_Sparrow,144,121,340,396,242,258,196,275
../../CUB_200_2011/images\133.White_throated_Sparrow/White_Throated_Sparrow_0063_128803.jpg,500,472,133.White_throated_Sparrow,125,176,466,383,295,279,341,207
../../CUB_200_2011/images\133.White_throated_Sparrow/White_Throated_Sparrow_0021_128804.jpg,500,337,133.White_throated_Sparrow,105,49,323,318,214,183,218,269
../../CUB_200_2011/images\133.White_throated_Sparrow/White_Throated_Sparrow_0031_128808.jpg,500,326,133.White_throated_Sparrow,21,55,499,325,260,190,478,270
../../CUB_200_2011/images\133.White_throated_Sparrow/White_Throated_Sparrow_0105_128814.jpg,500,386,133.White_throated_Sparrow,144,66,419,352,281,209,275,286
../../CUB_200_2011/images\133.White_throated_Sparrow/White_Throated_Sparrow_0106_128815.jpg,500,333,133.White_throated_Sparrow,0,45,436,286,218,165,436,241
../../CUB_200_2011/images\133.White_throated_Sparrow/White_Throated_Sparrow_0043_128818.jpg,500,500,133.White_throated_Sparrow,44,148,403,421,223,284,359,273
../../CUB_200_2011/images\133.White_throated_Sparrow/White_Throated_Sparrow_0135_128819.jpg,500,335,133.White_throated_Sparrow,66,55,272,264,169,159,206,209
../../CUB_200_2011/images\133.White_throated_Sparrow/White_Throated_Sparrow_0119_128827.jpg,500,281,133.White_throated_Sparrow,70,60,292,260,181,160,222,200
../../CUB_200_2011/images\133.White_throated_Sparrow/White_Throated_Sparrow_0125_128832.jpg,500,333,133.White_throated_Sparrow,14,25,465,316,239,170,451,291
../../CUB_200_2011/images\133.White_throated_Sparrow/White_Throated_Sparrow_0132_128833.jpg,500,333,133.White_throated_Sparrow,243,96,352,219,297,157,109,123
../../CUB_200_2011/images\133.White_throated_Sparrow/White_Throated_Sparrow_0110_128838.jpg,500,400,133.White_throated_Sparrow,126,82,409,315,267,198,283,233
../../CUB_200_2011/images\133.White_throated_Sparrow/White_Throated_Sparrow_0026_128843.jpg,500,325,133.White_throated_Sparrow,4,107,306,243,155,175,302,136
../../CUB_200_2011/images\133.White_throated_Sparrow/White_Throated_Sparrow_0027_128847.jpg,500,332,133.White_throated_Sparrow,110,74,330,291,220,182,220,217
../../CUB_200_2011/images\133.White_throated_Sparrow/White_Throated_Sparrow_0038_128853.jpg,500,332,133.White_throated_Sparrow,160,103,375,238,267,170,215,135
../../CUB_200_2011/images\133.White_throated_Sparrow/White_Throated_Sparrow_0039_128859.jpg,500,349,133.White_throated_Sparrow,136,59,323,228,229,143,187,169
../../CUB_200_2011/images\133.White_throated_Sparrow/White_Throated_Sparrow_0032_128866.jpg,500,333,133.White_throated_Sparrow,107,34,460,321,283,177,353,287
../../CUB_200_2011/images\133.White_throated_Sparrow/White_Throated_Sparrow_0042_128899.jpg,500,366,133.White_throated_Sparrow,114,74,484,349,299,211,370,275
../../CUB_200_2011/images\133.White_throated_Sparrow/White_Throated_Sparrow_0061_128902.jpg,500,375,133.White_throated_Sparrow,99,42,448,344,273,193,349,302
../../CUB_200_2011/images\133.White_throated_Sparrow/White_Throated_Sparrow_0056_128906.jpg,500,400,133.White_throated_Sparrow,171,112,455,352,313,232,284,240
../../CUB_200_2011/images\133.White_throated_Sparrow/White_Throated_Sparrow_0102_128911.jpg,500,333,133.White_throated_Sparrow,143,83,488,322,315,202,345,239
../../CUB_200_2011/images\133.White_throated_Sparrow/White_Throated_Sparrow_0071_128915.jpg,500,375,133.White_throated_Sparrow,38,4,345,226,191,115,307,222
../../CUB_200_2011/images\133.White_throated_Sparrow/White_Throated_Sparrow_0007_128918.jpg,500,445,133.White_throated_Sparrow,76,152,316,309,196,230,240,157
../../CUB_200_2011/images\133.White_throated_Sparrow/White_Throated_Sparrow_0052_128923.jpg,500,375,133.White_throated_Sparrow,80,78,494,338,287,208,414,260
../../CUB_200_2011/images\133.White_throated_Sparrow/White_Throated_Sparrow_0113_128936.jpg,489,500,133.White_throated_Sparrow,114,119,333,438,223,278,219,319
../../CUB_200_2011/images\133.White_throated_Sparrow/White_Throated_Sparrow_0004_128944.jpg,500,345,133.White_throated_Sparrow,15,65,336,303,175,184,321,238
../../CUB_200_2011/images\133.White_throated_Sparrow/White_Throated_Sparrow_0069_128951.jpg,500,479,133.White_throated_Sparrow,52,71,366,418,209,244,314,347
../../CUB_200_2011/images\133.White_throated_Sparrow/White_Throated_Sparrow_0128_128956.jpg,500,406,133.White_throated_Sparrow,123,73,401,333,262,203,278,260
../../CUB_200_2011/images\133.White_throated_Sparrow/White_Throated_Sparrow_0059_128964.jpg,500,355,133.White_throated_Sparrow,0,98,308,283,154,190,308,185
../../CUB_200_2011/images\133.White_throated_Sparrow/White_Throated_Sparrow_0097_128967.jpg,500,357,133.White_throated_Sparrow,68,90,384,328,226,209,316,238
../../CUB_200_2011/images\133.White_throated_Sparrow/White_Throated_Sparrow_0017_128982.jpg,500,376,133.White_throated_Sparrow,127,91,354,271,240,181,227,180
../../CUB_200_2011/images\133.White_throated_Sparrow/White_Throated_Sparrow_0075_128990.jpg,500,334,133.White_throated_Sparrow,177,64,449,297,313,180,272,233
../../CUB_200_2011/images\133.White_throated_Sparrow/White_Throated_Sparrow_0020_129007.jpg,500,400,133.White_throated_Sparrow,128,147,309,281,218,214,181,134
../../CUB_200_2011/images\133.White_throated_Sparrow/White_Throated_Sparrow_0123_129009.jpg,500,400,133.White_throated_Sparrow,151,100,498,298,324,199,347,198
../../CUB_200_2011/images\133.White_throated_Sparrow/White_Throated_Sparrow_0047_129014.jpg,500,334,133.White_throated_Sparrow,185,92,484,304,334,198,299,212
../../CUB_200_2011/images\133.White_throated_Sparrow/White_Throated_Sparrow_0033_129016.jpg,500,341,133.White_throated_Sparrow,202,70,448,265,325,167,246,195
../../CUB_200_2011/images\134.Cape_Glossy_Starling/Cape_Glossy_Starling_0027_129282.jpg,500,375,134.Cape_Glossy_Starling,127,87,375,311,251,199,248,224
../../CUB_200_2011/images\134.Cape_Glossy_Starling/Cape_Glossy_Starling_0026_129288.jpg,500,390,134.Cape_Glossy_Starling,107,21,444,377,275,199,337,356
../../CUB_200_2011/images\134.Cape_Glossy_Starling/Cape_Glossy_Starling_0074_129294.jpg,332,500,134.Cape_Glossy_Starling,26,157,211,437,118,297,185,280
../../CUB_200_2011/images\134.Cape_Glossy_Starling/Cape_Glossy_Starling_0006_129295.jpg,333,500,134.Cape_Glossy_Starling,34,139,201,425,117,282,167,286
../../CUB_200_2011/images\134.Cape_Glossy_Starling/Cape_Glossy_Starling_0065_129299.jpg,500,310,134.Cape_Glossy_Starling,15,49,367,307,191,178,352,258
../../CUB_200_2011/images\134.Cape_Glossy_Starling/Cape_Glossy_Starling_0038_129301.jpg,500,320,134.Cape_Glossy_Starling,133,68,239,276,186,172,106,208
../../CUB_200_2011/images\134.Cape_Glossy_Starling/Cape_Glossy_Starling_0097_129303.jpg,500,341,134.Cape_Glossy_Starling,31,135,256,282,143,208,225,147
../../CUB_200_2011/images\134.Cape_Glossy_Starling/Cape_Glossy_Starling_0028_129309.jpg,500,365,134.Cape_Glossy_Starling,169,116,299,249,234,182,130,133
../../CUB_200_2011/images\134.Cape_Glossy_Starling/Cape_Glossy_Starling_0002_129310.jpg,334,500,134.Cape_Glossy_Starling,30,121,253,405,141,263,223,284
../../CUB_200_2011/images\134.Cape_Glossy_Starling/Cape_Glossy_Starling_0070_129322.jpg,333,500,134.Cape_Glossy_Starling,54,162,318,477,186,319,264,315
../../CUB_200_2011/images\134.Cape_Glossy_Starling/Cape_Glossy_Starling_0020_129328.jpg,500,333,134.Cape_Glossy_Starling,66,37,323,331,194,184,257,294
../../CUB_200_2011/images\134.Cape_Glossy_Starling/Cape_Glossy_Starling_0017_129337.jpg,375,500,134.Cape_Glossy_Starling,22,134,336,391,179,262,314,257
../../CUB_200_2011/images\134.Cape_Glossy_Starling/Cape_Glossy_Starling_0025_129341.jpg,500,333,134.Cape_Glossy_Starling,89,60,308,334,198,197,219,274
../../CUB_200_2011/images\134.Cape_Glossy_Starling/Cape_Glossy_Starling_0007_129345.jpg,500,333,134.Cape_Glossy_Starling,71,51,358,328,214,189,287,277
../../CUB_200_2011/images\134.Cape_Glossy_Starling/Cape_Glossy_Starling_0084_129346.jpg,500,326,134.Cape_Glossy_Starling,123,17,435,322,279,169,312,305
../../CUB_200_2011/images\134.Cape_Glossy_Starling/Cape_Glossy_Starling_0047_129348.jpg,500,377,134.Cape_Glossy_Starling,41,50,213,192,127,121,172,142
../../CUB_200_2011/images\134.Cape_Glossy_Starling/Cape_Glossy_Starling_0092_129349.jpg,500,334,134.Cape_Glossy_Starling,87,43,385,309,236,176,298,266
../../CUB_200_2011/images\134.Cape_Glossy_Starling/Cape_Glossy_Starling_0010_129352.jpg,500,375,134.Cape_Glossy_Starling,49,69,499,373,274,221,450,304
../../CUB_200_2011/images\134.Cape_Glossy_Starling/Cape_Glossy_Starling_0018_129356.jpg,500,396,134.Cape_Glossy_Starling,17,59,365,342,191,200,348,283
../../CUB_200_2011/images\134.Cape_Glossy_Starling/Cape_Glossy_Starling_0059_129357.jpg,500,333,134.Cape_Glossy_Starling,100,63,384,305,242,184,284,242
../../CUB_200_2011/images\134.Cape_Glossy_Starling/Cape_Glossy_Starling_0043_129358.jpg,500,375,134.Cape_Glossy_Starling,112,26,333,302,222,164,221,276
../../CUB_200_2011/images\134.Cape_Glossy_Starling/Cape_Glossy_Starling_0080_129362.jpg,345,500,134.Cape_Glossy_Starling,49,81,209,480,129,280,160,399
../../CUB_200_2011/images\134.Cape_Glossy_Starling/Cape_Glossy_Starling_0098_129365.jpg,500,333,134.Cape_Glossy_Starling,209,49,491,334,350,191,282,285
../../CUB_200_2011/images\134.Cape_Glossy_Starling/Cape_Glossy_Starling_0094_129368.jpg,500,334,134.Cape_Glossy_Starling,177,98,373,264,275,181,196,166
../../CUB_200_2011/images\134.Cape_Glossy_Starling/Cape_Glossy_Starling_0076_129377.jpg,500,383,134.Cape_Glossy_Starling,45,58,276,197,160,127,231,139
../../CUB_200_2011/images\134.Cape_Glossy_Starling/Cape_Glossy_Starling_0077_129378.jpg,500,375,134.Cape_Glossy_Starling,160,151,270,271,215,211,110,120
../../CUB_200_2011/images\134.Cape_Glossy_Starling/Cape_Glossy_Starling_0067_129380.jpg,500,335,134.Cape_Glossy_Starling,32,15,413,321,222,168,381,306
../../CUB_200_2011/images\134.Cape_Glossy_Starling/Cape_Glossy_Starling_0024_129384.jpg,500,494,134.Cape_Glossy_Starling,171,25,461,478,316,251,290,453
../../CUB_200_2011/images\134.Cape_Glossy_Starling/Cape_Glossy_Starling_0042_129385.jpg,500,375,134.Cape_Glossy_Starling,189,83,349,322,269,202,160,239
../../CUB_200_2011/images\134.Cape_Glossy_Starling/Cape_Glossy_Starling_0072_129386.jpg,500,375,134.Cape_Glossy_Starling,161,72,438,305,299,188,277,233
../../CUB_200_2011/images\134.Cape_Glossy_Starling/Cape_Glossy_Starling_0096_129388.jpg,332,500,134.Cape_Glossy_Starling,120,104,268,453,194,278,148,349
../../CUB_200_2011/images\134.Cape_Glossy_Starling/Cape_Glossy_Starling_0048_129397.jpg,500,334,134.Cape_Glossy_Starling,46,14,375,333,210,173,329,319
../../CUB_200_2011/images\134.Cape_Glossy_Starling/Cape_Glossy_Starling_0079_129399.jpg,500,375,134.Cape_Glossy_Starling,75,85,362,326,218,205,287,241
../../CUB_200_2011/images\134.Cape_Glossy_Starling/Cape_Glossy_Starling_0019_129407.jpg,500,332,134.Cape_Glossy_Starling,50,76,339,309,194,192,289,233
../../CUB_200_2011/images\134.Cape_Glossy_Starling/Cape_Glossy_Starling_0099_129412.jpg,500,375,134.Cape_Glossy_Starling,60,60,261,355,160,207,201,295
../../CUB_200_2011/images\134.Cape_Glossy_Starling/Cape_Glossy_Starling_0022_129414.jpg,500,375,134.Cape_Glossy_Starling,155,74,374,262,264,168,219,188
../../CUB_200_2011/images\134.Cape_Glossy_Starling/Cape_Glossy_Starling_0075_129431.jpg,500,375,134.Cape_Glossy_Starling,193,57,405,287,299,172,212,230
../../CUB_200_2011/images\134.Cape_Glossy_Starling/Cape_Glossy_Starling_0046_129434.jpg,500,375,134.Cape_Glossy_Starling,61,97,212,311,136,204,151,214
../../CUB_200_2011/images\134.Cape_Glossy_Starling/Cape_Glossy_Starling_0033_129435.jpg,332,500,134.Cape_Glossy_Starling,73,75,315,386,194,230,242,311
../../CUB_200_2011/images\134.Cape_Glossy_Starling/Cape_Glossy_Starling_0088_129437.jpg,500,334,134.Cape_Glossy_Starling,66,73,310,311,188,192,244,238
../../CUB_200_2011/images\134.Cape_Glossy_Starling/Cape_Glossy_Starling_0054_129440.jpg,500,366,134.Cape_Glossy_Starling,105,65,425,303,265,184,320,238
../../CUB_200_2011/images\134.Cape_Glossy_Starling/Cape_Glossy_Starling_0030_129443.jpg,500,375,134.Cape_Glossy_Starling,103,70,492,374,297,222,389,304
../../CUB_200_2011/images\134.Cape_Glossy_Starling/Cape_Glossy_Starling_0068_129446.jpg,500,375,134.Cape_Glossy_Starling,98,86,336,309,217,197,238,223
../../CUB_200_2011/images\134.Cape_Glossy_Starling/Cape_Glossy_Starling_0034_129455.jpg,437,500,134.Cape_Glossy_Starling,31,53,386,450,208,251,355,397
../../CUB_200_2011/images\134.Cape_Glossy_Starling/Cape_Glossy_Starling_0087_129481.jpg,500,357,134.Cape_Glossy_Starling,98,90,445,314,271,202,347,224
../../CUB_200_2011/images\134.Cape_Glossy_Starling/Cape_Glossy_Starling_0016_129464.jpg,500,375,134.Cape_Glossy_Starling,78,26,385,373,231,199,307,347
../../CUB_200_2011/images\134.Cape_Glossy_Starling/Cape_Glossy_Starling_0073_129465.jpg,500,357,134.Cape_Glossy_Starling,47,19,414,356,230,187,367,337
../../CUB_200_2011/images\134.Cape_Glossy_Starling/Cape_Glossy_Starling_0039_129469.jpg,500,375,134.Cape_Glossy_Starling,142,87,307,307,224,197,165,220
../../CUB_200_2011/images\134.Cape_Glossy_Starling/Cape_Glossy_Starling_0091_129470.jpg,500,375,134.Cape_Glossy_Starling,181,50,430,323,305,186,249,273
../../CUB_200_2011/images\134.Cape_Glossy_Starling/Cape_Glossy_Starling_0082_129216.jpg,500,314,134.Cape_Glossy_Starling,257,62,440,277,348,169,183,215
../../CUB_200_2011/images\134.Cape_Glossy_Starling/Cape_Glossy_Starling_0069_129218.jpg,500,335,134.Cape_Glossy_Starling,109,52,226,264,167,158,117,212
../../CUB_200_2011/images\134.Cape_Glossy_Starling/Cape_Glossy_Starling_0053_129219.jpg,491,500,134.Cape_Glossy_Starling,22,18,471,495,246,256,449,477
../../CUB_200_2011/images\134.Cape_Glossy_Starling/Cape_Glossy_Starling_0081_129220.jpg,500,333,134.Cape_Glossy_Starling,223,50,491,248,357,149,268,198
../../CUB_200_2011/images\134.Cape_Glossy_Starling/Cape_Glossy_Starling_0060_129222.jpg,500,500,134.Cape_Glossy_Starling,157,112,357,338,257,225,200,226
../../CUB_200_2011/images\134.Cape_Glossy_Starling/Cape_Glossy_Starling_0012_129225.jpg,332,500,134.Cape_Glossy_Starling,91,161,224,351,157,256,133,190
../../CUB_200_2011/images\134.Cape_Glossy_Starling/Cape_Glossy_Starling_0013_129244.jpg,500,375,134.Cape_Glossy_Starling,147,67,420,335,283,201,273,268
../../CUB_200_2011/images\134.Cape_Glossy_Starling/Cape_Glossy_Starling_0062_129254.jpg,500,371,134.Cape_Glossy_Starling,50,71,324,315,187,193,274,244
../../CUB_200_2011/images\134.Cape_Glossy_Starling/Cape_Glossy_Starling_0005_129262.jpg,500,357,134.Cape_Glossy_Starling,130,9,492,353,311,181,362,344
../../CUB_200_2011/images\134.Cape_Glossy_Starling/Cape_Glossy_Starling_0015_129266.jpg,484,500,134.Cape_Glossy_Starling,66,39,405,493,235,266,339,454
../../CUB_200_2011/images\134.Cape_Glossy_Starling/Cape_Glossy_Starling_0050_129274.jpg,500,418,134.Cape_Glossy_Starling,68,125,461,344,264,234,393,219
../../CUB_200_2011/images\135.Bank_Swallow/Bank_Swallow_0015_129853.jpg,500,375,135.Bank_Swallow,168,57,397,304,282,180,229,247
../../CUB_200_2011/images\135.Bank_Swallow/Bank_Swallow_0048_129546.jpg,500,333,135.Bank_Swallow,66,44,234,256,150,150,168,212
../../CUB_200_2011/images\135.Bank_Swallow/Bank_Swallow_0062_129548.jpg,500,336,135.Bank_Swallow,161,26,388,252,274,139,227,226
../../CUB_200_2011/images\135.Bank_Swallow/Bank_Swallow_0004_129549.jpg,500,333,135.Bank_Swallow,20,93,390,285,205,189,370,192
../../CUB_200_2011/images\135.Bank_Swallow/Bank_Swallow_0068_129806.jpg,450,500,135.Bank_Swallow,25,110,296,433,160,271,271,323
../../CUB_200_2011/images\135.Bank_Swallow/Bank_Swallow_0066_129559.jpg,428,350,135.Bank_Swallow,170,47,358,314,264,180,188,267
../../CUB_200_2011/images\135.Bank_Swallow/Bank_Swallow_0064_129816.jpg,402,500,135.Bank_Swallow,62,111,370,391,216,251,308,280
../../CUB_200_2011/images\135.Bank_Swallow/Bank_Swallow_0013_129563.jpg,500,300,135.Bank_Swallow,164,68,298,262,231,165,134,194
../../CUB_200_2011/images\135.Bank_Swallow/Bank_Swallow_0036_129567.jpg,500,333,135.Bank_Swallow,77,61,441,280,259,170,364,219
../../CUB_200_2011/images\135.Bank_Swallow/Bank_Swallow_0057_129499.jpg,500,333,135.Bank_Swallow,212,45,421,240,316,142,209,195
../../CUB_200_2011/images\135.Bank_Swallow/Bank_Swallow_0038_129830.jpg,500,329,135.Bank_Swallow,162,57,456,300,309,178,294,243
../../CUB_200_2011/images\135.Bank_Swallow/Bank_Swallow_0052_129575.jpg,500,382,135.Bank_Swallow,137,59,298,381,217,220,161,322
../../CUB_200_2011/images\135.Bank_Swallow/Bank_Swallow_0008_129590.jpg,500,375,135.Bank_Swallow,125,158,258,268,191,213,133,110
../../CUB_200_2011/images\135.Bank_Swallow/Bank_Swallow_0010_129592.jpg,400,500,135.Bank_Swallow,88,115,351,377,219,246,263,262
../../CUB_200_2011/images\135.Bank_Swallow/Bank_Swallow_0069_129802.jpg,500,335,135.Bank_Swallow,133,74,297,257,215,165,164,183
../../CUB_200_2011/images\135.Bank_Swallow/Bank_Swallow_0039_129599.jpg,500,347,135.Bank_Swallow,101,113,265,243,183,178,164,130
../../CUB_200_2011/images\135.Bank_Swallow/Bank_Swallow_0049_129611.jpg,500,361,135.Bank_Swallow,187,70,300,304,243,187,113,234
../../CUB_200_2011/images\135.Bank_Swallow/Bank_Swallow_0026_129870.jpg,395,500,135.Bank_Swallow,140,145,264,408,202,276,124,263
../../CUB_200_2011/images\135.Bank_Swallow/Bank_Swallow_0023_129878.jpg,395,500,135.Bank_Swallow,89,105,342,333,215,219,253,228
../../CUB_200_2011/images\135.Bank_Swallow/Bank_Swallow_0003_129623.jpg,347,500,135.Bank_Swallow,90,79,259,430,174,254,169,351
../../CUB_200_2011/images\135.Bank_Swallow/Bank_Swallow_0041_129625.jpg,500,409,135.Bank_Swallow,141,60,465,311,303,185,324,251
../../CUB_200_2011/images\135.Bank_Swallow/Bank_Swallow_0018_129891.jpg,500,334,135.Bank_Swallow,157,99,301,261,229,180,144,162
../../CUB_200_2011/images\135.Bank_Swallow/Bank_Swallow_0059_129896.jpg,500,333,135.Bank_Swallow,180,129,298,270,239,199,118,141
../../CUB_200_2011/images\135.Bank_Swallow/Bank_Swallow_0037_129903.jpg,500,404,135.Bank_Swallow,141,106,305,367,223,236,164,261
../../CUB_200_2011/images\135.Bank_Swallow/Bank_Swallow_0006_129652.jpg,500,339,135.Bank_Swallow,115,23,318,338,216,180,203,315
../../CUB_200_2011/images\135.Bank_Swallow/Bank_Swallow_0002_129654.jpg,497,500,135.Bank_Swallow,92,183,413,460,252,321,321,277
../../CUB_200_2011/images\135.Bank_Swallow/Bank_Swallow_0022_129923.jpg,407,500,135.Bank_Swallow,135,109,361,442,248,275,226,333
../../CUB_200_2011/images\135.Bank_Swallow/Bank_Swallow_0014_129668.jpg,500,407,135.Bank_Swallow,87,118,443,286,265,202,356,168
../../CUB_200_2011/images\135.Bank_Swallow/Bank_Swallow_0040_129674.jpg,500,333,135.Bank_Swallow,162,129,263,252,212,190,101,123
../../CUB_200_2011/images\135.Bank_Swallow/Bank_Swallow_0030_129560.jpg,500,375,135.Bank_Swallow,180,109,321,289,250,199,141,180
../../CUB_200_2011/images\135.Bank_Swallow/Bank_Swallow_0043_129685.jpg,500,389,135.Bank_Swallow,161,95,360,302,260,198,199,207
../../CUB_200_2011/images\135.Bank_Swallow/Bank_Swallow_0020_129747.jpg,500,333,135.Bank_Swallow,152,44,290,185,221,114,138,141
../../CUB_200_2011/images\135.Bank_Swallow/Bank_Swallow_0044_129687.jpg,500,375,135.Bank_Swallow,191,82,292,217,241,149,101,135
../../CUB_200_2011/images\135.Bank_Swallow/Bank_Swallow_0067_129959.jpg,500,347,135.Bank_Swallow,148,139,286,324,217,231,138,185
../../CUB_200_2011/images\135.Bank_Swallow/Bank_Swallow_0012_129518.jpg,500,375,135.Bank_Swallow,212,133,354,274,283,203,142,141
../../CUB_200_2011/images\135.Bank_Swallow/Bank_Swallow_0045_129483.jpg,500,333,135.Bank_Swallow,181,28,376,255,278,141,195,227
../../CUB_200_2011/images\135.Bank_Swallow/Bank_Swallow_0061_129484.jpg,500,333,135.Bank_Swallow,262,174,384,326,323,250,122,152
../../CUB_200_2011/images\135.Bank_Swallow/Bank_Swallow_0046_129742.jpg,500,371,135.Bank_Swallow,82,64,471,281,276,172,389,217
../../CUB_200_2011/images\135.Bank_Swallow/Bank_Swallow_0054_129743.jpg,500,487,135.Bank_Swallow,136,82,395,399,265,240,259,317
../../CUB_200_2011/images\135.Bank_Swallow/Bank_Swallow_0032_129491.jpg,500,358,135.Bank_Swallow,164,17,333,350,248,183,169,333
../../CUB_200_2011/images\135.Bank_Swallow/Bank_Swallow_0029_129751.jpg,500,333,135.Bank_Swallow,75,93,313,286,194,189,238,193
../../CUB_200_2011/images\135.Bank_Swallow/Bank_Swallow_0034_129496.jpg,500,373,135.Bank_Swallow,83,68,280,315,181,191,197,247
../../CUB_200_2011/images\135.Bank_Swallow/Bank_Swallow_0028_129754.jpg,500,309,135.Bank_Swallow,178,79,299,225,238,152,121,146
../../CUB_200_2011/images\135.Bank_Swallow/Bank_Swallow_0017_129755.jpg,500,333,135.Bank_Swallow,138,69,256,301,197,185,118,232
../../CUB_200_2011/images\135.Bank_Swallow/Bank_Swallow_0058_129756.jpg,500,375,135.Bank_Swallow,62,89,377,280,219,184,315,191
../../CUB_200_2011/images\135.Bank_Swallow/Bank_Swallow_0053_129501.jpg,500,336,135.Bank_Swallow,151,79,303,281,227,180,152,202
../../CUB_200_2011/images\135.Bank_Swallow/Bank_Swallow_0027_129503.jpg,500,333,135.Bank_Swallow,21,82,336,280,178,181,315,198
../../CUB_200_2011/images\135.Bank_Swallow/Bank_Swallow_0031_129507.jpg,359,500,135.Bank_Swallow,48,132,206,433,127,282,158,301
../../CUB_200_2011/images\135.Bank_Swallow/Bank_Swallow_0033_129509.jpg,500,313,135.Bank_Swallow,138,53,263,273,200,163,125,220
../../CUB_200_2011/images\135.Bank_Swallow/Bank_Swallow_0007_129514.jpg,500,375,135.Bank_Swallow,178,151,306,280,242,215,128,129
../../CUB_200_2011/images\135.Bank_Swallow/Bank_Swallow_0001_129516.jpg,500,473,135.Bank_Swallow,189,150,292,448,240,299,103,298
../../CUB_200_2011/images\135.Bank_Swallow/Bank_Swallow_0063_129774.jpg,500,375,135.Bank_Swallow,134,155,323,324,228,239,189,169
../../CUB_200_2011/images\135.Bank_Swallow/Bank_Swallow_0047_129520.jpg,500,432,135.Bank_Swallow,51,28,342,387,196,207,291,359
../../CUB_200_2011/images\135.Bank_Swallow/Bank_Swallow_0025_129521.jpg,500,471,135.Bank_Swallow,244,132,347,271,295,201,103,139
../../CUB_200_2011/images\135.Bank_Swallow/Bank_Swallow_0024_129779.jpg,375,500,135.Bank_Swallow,67,105,206,456,136,280,139,351
../../CUB_200_2011/images\135.Bank_Swallow/Bank_Swallow_0050_129780.jpg,500,333,135.Bank_Swallow,174,68,311,319,242,193,137,251
../../CUB_200_2011/images\135.Bank_Swallow/Bank_Swallow_0035_129528.jpg,500,375,135.Bank_Swallow,185,117,323,223,254,170,138,106
../../CUB_200_2011/images\135.Bank_Swallow/Bank_Swallow_0019_129788.jpg,500,358,135.Bank_Swallow,188,105,343,305,265,205,155,200
../../CUB_200_2011/images\135.Bank_Swallow/Bank_Swallow_0016_129791.jpg,429,500,135.Bank_Swallow,136,156,374,417,255,286,238,261
../../CUB_200_2011/images\136.Barn_Swallow/Barn_Swallow_0038_132780.jpg,386,500,136.Barn_Swallow,134,95,330,468,232,281,196,373
../../CUB_200_2011/images\136.Barn_Swallow/Barn_Swallow_0041_131860.jpg,500,334,136.Barn_Swallow,152,105,299,297,225,201,147,192
../../CUB_200_2011/images\136.Barn_Swallow/Barn_Swallow_0053_130585.jpg,500,335,136.Barn_Swallow,1,90,343,281,172,185,342,191
../../CUB_200_2011/images\136.Barn_Swallow/Barn_Swallow_0005_130591.jpg,500,333,136.Barn_Swallow,186,108,431,220,308,164,245,112
../../CUB_200_2011/images\136.Barn_Swallow/Barn_Swallow_0026_132386.jpg,500,394,136.Barn_Swallow,10,29,435,376,222,202,425,347
../../CUB_200_2011/images\136.Barn_Swallow/Barn_Swallow_0003_130086.jpg,497,500,136.Barn_Swallow,169,230,480,429,324,329,311,199
../../CUB_200_2011/images\136.Barn_Swallow/Barn_Swallow_0050_130095.jpg,500,324,136.Barn_Swallow,77,80,390,258,233,169,313,178
../../CUB_200_2011/images\136.Barn_Swallow/Barn_Swallow_0034_130099.jpg,334,500,136.Barn_Swallow,47,135,301,348,174,241,254,213
../../CUB_200_2011/images\136.Barn_Swallow/Barn_Swallow_0075_130014.jpg,500,375,136.Barn_Swallow,264,78,495,243,379,160,231,165
../../CUB_200_2011/images\136.Barn_Swallow/Barn_Swallow_0056_132916.jpg,479,500,136.Barn_Swallow,231,147,342,255,286,201,111,108
../../CUB_200_2011/images\136.Barn_Swallow/Barn_Swallow_0094_132154.jpg,340,500,136.Barn_Swallow,78,100,334,359,206,229,256,259
../../CUB_200_2011/images\136.Barn_Swallow/Barn_Swallow_0073_131389.jpg,500,333,136.Barn_Swallow,100,43,442,303,271,173,342,260
../../CUB_200_2011/images\136.Barn_Swallow/Barn_Swallow_0060_130110.jpg,500,246,136.Barn_Swallow,62,74,312,234,187,154,250,160
../../CUB_200_2011/images\136.Barn_Swallow/Barn_Swallow_0021_130367.jpg,500,333,136.Barn_Swallow,190,83,356,293,273,188,166,210
../../CUB_200_2011/images\136.Barn_Swallow/Barn_Swallow_0069_130368.jpg,500,334,136.Barn_Swallow,8,55,444,286,226,170,436,231
../../CUB_200_2011/images\136.Barn_Swallow/Barn_Swallow_0047_130016.jpg,500,370,136.Barn_Swallow,192,76,435,300,313,188,243,224
../../CUB_200_2011/images\136.Barn_Swallow/Barn_Swallow_0022_130631.jpg,402,500,136.Barn_Swallow,61,63,354,474,207,268,293,411
../../CUB_200_2011/images\136.Barn_Swallow/Barn_Swallow_0054_131146.jpg,500,374,136.Barn_Swallow,16,129,365,372,190,250,349,243
../../CUB_200_2011/images\136.Barn_Swallow/Barn_Swallow_0085_132939.jpg,500,400,136.Barn_Swallow,26,72,312,311,169,191,286,239
../../CUB_200_2011/images\136.Barn_Swallow/Barn_Swallow_0070_130127.jpg,500,333,136.Barn_Swallow,111,52,400,196,255,124,289,144
../../CUB_200_2011/images\136.Barn_Swallow/Barn_Swallow_0078_130385.jpg,500,335,136.Barn_Swallow,110,87,305,282,207,184,195,195
../../CUB_200_2011/images\136.Barn_Swallow/Barn_Swallow_0083_132949.jpg,500,348,136.Barn_Swallow,17,66,271,335,144,200,254,269
../../CUB_200_2011/images\136.Barn_Swallow/Barn_Swallow_0017_132951.jpg,500,357,136.Barn_Swallow,10,115,370,317,190,216,360,202
../../CUB_200_2011/images\136.Barn_Swallow/Barn_Swallow_0055_131933.jpg,399,500,136.Barn_Swallow,86,100,353,406,219,253,267,306
../../CUB_200_2011/images\136.Barn_Swallow/Barn_Swallow_0089_131934.jpg,500,375,136.Barn_Swallow,143,137,322,292,232,214,179,155
../../CUB_200_2011/images\136.Barn_Swallow/Barn_Swallow_0014_130403.jpg,500,331,136.Barn_Swallow,135,96,443,285,289,190,308,189
../../CUB_200_2011/images\136.Barn_Swallow/Barn_Swallow_0062_132755.jpg,500,500,136.Barn_Swallow,35,129,457,350,246,239,422,221
../../CUB_200_2011/images\136.Barn_Swallow/Barn_Swallow_0044_132542.jpg,500,500,136.Barn_Swallow,94,63,399,458,246,260,305,395
../../CUB_200_2011/images\136.Barn_Swallow/Barn_Swallow_0016_130678.jpg,500,333,136.Barn_Swallow,2,80,315,215,158,147,313,135
../../CUB_200_2011/images\136.Barn_Swallow/Barn_Swallow_0086_132477.jpg,500,333,136.Barn_Swallow,14,62,480,273,247,167,466,211
../../CUB_200_2011/images\136.Barn_Swallow/Barn_Swallow_0023_130325.jpg,333,500,136.Barn_Swallow,19,85,234,313,126,199,215,228
../../CUB_200_2011/images\136.Barn_Swallow/Barn_Swallow_0049_130181.jpg,500,375,136.Barn_Swallow,27,112,317,280,172,196,290,168
../../CUB_200_2011/images\136.Barn_Swallow/Barn_Swallow_0030_130191.jpg,500,334,136.Barn_Swallow,277,19,486,302,381,160,209,283
../../CUB_200_2011/images\136.Barn_Swallow/Barn_Swallow_0077_130707.jpg,500,357,136.Barn_Swallow,50,59,262,335,156,197,212,276
../../CUB_200_2011/images\136.Barn_Swallow/Barn_Swallow_0018_130709.jpg,500,332,136.Barn_Swallow,123,70,432,315,277,192,309,245
../../CUB_200_2011/images\136.Barn_Swallow/Barn_Swallow_0045_130244.jpg,500,331,136.Barn_Swallow,187,148,495,272,341,210,308,124
../../CUB_200_2011/images\136.Barn_Swallow/Barn_Swallow_0066_130214.jpg,500,316,136.Barn_Swallow,26,20,474,285,250,152,448,265
../../CUB_200_2011/images\136.Barn_Swallow/Barn_Swallow_0072_130474.jpg,500,350,136.Barn_Swallow,30,68,322,302,176,185,292,234
../../CUB_200_2011/images\136.Barn_Swallow/Barn_Swallow_0015_132757.jpg,400,500,136.Barn_Swallow,78,87,272,420,175,253,194,333
../../CUB_200_2011/images\136.Barn_Swallow/Barn_Swallow_0093_130121.jpg,500,438,136.Barn_Swallow,0,38,431,378,215,208,431,340
../../CUB_200_2011/images\136.Barn_Swallow/Barn_Swallow_0048_132793.jpg,500,396,136.Barn_Swallow,126,82,479,296,302,189,353,214
../../CUB_200_2011/images\136.Barn_Swallow/Barn_Swallow_0027_129978.jpg,375,500,136.Barn_Swallow,67,81,354,457,210,269,287,376
../../CUB_200_2011/images\136.Barn_Swallow/Barn_Swallow_0076_130757.jpg,500,333,136.Barn_Swallow,210,117,458,307,334,212,248,190
../../CUB_200_2011/images\136.Barn_Swallow/Barn_Swallow_0042_132043.jpg,463,500,136.Barn_Swallow,125,108,326,441,225,274,201,333
../../CUB_200_2011/images\136.Barn_Swallow/Barn_Swallow_0052_131539.jpg,500,358,136.Barn_Swallow,100,32,401,261,250,146,301,229
../../CUB_200_2011/images\136.Barn_Swallow/Barn_Swallow_0007_131030.jpg,500,404,136.Barn_Swallow,231,63,345,232,288,147,114,169
../../CUB_200_2011/images\136.Barn_Swallow/Barn_Swallow_0043_130779.jpg,500,360,136.Barn_Swallow,123,66,450,317,286,191,327,251
../../CUB_200_2011/images\136.Barn_Swallow/Barn_Swallow_0063_132572.jpg,500,333,136.Barn_Swallow,217,80,328,215,272,147,111,135
../../CUB_200_2011/images\136.Barn_Swallow/Barn_Swallow_0020_132317.jpg,500,346,136.Barn_Swallow,200,117,459,273,329,195,259,156
../../CUB_200_2011/images\136.Barn_Swallow/Barn_Swallow_0029_132832.jpg,500,354,136.Barn_Swallow,158,81,404,319,281,200,246,238
../../CUB_200_2011/images\136.Barn_Swallow/Barn_Swallow_0064_132688.jpg,400,500,136.Barn_Swallow,14,11,372,486,193,248,358,475
../../CUB_200_2011/images\136.Barn_Swallow/Barn_Swallow_0065_131555.jpg,500,342,136.Barn_Swallow,127,53,245,304,186,178,118,251
../../CUB_200_2011/images\136.Barn_Swallow/Barn_Swallow_0013_131812.jpg,500,333,136.Barn_Swallow,112,22,303,325,207,173,191,303
../../CUB_200_2011/images\136.Barn_Swallow/Barn_Swallow_0084_130800.jpg,500,350,136.Barn_Swallow,125,119,461,292,293,205,336,173
../../CUB_200_2011/images\136.Barn_Swallow/Barn_Swallow_0006_131315.jpg,500,334,136.Barn_Swallow,168,88,413,283,290,185,245,195
../../CUB_200_2011/images\136.Barn_Swallow/Barn_Swallow_0080_131829.jpg,500,375,136.Barn_Swallow,172,117,302,265,237,191,130,148
../../CUB_200_2011/images\136.Barn_Swallow/Barn_Swallow_0002_130551.jpg,500,462,136.Barn_Swallow,6,30,474,424,240,227,468,394
../../CUB_200_2011/images\136.Barn_Swallow/Barn_Swallow_0035_131832.jpg,500,356,136.Barn_Swallow,7,97,441,271,224,184,434,174
../../CUB_200_2011/images\136.Barn_Swallow/Barn_Swallow_0019_130555.jpg,333,500,136.Barn_Swallow,132,60,315,235,223,147,183,175
../../CUB_200_2011/images\136.Barn_Swallow/Barn_Swallow_0074_132094.jpg,486,500,136.Barn_Swallow,175,126,306,373,240,249,131,247
../../CUB_200_2011/images\137.Cliff_Swallow/Cliff_Swallow_0012_133527.jpg,500,500,137.Cliff_Swallow,63,93,499,437,281,265,436,344
../../CUB_200_2011/images\137.Cliff_Swallow/Cliff_Swallow_0084_133974.jpg,500,385,137.Cliff_Swallow,160,117,271,275,215,196,111,158
../../CUB_200_2011/images\137.Cliff_Swallow/Cliff_Swallow_0088_134188.jpg,500,375,137.Cliff_Swallow,69,138,296,342,182,240,227,204
../../CUB_200_2011/images\137.Cliff_Swallow/Cliff_Swallow_0098_133130.jpg,438,500,137.Cliff_Swallow,199,67,353,191,276,129,154,124
../../CUB_200_2011/images\137.Cliff_Swallow/Cliff_Swallow_0039_133645.jpg,500,322,137.Cliff_Swallow,244,94,488,276,366,185,244,182
../../CUB_200_2011/images\137.Cliff_Swallow/Cliff_Swallow_0042_133646.jpg,500,462,137.Cliff_Swallow,121,70,352,432,236,251,231,362
../../CUB_200_2011/images\137.Cliff_Swallow/Cliff_Swallow_0087_133294.jpg,500,481,137.Cliff_Swallow,114,73,419,342,266,207,305,269
../../CUB_200_2011/images\137.Cliff_Swallow/Cliff_Swallow_0090_133144.jpg,500,333,137.Cliff_Swallow,29,8,458,302,243,155,429,294
../../CUB_200_2011/images\137.Cliff_Swallow/Cliff_Swallow_0100_133665.jpg,500,374,137.Cliff_Swallow,83,48,467,301,275,174,384,253
../../CUB_200_2011/images\137.Cliff_Swallow/Cliff_Swallow_0044_133927.jpg,375,500,137.Cliff_Swallow,17,55,331,346,174,200,314,291
../../CUB_200_2011/images\137.Cliff_Swallow/Cliff_Swallow_0031_133164.jpg,500,333,137.Cliff_Swallow,51,135,330,316,190,225,279,181
../../CUB_200_2011/images\137.Cliff_Swallow/Cliff_Swallow_0046_133165.jpg,500,333,137.Cliff_Swallow,1,109,356,238,178,173,355,129
../../CUB_200_2011/images\137.Cliff_Swallow/Cliff_Swallow_0036_133168.jpg,500,392,137.Cliff_Swallow,229,63,387,243,308,153,158,180
../../CUB_200_2011/images\137.Cliff_Swallow/Cliff_Swallow_0013_133169.jpg,500,400,137.Cliff_Swallow,112,84,448,284,280,184,336,200
../../CUB_200_2011/images\137.Cliff_Swallow/Cliff_Swallow_0015_133176.jpg,500,345,137.Cliff_Swallow,85,61,362,269,223,165,277,208
../../CUB_200_2011/images\137.Cliff_Swallow/Cliff_Swallow_0005_133696.jpg,500,374,137.Cliff_Swallow,83,58,353,295,218,176,270,237
../../CUB_200_2011/images\137.Cliff_Swallow/Cliff_Swallow_0047_133955.jpg,500,334,137.Cliff_Swallow,129,187,323,288,226,237,194,101
../../CUB_200_2011/images\137.Cliff_Swallow/Cliff_Swallow_0038_133701.jpg,500,365,137.Cliff_Swallow,65,86,464,309,264,197,399,223
../../CUB_200_2011/images\137.Cliff_Swallow/Cliff_Swallow_0028_132365.jpg,500,333,137.Cliff_Swallow,29,59,392,266,210,162,363,207
../../CUB_200_2011/images\137.Cliff_Swallow/Cliff_Swallow_0027_133203.jpg,500,500,137.Cliff_Swallow,96,94,373,475,234,284,277,381
../../CUB_200_2011/images\137.Cliff_Swallow/Cliff_Swallow_0108_133902.jpg,500,375,137.Cliff_Swallow,196,82,350,279,273,180,154,197
../../CUB_200_2011/images\137.Cliff_Swallow/Cliff_Swallow_0066_133206.jpg,500,427,137.Cliff_Swallow,169,86,346,424,257,255,177,338
../../CUB_200_2011/images\137.Cliff_Swallow/Cliff_Swallow_0094_133114.jpg,500,385,137.Cliff_Swallow,127,112,261,292,194,202,134,180
../../CUB_200_2011/images\137.Cliff_Swallow/Cliff_Swallow_0068_134236.jpg,333,500,137.Cliff_Swallow,44,186,171,394,107,290,127,208
../../CUB_200_2011/images\137.Cliff_Swallow/Cliff_Swallow_0049_132965.jpg,500,333,137.Cliff_Swallow,69,38,394,261,231,149,325,223
../../CUB_200_2011/images\137.Cliff_Swallow/Cliff_Swallow_0099_133948.jpg,500,335,137.Cliff_Swallow,72,64,269,314,170,189,197,250
../../CUB_200_2011/images\137.Cliff_Swallow/Cliff_Swallow_0071_133742.jpg,500,465,137.Cliff_Swallow,24,66,493,388,258,227,469,322
../../CUB_200_2011/images\137.Cliff_Swallow/Cliff_Swallow_0006_133489.jpg,500,400,137.Cliff_Swallow,138,96,342,304,240,200,204,208
../../CUB_200_2011/images\137.Cliff_Swallow/Cliff_Swallow_0075_134516.jpg,361,500,137.Cliff_Swallow,51,149,329,316,190,232,278,167
../../CUB_200_2011/images\137.Cliff_Swallow/Cliff_Swallow_0003_133496.jpg,500,400,137.Cliff_Swallow,216,78,398,333,307,205,182,255
../../CUB_200_2011/images\137.Cliff_Swallow/Cliff_Swallow_0092_132971.jpg,436,500,137.Cliff_Swallow,70,33,370,460,220,246,300,427
../../CUB_200_2011/images\137.Cliff_Swallow/Cliff_Swallow_0061_133259.jpg,458,500,137.Cliff_Swallow,138,34,383,472,260,253,245,438
../../CUB_200_2011/images\137.Cliff_Swallow/Cliff_Swallow_0069_133521.jpg,500,385,137.Cliff_Swallow,104,95,316,249,210,172,212,154
../../CUB_200_2011/images\137.Cliff_Swallow/Cliff_Swallow_0018_132974.jpg,500,333,137.Cliff_Swallow,101,65,322,228,211,146,221,163
../../CUB_200_2011/images\137.Cliff_Swallow/Cliff_Swallow_0022_133786.jpg,500,339,137.Cliff_Swallow,158,50,352,316,255,183,194,266
../../CUB_200_2011/images\137.Cliff_Swallow/Cliff_Swallow_0060_133280.jpg,333,500,137.Cliff_Swallow,23,51,301,430,162,240,278,379
../../CUB_200_2011/images\137.Cliff_Swallow/Cliff_Swallow_0083_133771.jpg,334,500,137.Cliff_Swallow,56,10,272,495,164,252,216,485
../../CUB_200_2011/images\137.Cliff_Swallow/Cliff_Swallow_0050_134054.jpg,330,220,137.Cliff_Swallow,17,46,206,198,111,122,189,152
../../CUB_200_2011/images\137.Cliff_Swallow/Cliff_Swallow_0054_133287.jpg,500,333,137.Cliff_Swallow,43,30,340,301,191,165,297,271
../../CUB_200_2011/images\137.Cliff_Swallow/Cliff_Swallow_0089_133545.jpg,500,333,137.Cliff_Swallow,65,71,420,275,242,173,355,204
../../CUB_200_2011/images\137.Cliff_Swallow/Cliff_Swallow_0023_134314.jpg,500,333,137.Cliff_Swallow,292,77,430,222,361,149,138,145
../../CUB_200_2011/images\137.Cliff_Swallow/Cliff_Swallow_0017_133806.jpg,500,410,137.Cliff_Swallow,31,40,458,396,244,218,427,356
../../CUB_200_2011/images\137.Cliff_Swallow/Cliff_Swallow_0093_133052.jpg,400,500,137.Cliff_Swallow,43,165,305,361,174,263,262,196
../../CUB_200_2011/images\137.Cliff_Swallow/Cliff_Swallow_0052_133055.jpg,406,500,137.Cliff_Swallow,26,133,284,362,155,247,258,229
../../CUB_200_2011/images\137.Cliff_Swallow/Cliff_Swallow_0085_134338.jpg,500,334,137.Cliff_Swallow,168,82,422,301,295,191,254,219
../../CUB_200_2011/images\137.Cliff_Swallow/Cliff_Swallow_0058_133060.jpg,500,313,137.Cliff_Swallow,72,97,470,201,271,149,398,104
../../CUB_200_2011/images\137.Cliff_Swallow/Cliff_Swallow_0056_133921.jpg,500,473,137.Cliff_Swallow,35,94,458,345,246,219,423,251
../../CUB_200_2011/images\137.Cliff_Swallow/Cliff_Swallow_0033_133836.jpg,500,333,137.Cliff_Swallow,76,22,322,329,199,175,246,307
../../CUB_200_2011/images\137.Cliff_Swallow/Cliff_Swallow_0101_133069.jpg,500,375,137.Cliff_Swallow,298,12,476,347,387,179,178,335
../../CUB_200_2011/images\137.Cliff_Swallow/Cliff_Swallow_0045_133591.jpg,500,341,137.Cliff_Swallow,157,55,306,191,231,123,149,136
../../CUB_200_2011/images\137.Cliff_Swallow/Cliff_Swallow_0063_133852.jpg,500,333,137.Cliff_Swallow,120,111,341,218,230,164,221,107
../../CUB_200_2011/images\137.Cliff_Swallow/Cliff_Swallow_0041_134111.jpg,500,358,137.Cliff_Swallow,184,54,330,268,257,161,146,214
../../CUB_200_2011/images\137.Cliff_Swallow/Cliff_Swallow_0065_133858.jpg,500,375,137.Cliff_Swallow,203,112,428,365,315,238,225,253
../../CUB_200_2011/images\137.Cliff_Swallow/Cliff_Swallow_0081_134119.jpg,500,375,137.Cliff_Swallow,87,119,323,310,205,214,236,191
../../CUB_200_2011/images\137.Cliff_Swallow/Cliff_Swallow_0035_133097.jpg,500,394,137.Cliff_Swallow,49,77,403,260,226,168,354,183
../../CUB_200_2011/images\137.Cliff_Swallow/Cliff_Swallow_0062_134383.jpg,500,500,137.Cliff_Swallow,112,137,351,348,231,242,239,211
../../CUB_200_2011/images\137.Cliff_Swallow/Cliff_Swallow_0011_133033.jpg,500,359,137.Cliff_Swallow,154,35,318,349,236,192,164,314
../../CUB_200_2011/images\137.Cliff_Swallow/Cliff_Swallow_0055_133624.jpg,500,300,137.Cliff_Swallow,152,82,380,299,266,190,228,217
../../CUB_200_2011/images\137.Cliff_Swallow/Cliff_Swallow_0103_133882.jpg,322,230,137.Cliff_Swallow,47,52,246,161,146,106,199,109
../../CUB_200_2011/images\137.Cliff_Swallow/Cliff_Swallow_0073_133116.jpg,500,360,137.Cliff_Swallow,205,109,397,213,301,161,192,104
../../CUB_200_2011/images\138.Tree_Swallow/Tree_Swallow_0040_135172.jpg,500,375,138.Tree_Swallow,80,48,385,303,232,175,305,255
../../CUB_200_2011/images\138.Tree_Swallow/Tree_Swallow_0117_134925.jpg,500,333,138.Tree_Swallow,74,20,376,322,225,171,302,302
../../CUB_200_2011/images\138.Tree_Swallow/Tree_Swallow_0076_137232.jpg,500,385,138.Tree_Swallow,143,72,301,268,222,170,158,196
../../CUB_200_2011/images\138.Tree_Swallow/Tree_Swallow_0100_137493.jpg,500,371,138.Tree_Swallow,132,64,328,198,230,131,196,134
../../CUB_200_2011/images\138.Tree_Swallow/Tree_Swallow_0032_136216.jpg,500,374,138.Tree_Swallow,105,140,250,251,177,195,145,111
../../CUB_200_2011/images\138.Tree_Swallow/Tree_Swallow_0098_134916.jpg,400,500,138.Tree_Swallow,58,129,188,355,123,242,130,226
../../CUB_200_2011/images\138.Tree_Swallow/Tree_Swallow_0046_135770.jpg,500,459,138.Tree_Swallow,141,48,393,328,267,188,252,280
../../CUB_200_2011/images\138.Tree_Swallow/Tree_Swallow_0030_134942.jpg,500,325,138.Tree_Swallow,192,51,408,254,300,152,216,203
../../CUB_200_2011/images\138.Tree_Swallow/Tree_Swallow_0107_136223.jpg,500,404,138.Tree_Swallow,23,33,467,253,245,143,444,220
../../CUB_200_2011/images\138.Tree_Swallow/Tree_Swallow_0060_134961.jpg,500,500,138.Tree_Swallow,13,39,489,497,251,268,476,458
../../CUB_200_2011/images\138.Tree_Swallow/Tree_Swallow_0092_136236.jpg,500,432,138.Tree_Swallow,131,121,415,333,273,227,284,212
../../CUB_200_2011/images\138.Tree_Swallow/Tree_Swallow_0071_136749.jpg,500,375,138.Tree_Swallow,123,53,463,292,293,172,340,239
../../CUB_200_2011/images\138.Tree_Swallow/Tree_Swallow_0044_135984.jpg,500,313,138.Tree_Swallow,136,38,486,292,311,165,350,254
../../CUB_200_2011/images\138.Tree_Swallow/Tree_Swallow_0074_135219.jpg,500,343,138.Tree_Swallow,72,81,335,227,203,154,263,146
../../CUB_200_2011/images\138.Tree_Swallow/Tree_Swallow_0067_136244.jpg,400,500,138.Tree_Swallow,142,31,368,193,255,112,226,162
../../CUB_200_2011/images\138.Tree_Swallow/Tree_Swallow_0061_134712.jpg,500,333,138.Tree_Swallow,145,32,267,314,206,173,122,282
../../CUB_200_2011/images\138.Tree_Swallow/Tree_Swallow_0114_136265.jpg,500,357,138.Tree_Swallow,260,115,425,290,342,202,165,175
../../CUB_200_2011/images\138.Tree_Swallow/Tree_Swallow_0008_135352.jpg,498,500,138.Tree_Swallow,52,168,282,496,167,332,230,328
../../CUB_200_2011/images\138.Tree_Swallow/Tree_Swallow_0049_134740.jpg,333,500,138.Tree_Swallow,37,5,294,431,165,218,257,426
../../CUB_200_2011/images\138.Tree_Swallow/Tree_Swallow_0111_135253.jpg,500,355,138.Tree_Swallow,106,94,262,282,184,188,156,188
../../CUB_200_2011/images\138.Tree_Swallow/Tree_Swallow_0103_137272.jpg,500,333,138.Tree_Swallow,85,37,292,316,188,176,207,279
../../CUB_200_2011/images\138.Tree_Swallow/Tree_Swallow_0002_136792.jpg,500,333,138.Tree_Swallow,214,114,426,277,320,195,212,163
../../CUB_200_2011/images\138.Tree_Swallow/Tree_Swallow_0082_135006.jpg,500,375,138.Tree_Swallow,63,55,271,321,167,188,208,266
../../CUB_200_2011/images\138.Tree_Swallow/Tree_Swallow_0083_136800.jpg,500,342,138.Tree_Swallow,109,79,490,314,299,196,381,235
../../CUB_200_2011/images\138.Tree_Swallow/Tree_Swallow_0109_135272.jpg,500,381,138.Tree_Swallow,186,119,333,299,259,209,147,180
../../CUB_200_2011/images\138.Tree_Swallow/Tree_Swallow_0066_135788.jpg,500,375,138.Tree_Swallow,170,68,409,311,289,189,239,243
../../CUB_200_2011/images\138.Tree_Swallow/Tree_Swallow_0016_135549.jpg,334,500,138.Tree_Swallow,16,121,224,396,120,258,208,275
../../CUB_200_2011/images\138.Tree_Swallow/Tree_Swallow_0039_135038.jpg,375,500,138.Tree_Swallow,108,54,357,327,232,190,249,273
../../CUB_200_2011/images\138.Tree_Swallow/Tree_Swallow_0064_136322.jpg,500,475,138.Tree_Swallow,80,101,181,254,130,177,101,153
../../CUB_200_2011/images\138.Tree_Swallow/Tree_Swallow_0105_134648.jpg,500,388,138.Tree_Swallow,165,133,423,286,294,209,258,153
../../CUB_200_2011/images\138.Tree_Swallow/Tree_Swallow_0015_134790.jpg,500,375,138.Tree_Swallow,230,147,423,319,326,233,193,172
../../CUB_200_2011/images\138.Tree_Swallow/Tree_Swallow_0037_134647.jpg,332,500,138.Tree_Swallow,77,182,320,395,198,288,243,213
../../CUB_200_2011/images\138.Tree_Swallow/Tree_Swallow_0087_137354.jpg,401,500,138.Tree_Swallow,101,123,313,362,207,242,212,239
../../CUB_200_2011/images\138.Tree_Swallow/Tree_Swallow_0020_136587.jpg,500,390,138.Tree_Swallow,121,70,420,360,270,215,299,290
../../CUB_200_2011/images\138.Tree_Swallow/Tree_Swallow_0035_136589.jpg,500,333,138.Tree_Swallow,95,52,200,292,147,172,105,240
../../CUB_200_2011/images\138.Tree_Swallow/Tree_Swallow_0113_136849.jpg,500,385,138.Tree_Swallow,166,91,421,309,293,200,255,218
../../CUB_200_2011/images\138.Tree_Swallow/Tree_Swallow_0095_135829.jpg,500,454,138.Tree_Swallow,98,81,224,269,161,175,126,188
../../CUB_200_2011/images\138.Tree_Swallow/Tree_Swallow_0017_135062.jpg,375,500,138.Tree_Swallow,226,171,327,334,276,252,101,163
../../CUB_200_2011/images\138.Tree_Swallow/Tree_Swallow_0115_135832.jpg,500,375,138.Tree_Swallow,90,54,369,296,229,175,279,242
../../CUB_200_2011/images\138.Tree_Swallow/Tree_Swallow_0108_135068.jpg,500,440,138.Tree_Swallow,68,63,409,302,238,182,341,239
../../CUB_200_2011/images\138.Tree_Swallow/Tree_Swallow_0090_135325.jpg,500,376,138.Tree_Swallow,25,126,261,334,143,230,236,208
../../CUB_200_2011/images\138.Tree_Swallow/Tree_Swallow_0075_136081.jpg,375,500,138.Tree_Swallow,85,141,254,361,169,251,169,220
../../CUB_200_2011/images\138.Tree_Swallow/Tree_Swallow_0091_136870.jpg,500,333,138.Tree_Swallow,75,45,391,274,233,159,316,229
../../CUB_200_2011/images\138.Tree_Swallow/Tree_Swallow_0019_137073.jpg,479,500,138.Tree_Swallow,119,75,413,319,266,197,294,244
../../CUB_200_2011/images\138.Tree_Swallow/Tree_Swallow_0043_136878.jpg,375,500,138.Tree_Swallow,76,145,230,385,153,265,154,240
../../CUB_200_2011/images\138.Tree_Swallow/Tree_Swallow_0023_135345.jpg,337,500,138.Tree_Swallow,89,67,299,439,194,253,210,372
../../CUB_200_2011/images\138.Tree_Swallow/Tree_Swallow_0004_135411.jpg,500,400,138.Tree_Swallow,183,127,430,335,306,231,247,208
../../CUB_200_2011/images\138.Tree_Swallow/Tree_Swallow_0050_135104.jpg,500,446,138.Tree_Swallow,184,36,446,387,315,211,262,351
../../CUB_200_2011/images\138.Tree_Swallow/Tree_Swallow_0058_134987.jpg,432,500,138.Tree_Swallow,141,89,369,431,255,260,228,342
../../CUB_200_2011/images\138.Tree_Swallow/Tree_Swallow_0042_136401.jpg,500,361,138.Tree_Swallow,88,75,398,319,243,197,310,244
../../CUB_200_2011/images\138.Tree_Swallow/Tree_Swallow_0062_137426.jpg,500,295,138.Tree_Swallow,299,63,425,201,362,132,126,138
../../CUB_200_2011/images\138.Tree_Swallow/Tree_Swallow_0110_136921.jpg,500,332,138.Tree_Swallow,123,49,330,292,226,170,207,243
../../CUB_200_2011/images\138.Tree_Swallow/Tree_Swallow_0029_134882.jpg,500,333,138.Tree_Swallow,218,51,344,202,281,126,126,151
../../CUB_200_2011/images\138.Tree_Swallow/Tree_Swallow_0127_135912.jpg,500,375,138.Tree_Swallow,283,104,493,268,388,186,210,164
../../CUB_200_2011/images\138.Tree_Swallow/Tree_Swallow_0056_135079.jpg,333,500,138.Tree_Swallow,73,119,300,457,186,288,227,338
../../CUB_200_2011/images\138.Tree_Swallow/Tree_Swallow_0069_135148.jpg,500,333,138.Tree_Swallow,143,126,348,236,245,181,205,110
../../CUB_200_2011/images\138.Tree_Swallow/Tree_Swallow_0013_135923.jpg,500,308,138.Tree_Swallow,24,47,253,306,138,176,229,259
../../CUB_200_2011/images\138.Tree_Swallow/Tree_Swallow_0041_136439.jpg,333,500,138.Tree_Swallow,66,60,294,413,180,236,228,353
../../CUB_200_2011/images\138.Tree_Swallow/Tree_Swallow_0102_135061.jpg,500,400,138.Tree_Swallow,150,110,417,256,283,183,267,146
../../CUB_200_2011/images\138.Tree_Swallow/Tree_Swallow_0073_134997.jpg,500,379,138.Tree_Swallow,196,59,395,320,295,189,199,261
../../CUB_200_2011/images\139.Scarlet_Tanager/Scarlet_Tanager_0116_138242.jpg,500,432,139.Scarlet_Tanager,146,145,336,298,241,221,190,153
../../CUB_200_2011/images\139.Scarlet_Tanager/Scarlet_Tanager_0093_138250.jpg,482,500,139.Scarlet_Tanager,163,72,314,440,238,256,151,368
../../CUB_200_2011/images\139.Scarlet_Tanager/Scarlet_Tanager_0121_138255.jpg,500,333,139.Scarlet_Tanager,55,91,306,206,180,148,251,115
../../CUB_200_2011/images\139.Scarlet_Tanager/Scarlet_Tanager_0129_137745.jpg,339,500,139.Scarlet_Tanager,170,202,318,414,244,308,148,212
../../CUB_200_2011/images\139.Scarlet_Tanager/Scarlet_Tanager_0113_138262.jpg,500,259,139.Scarlet_Tanager,173,74,288,180,230,127,115,106
../../CUB_200_2011/images\139.Scarlet_Tanager/Scarlet_Tanager_0068_137758.jpg,500,345,139.Scarlet_Tanager,172,126,395,300,283,213,223,174
../../CUB_200_2011/images\139.Scarlet_Tanager/Scarlet_Tanager_0086_138272.jpg,334,500,139.Scarlet_Tanager,61,72,329,326,195,199,268,254
../../CUB_200_2011/images\139.Scarlet_Tanager/Scarlet_Tanager_0110_138274.jpg,343,500,139.Scarlet_Tanager,79,182,242,324,160,253,163,142
../../CUB_200_2011/images\139.Scarlet_Tanager/Scarlet_Tanager_0089_138281.jpg,400,500,139.Scarlet_Tanager,111,148,281,269,196,208,170,121
../../CUB_200_2011/images\139.Scarlet_Tanager/Scarlet_Tanager_0042_138287.jpg,375,500,139.Scarlet_Tanager,72,132,267,355,169,243,195,223
../../CUB_200_2011/images\139.Scarlet_Tanager/Scarlet_Tanager_0119_138291.jpg,500,347,139.Scarlet_Tanager,106,80,249,262,177,171,143,182
../../CUB_200_2011/images\139.Scarlet_Tanager/Scarlet_Tanager_0018_138294.jpg,500,356,139.Scarlet_Tanager,98,61,301,222,199,141,203,161
../../CUB_200_2011/images\139.Scarlet_Tanager/Scarlet_Tanager_0099_137783.jpg,500,375,139.Scarlet_Tanager,112,109,403,289,257,199,291,180
../../CUB_200_2011/images\139.Scarlet_Tanager/Scarlet_Tanager_0014_138298.jpg,400,500,139.Scarlet_Tanager,114,166,314,425,214,295,200,259
../../CUB_200_2011/images\139.Scarlet_Tanager/Scarlet_Tanager_0120_138344.jpg,500,335,139.Scarlet_Tanager,172,48,469,283,320,165,297,235
../../CUB_200_2011/images\139.Scarlet_Tanager/Scarlet_Tanager_0060_138384.jpg,500,337,139.Scarlet_Tanager,90,154,246,275,168,214,156,121
../../CUB_200_2011/images\139.Scarlet_Tanager/Scarlet_Tanager_0050_137874.jpg,500,352,139.Scarlet_Tanager,132,71,288,299,210,185,156,228
../../CUB_200_2011/images\139.Scarlet_Tanager/Scarlet_Tanager_0040_137885.jpg,474,500,139.Scarlet_Tanager,211,196,329,369,270,282,118,173
../../CUB_200_2011/images\139.Scarlet_Tanager/Scarlet_Tanager_0012_138410.jpg,500,247,139.Scarlet_Tanager,189,12,329,241,259,126,140,229
../../CUB_200_2011/images\139.Scarlet_Tanager/Scarlet_Tanager_0053_138940.jpg,500,333,139.Scarlet_Tanager,123,57,354,281,238,169,231,224
../../CUB_200_2011/images\139.Scarlet_Tanager/Scarlet_Tanager_0087_137937.jpg,500,363,139.Scarlet_Tanager,184,75,330,285,257,180,146,210
../../CUB_200_2011/images\139.Scarlet_Tanager/Scarlet_Tanager_0017_138484.jpg,375,500,139.Scarlet_Tanager,162,246,266,406,214,326,104,160
../../CUB_200_2011/images\139.Scarlet_Tanager/Scarlet_Tanager_0082_137978.jpg,400,500,139.Scarlet_Tanager,61,124,316,455,188,289,255,331
../../CUB_200_2011/images\139.Scarlet_Tanager/Scarlet_Tanager_0083_138500.jpg,500,416,139.Scarlet_Tanager,15,70,395,384,205,227,380,314
../../CUB_200_2011/images\139.Scarlet_Tanager/Scarlet_Tanager_0021_138199.jpg,500,333,139.Scarlet_Tanager,55,77,282,288,168,182,227,211
../../CUB_200_2011/images\139.Scarlet_Tanager/Scarlet_Tanager_0132_138001.jpg,500,477,139.Scarlet_Tanager,121,122,408,412,264,267,287,290
../../CUB_200_2011/images\139.Scarlet_Tanager/Scarlet_Tanager_0100_138006.jpg,475,500,139.Scarlet_Tanager,106,212,256,380,181,296,150,168
../../CUB_200_2011/images\139.Scarlet_Tanager/Scarlet_Tanager_0016_138008.jpg,500,399,139.Scarlet_Tanager,58,96,306,304,182,200,248,208
../../CUB_200_2011/images\139.Scarlet_Tanager/Scarlet_Tanager_0039_138010.jpg,368,500,139.Scarlet_Tanager,57,77,310,429,183,253,253,352
../../CUB_200_2011/images\139.Scarlet_Tanager/Scarlet_Tanager_0096_138022.jpg,333,500,139.Scarlet_Tanager,62,87,250,451,156,269,188,364
../../CUB_200_2011/images\139.Scarlet_Tanager/Scarlet_Tanager_0022_138049.jpg,500,375,139.Scarlet_Tanager,155,114,412,337,283,225,257,223
../../CUB_200_2011/images\139.Scarlet_Tanager/Scarlet_Tanager_0054_138210.jpg,500,459,139.Scarlet_Tanager,35,164,432,337,233,250,397,173
../../CUB_200_2011/images\139.Scarlet_Tanager/Scarlet_Tanager_0107_138577.jpg,500,333,139.Scarlet_Tanager,139,101,299,258,219,179,160,157
../../CUB_200_2011/images\139.Scarlet_Tanager/Scarlet_Tanager_0009_138076.jpg,500,334,139.Scarlet_Tanager,137,76,339,239,238,157,202,163
../../CUB_200_2011/images\139.Scarlet_Tanager/Scarlet_Tanager_0073_138108.jpg,500,364,139.Scarlet_Tanager,29,63,463,259,246,161,434,196
../../CUB_200_2011/images\139.Scarlet_Tanager/Scarlet_Tanager_0075_137602.jpg,416,500,139.Scarlet_Tanager,137,101,313,430,225,265,176,329
../../CUB_200_2011/images\139.Scarlet_Tanager/Scarlet_Tanager_0033_137603.jpg,497,500,139.Scarlet_Tanager,87,103,322,461,204,282,235,358
../../CUB_200_2011/images\139.Scarlet_Tanager/Scarlet_Tanager_0008_137607.jpg,282,500,139.Scarlet_Tanager,51,172,241,481,146,326,190,309
../../CUB_200_2011/images\139.Scarlet_Tanager/Scarlet_Tanager_0095_137618.jpg,500,358,139.Scarlet_Tanager,205,119,418,250,311,184,213,131
../../CUB_200_2011/images\139.Scarlet_Tanager/Scarlet_Tanager_0077_137626.jpg,500,421,139.Scarlet_Tanager,171,137,322,248,246,192,151,111
../../CUB_200_2011/images\139.Scarlet_Tanager/Scarlet_Tanager_0130_138661.jpg,500,333,139.Scarlet_Tanager,43,75,273,278,158,176,230,203
../../CUB_200_2011/images\139.Scarlet_Tanager/Scarlet_Tanager_0079_138669.jpg,500,333,139.Scarlet_Tanager,6,55,404,286,205,170,398,231
../../CUB_200_2011/images\139.Scarlet_Tanager/Scarlet_Tanager_0065_138683.jpg,500,487,139.Scarlet_Tanager,111,62,396,403,253,232,285,341
../../CUB_200_2011/images\139.Scarlet_Tanager/Scarlet_Tanager_0092_138688.jpg,500,375,139.Scarlet_Tanager,110,87,435,295,272,191,325,208
../../CUB_200_2011/images\139.Scarlet_Tanager/Scarlet_Tanager_0112_138695.jpg,374,377,139.Scarlet_Tanager,97,48,350,330,223,189,253,282
../../CUB_200_2011/images\139.Scarlet_Tanager/Scarlet_Tanager_0055_138186.jpg,500,366,139.Scarlet_Tanager,50,69,466,317,258,193,416,248
../../CUB_200_2011/images\139.Scarlet_Tanager/Scarlet_Tanager_0038_138198.jpg,500,357,139.Scarlet_Tanager,24,83,360,273,192,178,336,190
../../CUB_200_2011/images\139.Scarlet_Tanager/Scarlet_Tanager_0128_138711.jpg,500,368,139.Scarlet_Tanager,181,41,437,355,309,198,256,314
../../CUB_200_2011/images\139.Scarlet_Tanager/Scarlet_Tanager_0025_138712.jpg,500,399,139.Scarlet_Tanager,150,96,311,289,230,192,161,193
../../CUB_200_2011/images\139.Scarlet_Tanager/Scarlet_Tanager_0109_137698.jpg,500,422,139.Scarlet_Tanager,138,185,238,371,188,278,100,186
../../CUB_200_2011/images\139.Scarlet_Tanager/Scarlet_Tanager_0135_137699.jpg,500,400,139.Scarlet_Tanager,63,150,330,300,196,225,267,150
../../CUB_200_2011/images\139.Scarlet_Tanager/Scarlet_Tanager_0076_137702.jpg,500,451,139.Scarlet_Tanager,78,117,397,369,237,243,319,252
../../CUB_200_2011/images\139.Scarlet_Tanager/Scarlet_Tanager_0090_137703.jpg,500,417,139.Scarlet_Tanager,117,20,486,387,301,203,369,367
../../CUB_200_2011/images\139.Scarlet_Tanager/Scarlet_Tanager_0043_138236.jpg,500,400,139.Scarlet_Tanager,99,82,417,315,258,198,318,233
../../CUB_200_2011/images\139.Scarlet_Tanager/Scarlet_Tanager_0058_137710.jpg,500,391,139.Scarlet_Tanager,179,73,386,305,282,189,207,232
../../CUB_200_2011/images\139.Scarlet_Tanager/Scarlet_Tanager_0024_137712.jpg,500,309,139.Scarlet_Tanager,75,69,407,282,241,175,332,213
../../CUB_200_2011/images\139.Scarlet_Tanager/Scarlet_Tanager_0063_138227.jpg,500,489,139.Scarlet_Tanager,131,90,441,347,286,218,310,257
../../CUB_200_2011/images\139.Scarlet_Tanager/Scarlet_Tanager_0131_138740.jpg,500,381,139.Scarlet_Tanager,106,121,348,229,227,175,242,108
../../CUB_200_2011/images\139.Scarlet_Tanager/Scarlet_Tanager_0097_137717.jpg,400,267,139.Scarlet_Tanager,130,43,358,220,244,131,228,177
../../CUB_200_2011/images\139.Scarlet_Tanager/Scarlet_Tanager_0003_137724.jpg,500,333,139.Scarlet_Tanager,222,58,477,180,349,119,255,122
../../CUB_200_2011/images\140.Summer_Tanager/Summer_Tanager_0103_139267.jpg,333,500,140.Summer_Tanager,71,103,305,365,188,234,234,262
../../CUB_200_2011/images\140.Summer_Tanager/Summer_Tanager_0034_139781.jpg,500,367,140.Summer_Tanager,176,56,281,345,228,200,105,289
../../CUB_200_2011/images\140.Summer_Tanager/Summer_Tanager_0071_140289.jpg,398,500,140.Summer_Tanager,121,131,288,287,204,209,167,156
../../CUB_200_2011/images\140.Summer_Tanager/Summer_Tanager_0097_140042.jpg,333,500,140.Summer_Tanager,109,196,217,305,163,250,108,109
../../CUB_200_2011/images\140.Summer_Tanager/Summer_Tanager_0109_139522.jpg,500,415,140.Summer_Tanager,221,131,416,296,318,213,195,165
../../CUB_200_2011/images\140.Summer_Tanager/Summer_Tanager_0106_139801.jpg,500,383,140.Summer_Tanager,177,48,307,381,242,214,130,333
../../CUB_200_2011/images\140.Summer_Tanager/Summer_Tanager_0018_139290.jpg,500,500,140.Summer_Tanager,220,103,392,365,306,234,172,262
../../CUB_200_2011/images\140.Summer_Tanager/Summer_Tanager_0052_139804.jpg,500,345,140.Summer_Tanager,117,136,313,265,215,200,196,129
../../CUB_200_2011/images\140.Summer_Tanager/Summer_Tanager_0127_139297.jpg,500,388,140.Summer_Tanager,124,113,334,325,229,219,210,212
../../CUB_200_2011/images\140.Summer_Tanager/Summer_Tanager_0059_140582.jpg,479,500,140.Summer_Tanager,185,71,385,464,285,267,200,393
../../CUB_200_2011/images\140.Summer_Tanager/Summer_Tanager_0101_139441.jpg,500,459,140.Summer_Tanager,114,145,367,428,240,286,253,283
../../CUB_200_2011/images\140.Summer_Tanager/Summer_Tanager_0035_139561.jpg,500,394,140.Summer_Tanager,42,142,287,330,164,236,245,188
../../CUB_200_2011/images\140.Summer_Tanager/Summer_Tanager_0037_140330.jpg,500,375,140.Summer_Tanager,22,92,379,276,200,184,357,184
../../CUB_200_2011/images\140.Summer_Tanager/Summer_Tanager_0099_139310.jpg,500,334,140.Summer_Tanager,246,77,433,233,339,155,187,156
../../CUB_200_2011/images\140.Summer_Tanager/Summer_Tanager_0025_139320.jpg,500,355,140.Summer_Tanager,173,108,309,263,241,185,136,155
../../CUB_200_2011/images\140.Summer_Tanager/Summer_Tanager_0063_139743.jpg,500,350,140.Summer_Tanager,166,109,365,326,265,217,199,217
../../CUB_200_2011/images\140.Summer_Tanager/Summer_Tanager_0117_140812.jpg,375,500,140.Summer_Tanager,28,101,358,405,193,253,330,304
../../CUB_200_2011/images\140.Summer_Tanager/Summer_Tanager_0066_140621.jpg,500,375,140.Summer_Tanager,180,109,499,369,339,239,319,260
../../CUB_200_2011/images\140.Summer_Tanager/Summer_Tanager_0080_140110.jpg,483,500,140.Summer_Tanager,121,56,335,466,228,261,214,410
../../CUB_200_2011/images\140.Summer_Tanager/Summer_Tanager_0075_139858.jpg,334,500,140.Summer_Tanager,123,171,316,419,219,295,193,248
../../CUB_200_2011/images\140.Summer_Tanager/Summer_Tanager_0023_139859.jpg,500,400,140.Summer_Tanager,94,113,461,316,277,214,367,203
../../CUB_200_2011/images\140.Summer_Tanager/Summer_Tanager_0111_139605.jpg,500,354,140.Summer_Tanager,126,146,303,260,214,203,177,114
../../CUB_200_2011/images\140.Summer_Tanager/Summer_Tanager_0094_139351.jpg,375,500,140.Summer_Tanager,30,78,303,347,166,212,273,269
../../CUB_200_2011/images\140.Summer_Tanager/Summer_Tanager_0062_140633.jpg,500,375,140.Summer_Tanager,167,58,360,357,263,207,193,299
../../CUB_200_2011/images\140.Summer_Tanager/Summer_Tanager_0050_139358.jpg,333,500,140.Summer_Tanager,87,149,220,385,153,267,133,236
../../CUB_200_2011/images\140.Summer_Tanager/Summer_Tanager_0068_139875.jpg,500,333,140.Summer_Tanager,163,100,397,304,280,202,234,204
../../CUB_200_2011/images\140.Summer_Tanager/Summer_Tanager_0120_140060.jpg,500,432,140.Summer_Tanager,47,88,318,425,182,256,271,337
../../CUB_200_2011/images\140.Summer_Tanager/Summer_Tanager_0006_140137.jpg,500,500,140.Summer_Tanager,70,96,374,311,222,203,304,215
../../CUB_200_2011/images\140.Summer_Tanager/Summer_Tanager_0095_139882.jpg,500,333,140.Summer_Tanager,107,39,233,268,170,153,126,229
../../CUB_200_2011/images\140.Summer_Tanager/Summer_Tanager_0038_139371.jpg,500,333,140.Summer_Tanager,113,66,356,272,234,169,243,206
../../CUB_200_2011/images\140.Summer_Tanager/Summer_Tanager_0043_139884.jpg,468,500,140.Summer_Tanager,169,103,353,429,261,266,184,326
../../CUB_200_2011/images\140.Summer_Tanager/Summer_Tanager_0073_139379.jpg,386,500,140.Summer_Tanager,63,122,292,408,177,265,229,286
../../CUB_200_2011/images\140.Summer_Tanager/Summer_Tanager_0065_139198.jpg,500,337,140.Summer_Tanager,160,58,441,336,300,197,281,278
../../CUB_200_2011/images\140.Summer_Tanager/Summer_Tanager_0041_139902.jpg,500,411,140.Summer_Tanager,176,124,312,296,244,210,136,172
../../CUB_200_2011/images\140.Summer_Tanager/Summer_Tanager_0074_139592.jpg,500,432,140.Summer_Tanager,170,65,334,405,252,235,164,340
../../CUB_200_2011/images\140.Summer_Tanager/Summer_Tanager_0125_139399.jpg,500,376,140.Summer_Tanager,65,85,484,353,274,219,419,268
../../CUB_200_2011/images\140.Summer_Tanager/Summer_Tanager_0032_140425.jpg,496,340,140.Summer_Tanager,70,61,226,304,148,182,156,243
../../CUB_200_2011/images\140.Summer_Tanager/Summer_Tanager_0004_139916.jpg,500,339,140.Summer_Tanager,61,91,421,259,241,175,360,168
../../CUB_200_2011/images\140.Summer_Tanager/Summer_Tanager_0017_140173.jpg,500,391,140.Summer_Tanager,178,79,308,324,243,201,130,245
../../CUB_200_2011/images\140.Summer_Tanager/Summer_Tanager_0116_139923.jpg,488,500,140.Summer_Tanager,94,151,413,302,253,226,319,151
../../CUB_200_2011/images\140.Summer_Tanager/Summer_Tanager_0001_139289.jpg,500,375,140.Summer_Tanager,193,109,471,309,332,209,278,200
../../CUB_200_2011/images\140.Summer_Tanager/Summer_Tanager_0047_140164.jpg,500,333,140.Summer_Tanager,124,118,353,250,238,184,229,132
../../CUB_200_2011/images\140.Summer_Tanager/Summer_Tanager_0046_139802.jpg,500,405,140.Summer_Tanager,165,90,415,280,290,185,250,190
../../CUB_200_2011/images\140.Summer_Tanager/Summer_Tanager_0058_139427.jpg,466,500,140.Summer_Tanager,172,103,331,420,251,261,159,317
../../CUB_200_2011/images\140.Summer_Tanager/Summer_Tanager_0069_139941.jpg,391,500,140.Summer_Tanager,106,177,245,409,175,293,139,232
../../CUB_200_2011/images\140.Summer_Tanager/Summer_Tanager_0013_140828.jpg,500,485,140.Summer_Tanager,159,78,316,434,237,256,157,356
../../CUB_200_2011/images\140.Summer_Tanager/Summer_Tanager_0010_139948.jpg,500,333,140.Summer_Tanager,180,54,311,267,245,160,131,213
../../CUB_200_2011/images\140.Summer_Tanager/Summer_Tanager_0064_140725.jpg,500,385,140.Summer_Tanager,96,113,293,307,194,210,197,194
../../CUB_200_2011/images\140.Summer_Tanager/Summer_Tanager_0119_140617.jpg,362,500,140.Summer_Tanager,90,158,261,454,175,306,171,296
../../CUB_200_2011/images\140.Summer_Tanager/Summer_Tanager_0124_139963.jpg,500,333,140.Summer_Tanager,123,121,354,225,238,173,231,104
../../CUB_200_2011/images\140.Summer_Tanager/Summer_Tanager_0044_140611.jpg,500,459,140.Summer_Tanager,186,156,378,401,282,278,192,245
../../CUB_200_2011/images\140.Summer_Tanager/Summer_Tanager_0030_139210.jpg,500,333,140.Summer_Tanager,142,106,332,310,237,208,190,204
../../CUB_200_2011/images\140.Summer_Tanager/Summer_Tanager_0056_139211.jpg,327,500,140.Summer_Tanager,59,116,202,376,130,246,143,260
../../CUB_200_2011/images\140.Summer_Tanager/Summer_Tanager_0088_139473.jpg,500,369,140.Summer_Tanager,105,68,407,273,256,170,302,205
../../CUB_200_2011/images\140.Summer_Tanager/Summer_Tanager_0107_139488.jpg,500,348,140.Summer_Tanager,178,110,368,318,273,214,190,208
../../CUB_200_2011/images\140.Summer_Tanager/Summer_Tanager_0033_140268.jpg,357,500,140.Summer_Tanager,102,51,315,457,208,254,213,406
../../CUB_200_2011/images\140.Summer_Tanager/Summer_Tanager_0091_139602.jpg,500,379,140.Summer_Tanager,63,74,405,307,234,190,342,233
../../CUB_200_2011/images\140.Summer_Tanager/Summer_Tanager_0070_137714.jpg,500,375,140.Summer_Tanager,77,10,488,372,282,191,411,362
../../CUB_200_2011/images\140.Summer_Tanager/Summer_Tanager_0115_139253.jpg,500,405,140.Summer_Tanager,181,81,354,315,267,198,173,234
../../CUB_200_2011/images\140.Summer_Tanager/Summer_Tanager_0093_139517.jpg,500,340,140.Summer_Tanager,28,142,287,319,157,230,259,177
../../CUB_200_2011/images\141.Artic_Tern/Artic_Tern_0032_141313.jpg,500,333,141.Artic_Tern,116,105,460,238,288,171,344,133
../../CUB_200_2011/images\141.Artic_Tern/Artic_Tern_0015_141829.jpg,500,333,141.Artic_Tern,67,92,497,228,282,160,430,136
../../CUB_200_2011/images\141.Artic_Tern/Artic_Tern_0035_143366.jpg,500,334,141.Artic_Tern,144,132,481,272,312,202,337,140
../../CUB_200_2011/images\141.Artic_Tern/Artic_Tern_0085_142083.jpg,500,333,141.Artic_Tern,20,84,432,273,226,178,412,189
../../CUB_200_2011/images\141.Artic_Tern/Artic_Tern_0092_141849.jpg,405,500,141.Artic_Tern,78,54,358,458,218,256,280,404
../../CUB_200_2011/images\141.Artic_Tern/Artic_Tern_0056_141858.jpg,500,333,141.Artic_Tern,16,22,483,277,249,149,467,255
../../CUB_200_2011/images\141.Artic_Tern/Artic_Tern_0048_142372.jpg,500,332,141.Artic_Tern,80,58,364,246,222,152,284,188
../../CUB_200_2011/images\141.Artic_Tern/Artic_Tern_0012_143410.jpg,180,218,141.Artic_Tern,38,38,179,177,108,107,141,139
../../CUB_200_2011/images\141.Artic_Tern/Artic_Tern_0059_141876.jpg,388,500,141.Artic_Tern,8,12,318,496,163,254,310,484
../../CUB_200_2011/images\141.Artic_Tern/Artic_Tern_0093_141880.jpg,500,375,141.Artic_Tern,56,15,498,324,277,169,442,309
../../CUB_200_2011/images\141.Artic_Tern/Artic_Tern_0112_141893.jpg,470,500,141.Artic_Tern,45,32,383,411,214,221,338,379
../../CUB_200_2011/images\141.Artic_Tern/Artic_Tern_0039_141390.jpg,500,333,141.Artic_Tern,105,41,499,252,302,146,394,211
../../CUB_200_2011/images\141.Artic_Tern/Artic_Tern_0129_141395.jpg,500,362,141.Artic_Tern,63,49,498,318,280,183,435,269
../../CUB_200_2011/images\141.Artic_Tern/Artic_Tern_0050_140887.jpg,500,403,141.Artic_Tern,64,53,408,307,236,180,344,254
../../CUB_200_2011/images\141.Artic_Tern/Artic_Tern_0080_140889.jpg,500,333,141.Artic_Tern,136,16,288,293,212,154,152,277
../../CUB_200_2011/images\141.Artic_Tern/Artic_Tern_0026_141839.jpg,461,307,141.Artic_Tern,93,48,460,285,276,166,367,237
../../CUB_200_2011/images\141.Artic_Tern/Artic_Tern_0019_141922.jpg,364,500,141.Artic_Tern,28,33,318,469,173,251,290,436
../../CUB_200_2011/images\141.Artic_Tern/Artic_Tern_0127_142440.jpg,500,357,141.Artic_Tern,220,35,464,185,342,110,244,150
../../CUB_200_2011/images\141.Artic_Tern/Artic_Tern_0036_142447.jpg,500,334,141.Artic_Tern,0,83,366,283,183,183,366,200
../../CUB_200_2011/images\141.Artic_Tern/Artic_Tern_0021_143477.jpg,500,331,141.Artic_Tern,193,7,379,235,286,121,186,228
../../CUB_200_2011/images\141.Artic_Tern/Artic_Tern_0102_141453.jpg,500,333,141.Artic_Tern,129,48,317,284,223,166,188,236
../../CUB_200_2011/images\141.Artic_Tern/Artic_Tern_0065_141472.jpg,500,500,141.Artic_Tern,33,8,333,432,183,220,300,424
../../CUB_200_2011/images\141.Artic_Tern/Artic_Tern_0060_141955.jpg,500,500,141.Artic_Tern,24,20,486,394,255,207,462,374
../../CUB_200_2011/images\141.Artic_Tern/Artic_Tern_0023_140898.jpg,500,380,141.Artic_Tern,83,121,439,290,261,205,356,169
../../CUB_200_2011/images\141.Artic_Tern/Artic_Tern_0046_140986.jpg,500,375,141.Artic_Tern,98,154,333,263,215,208,235,109
../../CUB_200_2011/images\141.Artic_Tern/Artic_Tern_0047_143549.jpg,500,333,141.Artic_Tern,27,80,385,223,206,151,358,143
../../CUB_200_2011/images\141.Artic_Tern/Artic_Tern_0138_142527.jpg,411,500,141.Artic_Tern,64,44,307,461,185,252,243,417
../../CUB_200_2011/images\141.Artic_Tern/Artic_Tern_0034_142022.jpg,500,333,141.Artic_Tern,49,35,383,326,216,180,334,291
../../CUB_200_2011/images\141.Artic_Tern/Artic_Tern_0117_143394.jpg,500,357,141.Artic_Tern,15,119,441,267,228,193,426,148
../../CUB_200_2011/images\141.Artic_Tern/Artic_Tern_0055_141524.jpg,500,334,141.Artic_Tern,35,47,444,209,239,128,409,162
../../CUB_200_2011/images\141.Artic_Tern/Artic_Tern_0090_143583.jpg,500,332,141.Artic_Tern,49,68,496,322,272,195,447,254
../../CUB_200_2011/images\141.Artic_Tern/Artic_Tern_0115_142570.jpg,500,375,141.Artic_Tern,174,116,350,304,262,210,176,188
../../CUB_200_2011/images\141.Artic_Tern/Artic_Tern_0073_143486.jpg,500,375,141.Artic_Tern,65,61,491,324,278,192,426,263
../../CUB_200_2011/images\141.Artic_Tern/Artic_Tern_0105_141098.jpg,500,313,141.Artic_Tern,7,100,449,302,228,201,442,202
../../CUB_200_2011/images\141.Artic_Tern/Artic_Tern_0142_142078.jpg,500,333,141.Artic_Tern,120,73,438,278,279,175,318,205
../../CUB_200_2011/images\141.Artic_Tern/Artic_Tern_0041_142079.jpg,500,352,141.Artic_Tern,21,150,251,283,136,216,230,133
../../CUB_200_2011/images\141.Artic_Tern/Artic_Tern_0083_141579.jpg,500,332,141.Artic_Tern,7,67,410,268,208,167,403,201
../../CUB_200_2011/images\141.Artic_Tern/Artic_Tern_0133_141069.jpg,500,351,141.Artic_Tern,151,65,426,279,288,172,275,214
../../CUB_200_2011/images\141.Artic_Tern/Artic_Tern_0101_141075.jpg,500,333,141.Artic_Tern,63,81,492,243,277,162,429,162
../../CUB_200_2011/images\141.Artic_Tern/Artic_Tern_0111_143101.jpg,500,333,141.Artic_Tern,250,105,359,242,304,173,109,137
../../CUB_200_2011/images\141.Artic_Tern/Artic_Tern_0027_141617.jpg,500,335,141.Artic_Tern,97,69,324,247,210,158,227,178
../../CUB_200_2011/images\141.Artic_Tern/Artic_Tern_0124_142121.jpg,500,334,141.Artic_Tern,139,82,354,256,246,169,215,174
../../CUB_200_2011/images\141.Artic_Tern/Artic_Tern_0082_142127.jpg,500,335,141.Artic_Tern,38,0,333,334,185,167,295,334
../../CUB_200_2011/images\141.Artic_Tern/Artic_Tern_0122_142448.jpg,500,333,141.Artic_Tern,17,65,425,298,221,181,408,233
../../CUB_200_2011/images\141.Artic_Tern/Artic_Tern_0044_142151.jpg,500,334,141.Artic_Tern,5,77,420,311,212,194,415,234
../../CUB_200_2011/images\141.Artic_Tern/Artic_Tern_0089_141652.jpg,500,445,141.Artic_Tern,145,17,378,367,261,192,233,350
../../CUB_200_2011/images\141.Artic_Tern/Artic_Tern_0037_141141.jpg,490,500,141.Artic_Tern,51,96,440,376,245,236,389,280
../../CUB_200_2011/images\141.Artic_Tern/Artic_Tern_0119_142682.jpg,500,375,141.Artic_Tern,1,110,431,331,216,220,430,221
../../CUB_200_2011/images\141.Artic_Tern/Artic_Tern_0099_141170.jpg,487,500,141.Artic_Tern,14,79,363,403,188,241,349,324
../../CUB_200_2011/images\141.Artic_Tern/Artic_Tern_0014_141716.jpg,500,347,141.Artic_Tern,98,111,424,252,261,181,326,141
../../CUB_200_2011/images\141.Artic_Tern/Artic_Tern_0107_141181.jpg,500,333,141.Artic_Tern,147,78,453,225,300,151,306,147
../../CUB_200_2011/images\141.Artic_Tern/Artic_Tern_0029_142220.jpg,500,369,141.Artic_Tern,13,92,488,302,250,197,475,210
../../CUB_200_2011/images\141.Artic_Tern/Artic_Tern_0024_143268.jpg,500,375,141.Artic_Tern,220,81,459,332,339,206,239,251
../../CUB_200_2011/images\141.Artic_Tern/Artic_Tern_0063_142495.jpg,500,354,141.Artic_Tern,33,47,408,232,220,139,375,185
../../CUB_200_2011/images\141.Artic_Tern/Artic_Tern_0052_143244.jpg,500,333,141.Artic_Tern,141,60,470,332,305,196,329,272
../../CUB_200_2011/images\141.Artic_Tern/Artic_Tern_0116_143613.jpg,500,401,141.Artic_Tern,89,81,333,290,211,185,244,209
../../CUB_200_2011/images\141.Artic_Tern/Artic_Tern_0030_141816.jpg,500,428,141.Artic_Tern,120,63,371,315,245,189,251,252
../../CUB_200_2011/images\141.Artic_Tern/Artic_Tern_0011_143355.jpg,500,281,141.Artic_Tern,29,66,478,231,253,148,449,165
../../CUB_200_2011/images\142.Black_Tern/Black_Tern_0017_143876.jpg,500,392,142.Black_Tern,178,44,423,352,300,198,245,308
../../CUB_200_2011/images\142.Black_Tern/Black_Tern_0006_144646.jpg,500,344,142.Black_Tern,193,83,401,276,297,179,208,193
../../CUB_200_2011/images\142.Black_Tern/Black_Tern_0090_143880.jpg,500,333,142.Black_Tern,35,100,485,315,260,207,450,215
../../CUB_200_2011/images\142.Black_Tern/Black_Tern_0004_143881.jpg,500,431,142.Black_Tern,72,64,373,340,222,202,301,276
../../CUB_200_2011/images\142.Black_Tern/Black_Tern_0053_143882.jpg,500,375,142.Black_Tern,48,87,472,289,260,188,424,202
../../CUB_200_2011/images\142.Black_Tern/Black_Tern_0057_143884.jpg,500,382,142.Black_Tern,117,73,323,281,220,177,206,208
../../CUB_200_2011/images\142.Black_Tern/Black_Tern_0080_144130.jpg,500,429,142.Black_Tern,231,9,397,332,314,170,166,323
../../CUB_200_2011/images\142.Black_Tern/Black_Tern_0013_143892.jpg,500,333,142.Black_Tern,66,100,307,220,186,160,241,120
../../CUB_200_2011/images\142.Black_Tern/Black_Tern_0059_144159.jpg,399,500,142.Black_Tern,33,137,232,481,132,309,199,344
../../CUB_200_2011/images\142.Black_Tern/Black_Tern_0056_143906.jpg,500,417,142.Black_Tern,57,42,489,391,273,216,432,349
../../CUB_200_2011/images\142.Black_Tern/Black_Tern_0020_144163.jpg,500,375,142.Black_Tern,148,68,455,299,301,183,307,231
../../CUB_200_2011/images\142.Black_Tern/Black_Tern_0019_144680.jpg,500,387,142.Black_Tern,4,11,251,261,127,136,247,250
../../CUB_200_2011/images\142.Black_Tern/Black_Tern_0096_143917.jpg,500,334,142.Black_Tern,197,87,423,226,310,156,226,139
../../CUB_200_2011/images\142.Black_Tern/Black_Tern_0089_144174.jpg,379,500,142.Black_Tern,140,91,279,408,209,249,139,317
../../CUB_200_2011/images\142.Black_Tern/Black_Tern_0014_143939.jpg,500,366,142.Black_Tern,159,112,297,258,228,185,138,146
../../CUB_200_2011/images\142.Black_Tern/Black_Tern_0029_144140.jpg,274,326,142.Black_Tern,20,7,240,316,130,161,220,309
../../CUB_200_2011/images\142.Black_Tern/Black_Tern_0094_144466.jpg,500,387,142.Black_Tern,77,144,397,314,237,229,320,170
../../CUB_200_2011/images\142.Black_Tern/Black_Tern_0103_143956.jpg,500,333,142.Black_Tern,112,44,308,263,210,153,196,219
../../CUB_200_2011/images\142.Black_Tern/Black_Tern_0061_143959.jpg,500,375,142.Black_Tern,20,69,468,364,244,216,448,295
../../CUB_200_2011/images\142.Black_Tern/Black_Tern_0063_144731.jpg,500,400,142.Black_Tern,46,137,409,332,227,234,363,195
../../CUB_200_2011/images\142.Black_Tern/Black_Tern_0008_143965.jpg,500,333,142.Black_Tern,148,43,287,303,217,173,139,260
../../CUB_200_2011/images\142.Black_Tern/Black_Tern_0046_144229.jpg,500,400,142.Black_Tern,51,51,365,361,208,206,314,310
../../CUB_200_2011/images\142.Black_Tern/Black_Tern_0015_143979.jpg,485,500,142.Black_Tern,146,107,451,439,298,273,305,332
../../CUB_200_2011/images\142.Black_Tern/Black_Tern_0058_143981.jpg,499,409,142.Black_Tern,72,67,367,222,219,144,295,155
../../CUB_200_2011/images\142.Black_Tern/Black_Tern_0023_143985.jpg,500,349,142.Black_Tern,95,15,451,285,273,150,356,270
../../CUB_200_2011/images\142.Black_Tern/Black_Tern_0099_144242.jpg,500,332,142.Black_Tern,116,61,399,260,257,160,283,199
../../CUB_200_2011/images\142.Black_Tern/Black_Tern_0064_143990.jpg,500,494,142.Black_Tern,174,164,401,380,287,272,227,216
../../CUB_200_2011/images\142.Black_Tern/Black_Tern_0025_144503.jpg,500,401,142.Black_Tern,13,93,346,362,179,227,333,269
../../CUB_200_2011/images\142.Black_Tern/Black_Tern_0079_143998.jpg,417,500,142.Black_Tern,193,24,320,175,256,99,127,151
../../CUB_200_2011/images\142.Black_Tern/Black_Tern_0107_144661.jpg,500,375,142.Black_Tern,160,72,420,252,290,162,260,180
../../CUB_200_2011/images\142.Black_Tern/Black_Tern_0050_144000.jpg,500,437,142.Black_Tern,163,87,347,274,255,180,184,187
../../CUB_200_2011/images\142.Black_Tern/Black_Tern_0048_144001.jpg,500,334,142.Black_Tern,63,104,380,259,221,181,317,155
../../CUB_200_2011/images\142.Black_Tern/Black_Tern_0044_144021.jpg,500,333,142.Black_Tern,205,86,454,217,329,151,249,131
../../CUB_200_2011/images\142.Black_Tern/Black_Tern_0032_144029.jpg,500,333,142.Black_Tern,259,67,448,275,353,171,189,208
../../CUB_200_2011/images\142.Black_Tern/Black_Tern_0070_144292.jpg,400,500,142.Black_Tern,65,26,359,394,212,210,294,368
../../CUB_200_2011/images\142.Black_Tern/Black_Tern_0104_144038.jpg,500,333,142.Black_Tern,74,59,427,225,250,142,353,166
../../CUB_200_2011/images\142.Black_Tern/Black_Tern_0024_144039.jpg,500,471,142.Black_Tern,97,224,342,338,219,281,245,114
../../CUB_200_2011/images\142.Black_Tern/Black_Tern_0009_144046.jpg,341,500,142.Black_Tern,9,166,238,414,123,290,229,248
../../CUB_200_2011/images\142.Black_Tern/Black_Tern_0066_144541.jpg,500,375,142.Black_Tern,62,109,402,283,232,196,340,174
../../CUB_200_2011/images\142.Black_Tern/Black_Tern_0069_144359.jpg,411,500,142.Black_Tern,41,160,279,295,160,227,238,135
../../CUB_200_2011/images\142.Black_Tern/Black_Tern_0082_144372.jpg,500,336,142.Black_Tern,150,51,473,232,311,141,323,181
../../CUB_200_2011/images\142.Black_Tern/Black_Tern_0091_144063.jpg,375,500,142.Black_Tern,75,115,322,295,198,205,247,180
../../CUB_200_2011/images\142.Black_Tern/Black_Tern_0033_144328.jpg,500,334,142.Black_Tern,84,35,292,280,188,157,208,245
../../CUB_200_2011/images\142.Black_Tern/Black_Tern_0065_144076.jpg,500,335,142.Black_Tern,57,83,337,214,197,148,280,131
../../CUB_200_2011/images\142.Black_Tern/Black_Tern_0101_144331.jpg,500,333,142.Black_Tern,46,91,477,266,261,178,431,175
../../CUB_200_2011/images\142.Black_Tern/Black_Tern_0083_144083.jpg,500,360,142.Black_Tern,155,34,382,230,268,132,227,196
../../CUB_200_2011/images\142.Black_Tern/Black_Tern_0073_144638.jpg,500,500,142.Black_Tern,118,41,321,303,219,172,203,262
../../CUB_200_2011/images\142.Black_Tern/Black_Tern_0100_144597.jpg,500,387,142.Black_Tern,161,121,436,341,298,231,275,220
../../CUB_200_2011/images\142.Black_Tern/Black_Tern_0102_144344.jpg,340,500,142.Black_Tern,102,151,301,374,201,262,199,223
../../CUB_200_2011/images\142.Black_Tern/Black_Tern_0098_144089.jpg,500,375,142.Black_Tern,97,90,334,271,215,180,237,181
../../CUB_200_2011/images\142.Black_Tern/Black_Tern_0012_144091.jpg,500,500,142.Black_Tern,85,98,402,418,243,258,317,320
../../CUB_200_2011/images\142.Black_Tern/Black_Tern_0055_144607.jpg,500,333,142.Black_Tern,86,18,283,236,184,127,197,218
../../CUB_200_2011/images\142.Black_Tern/Black_Tern_0038_144102.jpg,400,500,142.Black_Tern,94,69,286,406,190,237,192,337
../../CUB_200_2011/images\142.Black_Tern/Black_Tern_0041_144103.jpg,500,339,142.Black_Tern,223,42,434,219,328,130,211,177
../../CUB_200_2011/images\142.Black_Tern/Black_Tern_0034_144106.jpg,500,285,142.Black_Tern,33,50,492,262,262,156,459,212
../../CUB_200_2011/images\142.Black_Tern/Black_Tern_0037_144110.jpg,500,332,142.Black_Tern,261,26,398,252,329,139,137,226
../../CUB_200_2011/images\142.Black_Tern/Black_Tern_0077_144117.jpg,500,357,142.Black_Tern,170,29,352,298,261,163,182,269
../../CUB_200_2011/images\142.Black_Tern/Black_Tern_0097_144724.jpg,322,403,142.Black_Tern,27,74,312,307,169,190,285,233
../../CUB_200_2011/images\142.Black_Tern/Black_Tern_0105_144380.jpg,420,280,142.Black_Tern,79,58,398,237,238,147,319,179
../../CUB_200_2011/images\142.Black_Tern/Black_Tern_0010_144341.jpg,500,401,142.Black_Tern,61,63,365,246,213,154,304,183
../../CUB_200_2011/images\143.Caspian_Tern/Caspian_Tern_0015_145664.jpg,500,384,143.Caspian_Tern,168,72,396,300,282,186,228,228
../../CUB_200_2011/images\143.Caspian_Tern/Caspian_Tern_0024_146033.jpg,500,397,143.Caspian_Tern,71,31,448,329,259,180,377,298
../../CUB_200_2011/images\143.Caspian_Tern/Caspian_Tern_0097_145923.jpg,409,500,143.Caspian_Tern,18,2,395,421,206,211,377,419
../../CUB_200_2011/images\143.Caspian_Tern/Caspian_Tern_0115_145927.jpg,333,500,143.Caspian_Tern,93,173,238,363,165,268,145,190
../../CUB_200_2011/images\143.Caspian_Tern/Caspian_Tern_0102_145928.jpg,500,387,143.Caspian_Tern,45,58,356,279,200,168,311,221
../../CUB_200_2011/images\143.Caspian_Tern/Caspian_Tern_0005_145929.jpg,500,250,143.Caspian_Tern,7,60,489,204,248,132,482,144
../../CUB_200_2011/images\143.Caspian_Tern/Caspian_Tern_0051_145930.jpg,500,333,143.Caspian_Tern,227,70,392,307,309,188,165,237
../../CUB_200_2011/images\143.Caspian_Tern/Caspian_Tern_0069_145931.jpg,500,457,143.Caspian_Tern,97,74,448,251,272,162,351,177
../../CUB_200_2011/images\143.Caspian_Tern/Caspian_Tern_0079_145777.jpg,500,379,143.Caspian_Tern,110,29,336,321,223,175,226,292
../../CUB_200_2011/images\143.Caspian_Tern/Caspian_Tern_0099_145939.jpg,353,500,143.Caspian_Tern,25,47,317,426,171,236,292,379
../../CUB_200_2011/images\143.Caspian_Tern/Caspian_Tern_0117_146009.jpg,500,334,143.Caspian_Tern,131,114,338,214,234,164,207,100
../../CUB_200_2011/images\143.Caspian_Tern/Caspian_Tern_0109_145948.jpg,500,365,143.Caspian_Tern,117,110,439,222,278,166,322,112
../../CUB_200_2011/images\143.Caspian_Tern/Caspian_Tern_0010_145667.jpg,500,333,143.Caspian_Tern,75,72,304,297,189,184,229,225
../../CUB_200_2011/images\143.Caspian_Tern/Caspian_Tern_0074_145964.jpg,500,390,143.Caspian_Tern,34,88,410,339,222,213,376,251
../../CUB_200_2011/images\143.Caspian_Tern/Caspian_Tern_0105_145673.jpg,500,357,143.Caspian_Tern,35,99,341,334,188,216,306,235
../../CUB_200_2011/images\143.Caspian_Tern/Caspian_Tern_0062_145981.jpg,500,387,143.Caspian_Tern,2,30,468,382,235,206,466,352
../../CUB_200_2011/images\143.Caspian_Tern/Caspian_Tern_0041_144964.jpg,500,332,143.Caspian_Tern,185,57,386,276,285,166,201,219
../../CUB_200_2011/images\143.Caspian_Tern/Caspian_Tern_0101_145164.jpg,500,356,143.Caspian_Tern,37,97,410,315,223,206,373,218
../../CUB_200_2011/images\143.Caspian_Tern/Caspian_Tern_0111_145995.jpg,500,375,143.Caspian_Tern,45,3,491,330,268,166,446,327
../../CUB_200_2011/images\143.Caspian_Tern/Caspian_Tern_0066_147680.jpg,500,313,143.Caspian_Tern,81,34,396,212,238,123,315,178
../../CUB_200_2011/images\143.Caspian_Tern/Caspian_Tern_0119_145492.jpg,500,336,143.Caspian_Tern,51,27,474,266,262,146,423,239
../../CUB_200_2011/images\143.Caspian_Tern/Caspian_Tern_0060_146007.jpg,500,350,143.Caspian_Tern,73,29,300,289,186,159,227,260
../../CUB_200_2011/images\143.Caspian_Tern/Caspian_Tern_0070_147545.jpg,500,335,143.Caspian_Tern,33,55,469,279,251,167,436,224
../../CUB_200_2011/images\143.Caspian_Tern/Caspian_Tern_0018_146010.jpg,500,337,143.Caspian_Tern,66,14,404,322,235,168,338,308
../../CUB_200_2011/images\143.Caspian_Tern/Caspian_Tern_0049_145755.jpg,500,334,143.Caspian_Tern,178,74,448,265,313,169,270,191
../../CUB_200_2011/images\143.Caspian_Tern/Caspian_Tern_0055_146014.jpg,500,291,143.Caspian_Tern,38,33,435,135,236,84,397,102
../../CUB_200_2011/images\143.Caspian_Tern/Caspian_Tern_0123_145774.jpg,500,392,143.Caspian_Tern,121,34,308,302,214,168,187,268
../../CUB_200_2011/images\143.Caspian_Tern/Caspian_Tern_0096_145009.jpg,500,360,143.Caspian_Tern,194,97,323,263,258,180,129,166
../../CUB_200_2011/images\143.Caspian_Tern/Caspian_Tern_0108_145278.jpg,500,375,143.Caspian_Tern,31,72,447,291,239,181,416,219
../../CUB_200_2011/images\143.Caspian_Tern/Caspian_Tern_0029_147589.jpg,500,329,143.Caspian_Tern,63,27,367,286,215,156,304,259
../../CUB_200_2011/images\143.Caspian_Tern/Caspian_Tern_0011_146058.jpg,500,333,143.Caspian_Tern,189,9,424,327,306,168,235,318
../../CUB_200_2011/images\143.Caspian_Tern/Caspian_Tern_0113_146828.jpg,500,383,143.Caspian_Tern,96,51,372,249,234,150,276,198
../../CUB_200_2011/images\143.Caspian_Tern/Caspian_Tern_0013_145553.jpg,500,295,143.Caspian_Tern,37,85,449,253,243,169,412,168
../../CUB_200_2011/images\143.Caspian_Tern/Caspian_Tern_0045_145554.jpg,500,375,143.Caspian_Tern,149,92,428,215,288,153,279,123
../../CUB_200_2011/images\143.Caspian_Tern/Caspian_Tern_0078_146824.jpg,500,390,143.Caspian_Tern,161,70,345,290,253,180,184,220
../../CUB_200_2011/images\143.Caspian_Tern/Caspian_Tern_0009_145057.jpg,500,336,143.Caspian_Tern,148,15,466,313,307,164,318,298
../../CUB_200_2011/images\143.Caspian_Tern/Caspian_Tern_0063_146082.jpg,500,362,143.Caspian_Tern,84,78,380,233,232,155,296,155
../../CUB_200_2011/images\143.Caspian_Tern/Caspian_Tern_0059_145582.jpg,500,377,143.Caspian_Tern,139,140,299,293,219,216,160,153
../../CUB_200_2011/images\143.Caspian_Tern/Caspian_Tern_0012_147632.jpg,445,500,143.Caspian_Tern,64,43,289,352,176,197,225,309
../../CUB_200_2011/images\143.Caspian_Tern/Caspian_Tern_0068_146615.jpg,500,333,143.Caspian_Tern,130,22,427,280,278,151,297,258
../../CUB_200_2011/images\143.Caspian_Tern/Caspian_Tern_0006_145594.jpg,500,400,143.Caspian_Tern,241,148,363,248,302,198,122,100
../../CUB_200_2011/images\143.Caspian_Tern/Caspian_Tern_0034_147643.jpg,500,375,143.Caspian_Tern,79,40,487,295,283,167,408,255
../../CUB_200_2011/images\143.Caspian_Tern/Caspian_Tern_0106_147645.jpg,500,333,143.Caspian_Tern,140,22,319,241,229,131,179,219
../../CUB_200_2011/images\143.Caspian_Tern/Caspian_Tern_0048_145672.jpg,500,446,143.Caspian_Tern,53,75,484,411,268,243,431,336
../../CUB_200_2011/images\143.Caspian_Tern/Caspian_Tern_0016_145314.jpg,483,500,143.Caspian_Tern,107,142,436,499,271,320,329,357
../../CUB_200_2011/images\143.Caspian_Tern/Caspian_Tern_0022_144922.jpg,500,500,143.Caspian_Tern,65,47,351,322,208,184,286,275
../../CUB_200_2011/images\143.Caspian_Tern/Caspian_Tern_0116_145607.jpg,500,333,143.Caspian_Tern,100,45,409,332,254,188,309,287
../../CUB_200_2011/images\143.Caspian_Tern/Caspian_Tern_0075_147650.jpg,500,340,143.Caspian_Tern,81,98,284,225,182,161,203,127
../../CUB_200_2011/images\143.Caspian_Tern/Caspian_Tern_0114_145612.jpg,500,260,143.Caspian_Tern,79,74,331,191,205,132,252,117
../../CUB_200_2011/images\143.Caspian_Tern/Caspian_Tern_0067_145107.jpg,500,399,143.Caspian_Tern,188,177,341,398,264,287,153,221
../../CUB_200_2011/images\143.Caspian_Tern/Caspian_Tern_0046_145627.jpg,500,400,143.Caspian_Tern,121,93,340,277,230,185,219,184
../../CUB_200_2011/images\143.Caspian_Tern/Caspian_Tern_0058_145886.jpg,500,350,143.Caspian_Tern,79,89,408,227,243,158,329,138
../../CUB_200_2011/images\143.Caspian_Tern/Caspian_Tern_0054_145890.jpg,500,393,143.Caspian_Tern,65,37,371,304,218,170,306,267
../../CUB_200_2011/images\143.Caspian_Tern/Caspian_Tern_0026_145125.jpg,500,355,143.Caspian_Tern,74,14,455,335,264,174,381,321
../../CUB_200_2011/images\143.Caspian_Tern/Caspian_Tern_0107_145639.jpg,500,405,143.Caspian_Tern,16,100,424,319,220,209,408,219
../../CUB_200_2011/images\143.Caspian_Tern/Caspian_Tern_0014_145640.jpg,500,333,143.Caspian_Tern,96,8,375,263,235,135,279,255
../../CUB_200_2011/images\143.Caspian_Tern/Caspian_Tern_0027_145899.jpg,400,500,143.Caspian_Tern,30,3,376,451,203,227,346,448
../../CUB_200_2011/images\143.Caspian_Tern/Caspian_Tern_0120_145650.jpg,294,500,143.Caspian_Tern,85,30,234,459,159,244,149,429
../../CUB_200_2011/images\143.Caspian_Tern/Caspian_Tern_0072_147667.jpg,500,315,143.Caspian_Tern,131,48,309,275,220,161,178,227
../../CUB_200_2011/images\143.Caspian_Tern/Caspian_Tern_0023_147194.jpg,500,344,143.Caspian_Tern,26,31,453,274,239,152,427,243
../../CUB_200_2011/images\144.Common_Tern/Common_Tern_0040_147973.jpg,500,334,144.Common_Tern,40,81,385,228,212,154,345,147
../../CUB_200_2011/images\144.Common_Tern/Common_Tern_0019_149769.jpg,500,350,144.Common_Tern,104,98,368,276,236,187,264,178
../../CUB_200_2011/images\144.Common_Tern/Common_Tern_0084_147980.jpg,500,333,144.Common_Tern,109,110,405,250,257,180,296,140
../../CUB_200_2011/images\144.Common_Tern/Common_Tern_0025_147728.jpg,500,357,144.Common_Tern,240,84,445,312,342,198,205,228
../../CUB_200_2011/images\144.Common_Tern/Common_Tern_0125_148767.jpg,500,333,144.Common_Tern,101,99,380,267,240,183,279,168
../../CUB_200_2011/images\144.Common_Tern/Common_Tern_0067_149540.jpg,500,375,144.Common_Tern,97,39,295,279,196,159,198,240
../../CUB_200_2011/images\144.Common_Tern/Common_Tern_0100_149541.jpg,500,363,144.Common_Tern,137,3,438,233,287,118,301,230
../../CUB_200_2011/images\144.Common_Tern/Common_Tern_0043_147753.jpg,500,333,144.Common_Tern,176,119,429,280,302,199,253,161
../../CUB_200_2011/images\144.Common_Tern/Common_Tern_0075_148528.jpg,500,333,144.Common_Tern,131,82,499,290,315,186,368,208
../../CUB_200_2011/images\144.Common_Tern/Common_Tern_0098_148785.jpg,500,382,144.Common_Tern,79,82,269,206,174,144,190,124
../../CUB_200_2011/images\144.Common_Tern/Common_Tern_0045_150067.jpg,500,353,144.Common_Tern,93,11,311,313,202,162,218,302
../../CUB_200_2011/images\144.Common_Tern/Common_Tern_0054_148028.jpg,500,333,144.Common_Tern,41,34,236,202,138,118,195,168
../../CUB_200_2011/images\144.Common_Tern/Common_Tern_0029_148035.jpg,500,489,144.Common_Tern,115,84,335,359,225,221,220,275
../../CUB_200_2011/images\144.Common_Tern/Common_Tern_0056_148549.jpg,481,319,144.Common_Tern,31,19,448,287,239,153,417,268
../../CUB_200_2011/images\144.Common_Tern/Common_Tern_0063_147789.jpg,500,349,144.Common_Tern,91,49,407,254,249,151,316,205
../../CUB_200_2011/images\144.Common_Tern/Common_Tern_0030_147825.jpg,500,357,144.Common_Tern,109,92,342,233,225,162,233,141
../../CUB_200_2011/images\144.Common_Tern/Common_Tern_0037_148048.jpg,500,429,144.Common_Tern,178,78,290,215,234,146,112,137
../../CUB_200_2011/images\144.Common_Tern/Common_Tern_0105_149841.jpg,500,343,144.Common_Tern,136,113,373,217,254,165,237,104
../../CUB_200_2011/images\144.Common_Tern/Common_Tern_0094_148309.jpg,500,333,144.Common_Tern,142,2,499,324,320,163,357,322
../../CUB_200_2011/images\144.Common_Tern/Common_Tern_0088_147941.jpg,500,333,144.Common_Tern,1,25,475,293,238,159,474,268
../../CUB_200_2011/images\144.Common_Tern/Common_Tern_0027_150113.jpg,500,304,144.Common_Tern,95,56,485,251,290,153,390,195
../../CUB_200_2011/images\144.Common_Tern/Common_Tern_0028_150117.jpg,500,368,144.Common_Tern,262,42,459,233,360,137,197,191
../../CUB_200_2011/images\144.Common_Tern/Common_Tern_0009_149609.jpg,500,375,144.Common_Tern,0,125,312,345,156,235,312,220
../../CUB_200_2011/images\144.Common_Tern/Common_Tern_0079_148844.jpg,500,357,144.Common_Tern,21,87,445,258,233,172,424,171
../../CUB_200_2011/images\144.Common_Tern/Common_Tern_0087_147945.jpg,500,343,144.Common_Tern,94,14,429,258,261,136,335,244
../../CUB_200_2011/images\144.Common_Tern/Common_Tern_0070_150292.jpg,500,375,144.Common_Tern,199,28,421,291,310,159,222,263
../../CUB_200_2011/images\144.Common_Tern/Common_Tern_0083_148096.jpg,500,375,144.Common_Tern,65,42,498,301,281,171,433,259
../../CUB_200_2011/images\144.Common_Tern/Common_Tern_0062_147947.jpg,357,500,144.Common_Tern,93,41,229,352,161,196,136,311
../../CUB_200_2011/images\144.Common_Tern/Common_Tern_0097_148874.jpg,500,333,144.Common_Tern,195,139,417,264,306,201,222,125
../../CUB_200_2011/images\144.Common_Tern/Common_Tern_0092_147779.jpg,500,333,144.Common_Tern,243,27,431,265,337,146,188,238
../../CUB_200_2011/images\144.Common_Tern/Common_Tern_0055_149486.jpg,500,477,144.Common_Tern,166,92,391,298,278,195,225,206
../../CUB_200_2011/images\144.Common_Tern/Common_Tern_0064_148761.jpg,500,331,144.Common_Tern,71,72,479,274,275,173,408,202
../../CUB_200_2011/images\144.Common_Tern/Common_Tern_0071_148796.jpg,500,387,144.Common_Tern,103,57,427,181,265,119,324,124
../../CUB_200_2011/images\144.Common_Tern/Common_Tern_0049_149159.jpg,500,365,144.Common_Tern,73,49,296,255,184,152,223,206
../../CUB_200_2011/images\144.Common_Tern/Common_Tern_0108_149672.jpg,500,334,144.Common_Tern,42,57,216,317,129,187,174,260
../../CUB_200_2011/images\144.Common_Tern/Common_Tern_0078_149161.jpg,500,333,144.Common_Tern,55,21,358,266,206,143,303,245
../../CUB_200_2011/images\144.Common_Tern/Common_Tern_0106_149345.jpg,500,375,144.Common_Tern,22,24,482,324,252,174,460,300
../../CUB_200_2011/images\144.Common_Tern/Common_Tern_0095_149960.jpg,500,333,144.Common_Tern,133,121,315,253,224,187,182,132
../../CUB_200_2011/images\144.Common_Tern/Common_Tern_0042_147897.jpg,399,500,144.Common_Tern,106,92,371,353,238,222,265,261
../../CUB_200_2011/images\144.Common_Tern/Common_Tern_0120_148670.jpg,357,500,144.Common_Tern,41,54,184,289,112,171,143,235
../../CUB_200_2011/images\144.Common_Tern/Common_Tern_0050_148928.jpg,500,342,144.Common_Tern,90,11,297,284,193,147,207,273
../../CUB_200_2011/images\144.Common_Tern/Common_Tern_0033_148675.jpg,492,500,144.Common_Tern,39,21,452,481,245,251,413,460
../../CUB_200_2011/images\144.Common_Tern/Common_Tern_0051_150469.jpg,500,334,144.Common_Tern,184,16,483,282,333,149,299,266
../../CUB_200_2011/images\144.Common_Tern/Common_Tern_0044_148680.jpg,500,369,144.Common_Tern,152,107,467,271,309,189,315,164
../../CUB_200_2011/images\144.Common_Tern/Common_Tern_0047_149195.jpg,500,333,144.Common_Tern,164,26,443,291,303,158,279,265
../../CUB_200_2011/images\144.Common_Tern/Common_Tern_0077_149196.jpg,500,333,144.Common_Tern,15,44,479,287,247,165,464,243
../../CUB_200_2011/images\144.Common_Tern/Common_Tern_0117_148944.jpg,500,320,144.Common_Tern,132,52,240,173,186,112,108,121
../../CUB_200_2011/images\144.Common_Tern/Common_Tern_0004_148977.jpg,500,325,144.Common_Tern,13,82,365,195,189,138,352,113
../../CUB_200_2011/images\144.Common_Tern/Common_Tern_0001_149721.jpg,500,354,144.Common_Tern,38,92,367,286,202,189,329,194
../../CUB_200_2011/images\144.Common_Tern/Common_Tern_0085_147937.jpg,500,361,144.Common_Tern,37,80,373,214,205,147,336,134
../../CUB_200_2011/images\144.Common_Tern/Common_Tern_0103_149733.jpg,500,333,144.Common_Tern,23,17,371,163,197,90,348,146
../../CUB_200_2011/images\144.Common_Tern/Common_Tern_0014_149194.jpg,500,411,144.Common_Tern,2,71,499,316,250,193,497,245
../../CUB_200_2011/images\144.Common_Tern/Common_Tern_0118_148201.jpg,500,333,144.Common_Tern,83,60,335,224,209,142,252,164
../../CUB_200_2011/images\144.Common_Tern/Common_Tern_0115_149482.jpg,500,375,144.Common_Tern,2,45,385,213,193,129,383,168
../../CUB_200_2011/images\144.Common_Tern/Common_Tern_0076_148391.jpg,333,500,144.Common_Tern,87,56,302,357,194,206,215,301
../../CUB_200_2011/images\144.Common_Tern/Common_Tern_0081_149228.jpg,500,400,144.Common_Tern,110,128,344,230,227,179,234,102
../../CUB_200_2011/images\144.Common_Tern/Common_Tern_0113_147949.jpg,500,427,144.Common_Tern,254,99,456,314,355,206,202,215
../../CUB_200_2011/images\144.Common_Tern/Common_Tern_0057_149749.jpg,500,355,144.Common_Tern,170,7,354,279,262,143,184,272
../../CUB_200_2011/images\144.Common_Tern/Common_Tern_0053_148472.jpg,500,374,144.Common_Tern,182,153,405,303,293,228,223,150
../../CUB_200_2011/images\144.Common_Tern/Common_Tern_0012_148477.jpg,500,335,144.Common_Tern,143,105,481,291,312,198,338,186
../../CUB_200_2011/images\145.Elegant_Tern/Elegant_Tern_0093_150534.jpg,500,375,145.Elegant_Tern,93,121,441,272,267,196,348,151
../../CUB_200_2011/images\145.Elegant_Tern/Elegant_Tern_0080_150538.jpg,500,353,145.Elegant_Tern,135,47,471,335,303,191,336,288
../../CUB_200_2011/images\145.Elegant_Tern/Elegant_Tern_0032_150488.jpg,500,388,145.Elegant_Tern,130,57,420,298,275,177,290,241
../../CUB_200_2011/images\145.Elegant_Tern/Elegant_Tern_0077_150548.jpg,500,333,145.Elegant_Tern,166,50,408,249,287,149,242,199
../../CUB_200_2011/images\145.Elegant_Tern/Elegant_Tern_0030_151067.jpg,500,335,145.Elegant_Tern,15,27,478,263,246,145,463,236
../../CUB_200_2011/images\145.Elegant_Tern/Elegant_Tern_0096_151068.jpg,500,335,145.Elegant_Tern,72,57,324,263,198,160,252,206
../../CUB_200_2011/images\145.Elegant_Tern/Elegant_Tern_0034_45914.jpg,500,314,145.Elegant_Tern,111,16,398,260,254,138,287,244
../../CUB_200_2011/images\145.Elegant_Tern/Elegant_Tern_0064_150822.jpg,500,452,145.Elegant_Tern,50,1,439,388,244,194,389,387
../../CUB_200_2011/images\145.Elegant_Tern/Elegant_Tern_0083_150829.jpg,500,393,145.Elegant_Tern,44,1,472,365,258,183,428,364
../../CUB_200_2011/images\145.Elegant_Tern/Elegant_Tern_0088_151089.jpg,500,332,145.Elegant_Tern,254,151,465,268,359,209,211,117
../../CUB_200_2011/images\145.Elegant_Tern/Elegant_Tern_0085_151091.jpg,500,375,145.Elegant_Tern,238,66,446,210,342,138,208,144
../../CUB_200_2011/images\145.Elegant_Tern/Elegant_Tern_0060_150837.jpg,500,326,145.Elegant_Tern,44,30,236,312,140,171,192,282
../../CUB_200_2011/images\145.Elegant_Tern/Elegant_Tern_0024_150852.jpg,500,333,145.Elegant_Tern,46,40,494,325,270,182,448,285
../../CUB_200_2011/images\145.Elegant_Tern/Elegant_Tern_0058_150853.jpg,500,296,145.Elegant_Tern,27,20,316,165,171,92,289,145
../../CUB_200_2011/images\145.Elegant_Tern/Elegant_Tern_0089_150854.jpg,500,333,145.Elegant_Tern,45,25,495,286,270,155,450,261
../../CUB_200_2011/images\145.Elegant_Tern/Elegant_Tern_0066_150864.jpg,500,357,145.Elegant_Tern,10,109,215,250,112,179,205,141
../../CUB_200_2011/images\145.Elegant_Tern/Elegant_Tern_0026_150869.jpg,500,352,145.Elegant_Tern,50,38,499,346,274,192,449,308
../../CUB_200_2011/images\145.Elegant_Tern/Elegant_Tern_0106_150872.jpg,500,333,145.Elegant_Tern,2,20,357,160,179,90,355,140
../../CUB_200_2011/images\145.Elegant_Tern/Elegant_Tern_0063_150873.jpg,500,354,145.Elegant_Tern,119,73,399,270,259,171,280,197
../../CUB_200_2011/images\145.Elegant_Tern/Elegant_Tern_0070_147548.jpg,500,333,145.Elegant_Tern,7,117,333,296,170,206,326,179
../../CUB_200_2011/images\145.Elegant_Tern/Elegant_Tern_0047_150626.jpg,500,333,145.Elegant_Tern,118,49,320,214,219,131,202,165
../../CUB_200_2011/images\145.Elegant_Tern/Elegant_Tern_0090_45924.jpg,500,333,145.Elegant_Tern,165,103,487,281,326,192,322,178
../../CUB_200_2011/images\145.Elegant_Tern/Elegant_Tern_0046_150905.jpg,500,305,145.Elegant_Tern,71,43,440,205,255,124,369,162
../../CUB_200_2011/images\145.Elegant_Tern/Elegant_Tern_0023_150654.jpg,333,500,145.Elegant_Tern,64,77,296,374,180,225,232,297
../../CUB_200_2011/images\145.Elegant_Tern/Elegant_Tern_0072_150911.jpg,500,391,145.Elegant_Tern,51,93,351,265,201,179,300,172
../../CUB_200_2011/images\145.Elegant_Tern/Elegant_Tern_0053_150507.jpg,500,348,145.Elegant_Tern,27,81,493,321,260,201,466,240
../../CUB_200_2011/images\145.Elegant_Tern/Elegant_Tern_0084_150922.jpg,420,280,145.Elegant_Tern,83,67,388,257,235,162,305,190
../../CUB_200_2011/images\145.Elegant_Tern/Elegant_Tern_0073_150925.jpg,500,335,145.Elegant_Tern,67,26,438,254,252,140,371,228
../../CUB_200_2011/images\145.Elegant_Tern/Elegant_Tern_0067_151185.jpg,500,333,145.Elegant_Tern,161,98,336,230,248,164,175,132
../../CUB_200_2011/images\145.Elegant_Tern/Elegant_Tern_0042_150851.jpg,500,357,145.Elegant_Tern,41,30,385,315,213,172,344,285
../../CUB_200_2011/images\145.Elegant_Tern/Elegant_Tern_0008_145044.jpg,500,333,145.Elegant_Tern,51,109,370,262,210,185,319,153
../../CUB_200_2011/images\145.Elegant_Tern/Elegant_Tern_0099_150682.jpg,500,333,145.Elegant_Tern,75,59,405,287,240,173,330,228
../../CUB_200_2011/images\145.Elegant_Tern/Elegant_Tern_0078_151196.jpg,500,375,145.Elegant_Tern,95,77,338,337,216,207,243,260
../../CUB_200_2011/images\145.Elegant_Tern/Elegant_Tern_0033_150687.jpg,500,357,145.Elegant_Tern,329,228,482,337,405,282,153,109
../../CUB_200_2011/images\145.Elegant_Tern/Elegant_Tern_0004_150948.jpg,500,333,145.Elegant_Tern,122,99,459,283,290,191,337,184
../../CUB_200_2011/images\145.Elegant_Tern/Elegant_Tern_0048_150693.jpg,500,333,145.Elegant_Tern,56,36,321,247,188,141,265,211
../../CUB_200_2011/images\145.Elegant_Tern/Elegant_Tern_0052_150695.jpg,500,335,145.Elegant_Tern,87,56,484,245,285,150,397,189
../../CUB_200_2011/images\145.Elegant_Tern/Elegant_Tern_0079_150953.jpg,500,246,145.Elegant_Tern,73,11,316,206,194,108,243,195
../../CUB_200_2011/images\145.Elegant_Tern/Elegant_Tern_0009_150954.jpg,424,500,145.Elegant_Tern,59,83,372,427,215,255,313,344
../../CUB_200_2011/images\145.Elegant_Tern/Elegant_Tern_0107_150960.jpg,500,400,145.Elegant_Tern,117,87,307,254,212,170,190,167
../../CUB_200_2011/images\145.Elegant_Tern/Elegant_Tern_0006_150963.jpg,500,309,145.Elegant_Tern,172,81,319,189,245,135,147,108
../../CUB_200_2011/images\145.Elegant_Tern/Elegant_Tern_0005_150708.jpg,500,334,145.Elegant_Tern,52,59,452,262,252,160,400,203
../../CUB_200_2011/images\145.Elegant_Tern/Elegant_Tern_0101_150715.jpg,500,357,145.Elegant_Tern,38,87,462,273,250,180,424,186
../../CUB_200_2011/images\145.Elegant_Tern/Elegant_Tern_0036_150972.jpg,500,375,145.Elegant_Tern,32,108,499,342,265,225,467,234
../../CUB_200_2011/images\145.Elegant_Tern/Elegant_Tern_0039_150944.jpg,500,354,145.Elegant_Tern,76,107,249,278,162,192,173,171
../../CUB_200_2011/images\145.Elegant_Tern/Elegant_Tern_0044_150946.jpg,500,337,145.Elegant_Tern,39,45,486,226,262,135,447,181
../../CUB_200_2011/images\145.Elegant_Tern/Elegant_Tern_0050_150521.jpg,333,500,145.Elegant_Tern,30,57,230,198,130,127,200,141
../../CUB_200_2011/images\145.Elegant_Tern/Elegant_Tern_0035_150744.jpg,426,500,145.Elegant_Tern,91,49,302,349,196,199,211,300
../../CUB_200_2011/images\145.Elegant_Tern/Elegant_Tern_0103_150493.jpg,500,305,145.Elegant_Tern,124,31,294,238,209,134,170,207
../../CUB_200_2011/images\145.Elegant_Tern/Elegant_Tern_0029_150494.jpg,332,500,145.Elegant_Tern,22,56,302,427,162,241,280,371
../../CUB_200_2011/images\145.Elegant_Tern/Elegant_Tern_0045_150752.jpg,500,333,145.Elegant_Tern,40,89,462,311,251,200,422,222
../../CUB_200_2011/images\145.Elegant_Tern/Elegant_Tern_0061_150524.jpg,500,308,145.Elegant_Tern,41,90,395,270,218,180,354,180
../../CUB_200_2011/images\145.Elegant_Tern/Elegant_Tern_0028_151019.jpg,500,388,145.Elegant_Tern,120,60,348,287,234,173,228,227
../../CUB_200_2011/images\145.Elegant_Tern/Elegant_Tern_0065_151021.jpg,500,386,145.Elegant_Tern,32,30,446,269,239,149,414,239
../../CUB_200_2011/images\145.Elegant_Tern/Elegant_Tern_0098_151028.jpg,500,334,145.Elegant_Tern,62,23,321,240,191,131,259,217
../../CUB_200_2011/images\145.Elegant_Tern/Elegant_Tern_0082_150517.jpg,500,349,145.Elegant_Tern,137,134,464,313,300,223,327,179
../../CUB_200_2011/images\145.Elegant_Tern/Elegant_Tern_0076_150519.jpg,500,362,145.Elegant_Tern,59,34,478,271,268,152,419,237
../../CUB_200_2011/images\145.Elegant_Tern/Elegant_Tern_0014_150523.jpg,500,371,145.Elegant_Tern,52,23,467,233,259,128,415,210
../../CUB_200_2011/images\145.Elegant_Tern/Elegant_Tern_0074_151036.jpg,334,500,145.Elegant_Tern,25,55,279,429,152,242,254,374
../../CUB_200_2011/images\145.Elegant_Tern/Elegant_Tern_0068_150526.jpg,500,366,145.Elegant_Tern,60,78,436,237,248,157,376,159
../../CUB_200_2011/images\146.Forsters_Tern/Forsters_Tern_0012_151558.jpg,500,341,146.Forsters_Tern,124,37,446,325,285,181,322,288
../../CUB_200_2011/images\146.Forsters_Tern/Forsters_Tern_0098_151258.jpg,500,334,146.Forsters_Tern,190,72,326,255,258,163,136,183
../../CUB_200_2011/images\146.Forsters_Tern/Forsters_Tern_0118_151564.jpg,436,500,146.Forsters_Tern,58,29,396,364,227,196,338,335
../../CUB_200_2011/images\146.Forsters_Tern/Forsters_Tern_0068_152078.jpg,500,396,146.Forsters_Tern,45,98,452,371,248,234,407,273
../../CUB_200_2011/images\146.Forsters_Tern/Forsters_Tern_0057_151570.jpg,500,401,146.Forsters_Tern,184,125,496,354,340,239,312,229
../../CUB_200_2011/images\146.Forsters_Tern/Forsters_Tern_0109_152094.jpg,500,358,146.Forsters_Tern,37,42,364,317,200,179,327,275
../../CUB_200_2011/images\146.Forsters_Tern/Forsters_Tern_0076_151330.jpg,500,333,146.Forsters_Tern,19,66,344,295,181,180,325,229
../../CUB_200_2011/images\146.Forsters_Tern/Forsters_Tern_0043_151332.jpg,500,332,146.Forsters_Tern,212,33,408,259,310,146,196,226
../../CUB_200_2011/images\146.Forsters_Tern/Forsters_Tern_0070_152107.jpg,500,334,146.Forsters_Tern,0,0,460,333,230,166,460,333
../../CUB_200_2011/images\146.Forsters_Tern/Forsters_Tern_0007_152110.jpg,500,338,146.Forsters_Tern,14,131,331,282,172,206,317,151
../../CUB_200_2011/images\146.Forsters_Tern/Forsters_Tern_0089_152372.jpg,500,335,146.Forsters_Tern,164,82,294,208,229,145,130,126
../../CUB_200_2011/images\146.Forsters_Tern/Forsters_Tern_0092_152119.jpg,500,333,146.Forsters_Tern,77,51,309,266,193,158,232,215
../../CUB_200_2011/images\146.Forsters_Tern/Forsters_Tern_0002_151622.jpg,500,436,146.Forsters_Tern,51,103,367,343,209,223,316,240
../../CUB_200_2011/images\146.Forsters_Tern/Forsters_Tern_0071_152142.jpg,500,336,146.Forsters_Tern,116,82,375,224,245,153,259,142
../../CUB_200_2011/images\146.Forsters_Tern/Forsters_Tern_0049_151631.jpg,500,333,146.Forsters_Tern,20,79,476,266,248,172,456,187
../../CUB_200_2011/images\146.Forsters_Tern/Forsters_Tern_0041_149586.jpg,500,400,146.Forsters_Tern,37,158,342,352,189,255,305,194
../../CUB_200_2011/images\146.Forsters_Tern/Forsters_Tern_0088_151893.jpg,431,500,146.Forsters_Tern,146,134,366,379,256,256,220,245
../../CUB_200_2011/images\146.Forsters_Tern/Forsters_Tern_0091_151895.jpg,500,320,146.Forsters_Tern,8,32,439,259,223,145,431,227
../../CUB_200_2011/images\146.Forsters_Tern/Forsters_Tern_0032_151384.jpg,500,375,146.Forsters_Tern,13,98,407,256,210,177,394,158
../../CUB_200_2011/images\146.Forsters_Tern/Forsters_Tern_0121_151385.jpg,500,332,146.Forsters_Tern,39,28,450,247,244,137,411,219
../../CUB_200_2011/images\146.Forsters_Tern/Forsters_Tern_0104_152666.jpg,500,347,146.Forsters_Tern,74,35,410,254,242,144,336,219
../../CUB_200_2011/images\146.Forsters_Tern/Forsters_Tern_0034_152667.jpg,500,333,146.Forsters_Tern,15,2,257,276,136,139,242,274
../../CUB_200_2011/images\146.Forsters_Tern/Forsters_Tern_0042_151644.jpg,500,333,146.Forsters_Tern,46,43,261,233,153,138,215,190
../../CUB_200_2011/images\146.Forsters_Tern/Forsters_Tern_0021_144734.jpg,500,500,146.Forsters_Tern,175,196,420,321,297,258,245,125
../../CUB_200_2011/images\146.Forsters_Tern/Forsters_Tern_0125_151399.jpg,500,357,146.Forsters_Tern,168,88,465,255,316,171,297,167
../../CUB_200_2011/images\146.Forsters_Tern/Forsters_Tern_0001_152174.jpg,500,331,146.Forsters_Tern,122,66,440,263,281,164,318,197
../../CUB_200_2011/images\146.Forsters_Tern/Forsters_Tern_0053_152175.jpg,329,500,146.Forsters_Tern,11,3,323,489,167,246,312,486
../../CUB_200_2011/images\146.Forsters_Tern/Forsters_Tern_0017_152696.jpg,500,500,146.Forsters_Tern,107,114,434,453,270,283,327,339
../../CUB_200_2011/images\146.Forsters_Tern/Forsters_Tern_0082_151937.jpg,400,500,146.Forsters_Tern,145,65,283,313,214,189,138,248
../../CUB_200_2011/images\146.Forsters_Tern/Forsters_Tern_0119_152709.jpg,500,333,146.Forsters_Tern,28,37,443,196,235,116,415,159
../../CUB_200_2011/images\146.Forsters_Tern/Forsters_Tern_0116_151688.jpg,500,333,146.Forsters_Tern,139,56,499,283,319,169,360,227
../../CUB_200_2011/images\146.Forsters_Tern/Forsters_Tern_0065_152206.jpg,500,343,146.Forsters_Tern,152,80,474,216,313,148,322,136
../../CUB_200_2011/images\146.Forsters_Tern/Forsters_Tern_0016_152463.jpg,375,500,146.Forsters_Tern,88,108,269,499,178,303,181,391
../../CUB_200_2011/images\146.Forsters_Tern/Forsters_Tern_0127_150418.jpg,500,333,146.Forsters_Tern,81,36,485,282,283,159,404,246
../../CUB_200_2011/images\146.Forsters_Tern/Forsters_Tern_0064_152047.jpg,500,346,146.Forsters_Tern,206,130,412,236,309,183,206,106
../../CUB_200_2011/images\146.Forsters_Tern/Forsters_Tern_0027_151456.jpg,500,333,146.Forsters_Tern,12,102,408,295,210,198,396,193
../../CUB_200_2011/images\146.Forsters_Tern/Forsters_Tern_0086_152738.jpg,500,375,146.Forsters_Tern,17,77,292,245,154,161,275,168
../../CUB_200_2011/images\146.Forsters_Tern/Forsters_Tern_0097_151731.jpg,500,300,146.Forsters_Tern,16,17,486,254,251,135,470,237
../../CUB_200_2011/images\146.Forsters_Tern/Forsters_Tern_0066_151478.jpg,500,333,146.Forsters_Tern,101,55,452,285,276,170,351,230
../../CUB_200_2011/images\146.Forsters_Tern/Forsters_Tern_0087_151226.jpg,500,357,146.Forsters_Tern,88,108,439,290,263,199,351,182
../../CUB_200_2011/images\146.Forsters_Tern/Forsters_Tern_0045_151227.jpg,500,323,146.Forsters_Tern,178,60,303,186,240,123,125,126
../../CUB_200_2011/images\146.Forsters_Tern/Forsters_Tern_0029_151228.jpg,500,415,146.Forsters_Tern,18,98,411,278,214,188,393,180
../../CUB_200_2011/images\146.Forsters_Tern/Forsters_Tern_0069_151229.jpg,500,334,146.Forsters_Tern,154,4,384,268,269,136,230,264
../../CUB_200_2011/images\146.Forsters_Tern/Forsters_Tern_0077_152255.jpg,500,333,146.Forsters_Tern,108,0,499,294,303,147,391,294
../../CUB_200_2011/images\146.Forsters_Tern/Forsters_Tern_0114_152768.jpg,500,333,146.Forsters_Tern,86,28,496,245,291,136,410,217
../../CUB_200_2011/images\146.Forsters_Tern/Forsters_Tern_0075_152258.jpg,500,450,146.Forsters_Tern,93,28,350,386,221,207,257,358
../../CUB_200_2011/images\146.Forsters_Tern/Forsters_Tern_0080_152521.jpg,500,329,146.Forsters_Tern,122,92,432,233,277,162,310,141
../../CUB_200_2011/images\146.Forsters_Tern/Forsters_Tern_0010_151243.jpg,333,500,146.Forsters_Tern,103,68,330,394,216,231,227,326
../../CUB_200_2011/images\146.Forsters_Tern/Forsters_Tern_0035_151757.jpg,400,500,146.Forsters_Tern,111,103,366,304,238,203,255,201
../../CUB_200_2011/images\146.Forsters_Tern/Forsters_Tern_0126_151257.jpg,500,332,146.Forsters_Tern,34,50,484,262,259,156,450,212
../../CUB_200_2011/images\146.Forsters_Tern/Forsters_Tern_0100_151774.jpg,500,371,146.Forsters_Tern,163,26,452,328,307,177,289,302
../../CUB_200_2011/images\146.Forsters_Tern/Forsters_Tern_0003_151547.jpg,500,323,146.Forsters_Tern,159,107,431,225,295,166,272,118
../../CUB_200_2011/images\146.Forsters_Tern/Forsters_Tern_0062_151780.jpg,332,500,146.Forsters_Tern,71,110,299,332,185,221,228,222
../../CUB_200_2011/images\146.Forsters_Tern/Forsters_Tern_0059_151269.jpg,500,333,146.Forsters_Tern,87,45,462,272,274,158,375,227
../../CUB_200_2011/images\146.Forsters_Tern/Forsters_Tern_0099_152529.jpg,500,346,146.Forsters_Tern,143,103,441,254,292,178,298,151
../../CUB_200_2011/images\146.Forsters_Tern/Forsters_Tern_0123_151789.jpg,500,336,146.Forsters_Tern,26,22,477,312,251,167,451,290
../../CUB_200_2011/images\146.Forsters_Tern/Forsters_Tern_0095_152067.jpg,500,375,146.Forsters_Tern,63,136,400,292,231,214,337,156
../../CUB_200_2011/images\146.Forsters_Tern/Forsters_Tern_0083_151282.jpg,500,370,146.Forsters_Tern,82,60,497,280,289,170,415,220
../../CUB_200_2011/images\146.Forsters_Tern/Forsters_Tern_0004_152358.jpg,500,375,146.Forsters_Tern,147,119,380,243,263,181,233,124
../../CUB_200_2011/images\146.Forsters_Tern/Forsters_Tern_0060_152190.jpg,500,332,146.Forsters_Tern,44,27,226,135,135,81,182,108
../../CUB_200_2011/images\147.Least_Tern/Least_Tern_0109_154127.jpg,500,336,147.Least_Tern,24,56,424,268,224,162,400,212
../../CUB_200_2011/images\147.Least_Tern/Least_Tern_0016_153560.jpg,500,327,147.Least_Tern,79,74,358,260,218,167,279,186
../../CUB_200_2011/images\147.Least_Tern/Least_Tern_0127_154141.jpg,500,375,147.Least_Tern,202,159,421,289,311,224,219,130
../../CUB_200_2011/images\147.Least_Tern/Least_Tern_0067_154145.jpg,500,375,147.Least_Tern,34,66,384,262,209,164,350,196
../../CUB_200_2011/images\147.Least_Tern/Least_Tern_0095_154680.jpg,500,476,147.Least_Tern,60,116,492,365,276,240,432,249
../../CUB_200_2011/images\147.Least_Tern/Least_Tern_0036_153658.jpg,500,417,147.Least_Tern,5,122,477,333,241,227,472,211
../../CUB_200_2011/images\147.Least_Tern/Least_Tern_0007_153661.jpg,500,348,147.Least_Tern,96,55,444,308,270,181,348,253
../../CUB_200_2011/images\147.Least_Tern/Least_Tern_0025_153678.jpg,500,333,147.Least_Tern,118,106,482,304,300,205,364,198
../../CUB_200_2011/images\147.Least_Tern/Least_Tern_0075_153691.jpg,500,335,147.Least_Tern,106,60,425,231,265,145,319,171
../../CUB_200_2011/images\147.Least_Tern/Least_Tern_0026_153702.jpg,500,375,147.Least_Tern,11,101,395,309,203,205,384,208
../../CUB_200_2011/images\147.Least_Tern/Least_Tern_0116_153715.jpg,500,337,147.Least_Tern,31,136,336,276,183,206,305,140
../../CUB_200_2011/images\147.Least_Tern/Least_Tern_0011_153722.jpg,500,350,147.Least_Tern,148,56,441,285,294,170,293,229
../../CUB_200_2011/images\147.Least_Tern/Least_Tern_0128_153732.jpg,500,333,147.Least_Tern,139,95,367,267,253,181,228,172
../../CUB_200_2011/images\147.Least_Tern/Least_Tern_0068_153738.jpg,500,374,147.Least_Tern,93,53,405,306,249,179,312,253
../../CUB_200_2011/images\147.Least_Tern/Least_Tern_0088_152941.jpg,500,354,147.Least_Tern,116,83,496,304,306,193,380,221
../../CUB_200_2011/images\147.Least_Tern/Least_Tern_0059_153746.jpg,500,373,147.Least_Tern,119,72,367,323,243,197,248,251
../../CUB_200_2011/images\147.Least_Tern/Least_Tern_0058_153747.jpg,500,357,147.Least_Tern,118,50,472,242,295,146,354,192
../../CUB_200_2011/images\147.Least_Tern/Least_Tern_0014_153757.jpg,500,333,147.Least_Tern,114,62,452,234,283,148,338,172
../../CUB_200_2011/images\147.Least_Tern/Least_Tern_0062_153259.jpg,500,372,147.Least_Tern,62,123,385,311,223,217,323,188
../../CUB_200_2011/images\147.Least_Tern/Least_Tern_0060_153190.jpg,500,333,147.Least_Tern,94,113,319,232,206,172,225,119
../../CUB_200_2011/images\147.Least_Tern/Least_Tern_0028_153781.jpg,500,334,147.Least_Tern,64,35,228,256,146,145,164,221
../../CUB_200_2011/images\147.Least_Tern/Least_Tern_0033_153796.jpg,500,352,147.Least_Tern,49,108,419,256,234,182,370,148
../../CUB_200_2011/images\147.Least_Tern/Least_Tern_0042_153809.jpg,500,333,147.Least_Tern,3,0,272,209,137,104,269,209
../../CUB_200_2011/images\147.Least_Tern/Least_Tern_0133_153816.jpg,425,500,147.Least_Tern,27,144,305,339,166,241,278,195
../../CUB_200_2011/images\147.Least_Tern/Least_Tern_0098_153820.jpg,500,331,147.Least_Tern,104,105,350,218,227,161,246,113
../../CUB_200_2011/images\147.Least_Tern/Least_Tern_0037_153637.jpg,500,390,147.Least_Tern,127,83,371,209,249,146,244,126
../../CUB_200_2011/images\147.Least_Tern/Least_Tern_0008_153313.jpg,500,332,147.Least_Tern,6,65,445,287,225,176,439,222
../../CUB_200_2011/images\147.Least_Tern/Least_Tern_0024_153317.jpg,500,333,147.Least_Tern,100,76,480,275,290,175,380,199
../../CUB_200_2011/images\147.Least_Tern/Least_Tern_0114_153840.jpg,500,334,147.Least_Tern,99,125,327,244,213,184,228,119
../../CUB_200_2011/images\147.Least_Tern/Least_Tern_0096_153868.jpg,500,372,147.Least_Tern,67,83,403,293,235,188,336,210
../../CUB_200_2011/images\147.Least_Tern/Least_Tern_0012_153871.jpg,339,500,147.Least_Tern,52,43,289,396,170,219,237,353
../../CUB_200_2011/images\147.Least_Tern/Least_Tern_0092_153361.jpg,500,375,147.Least_Tern,132,92,424,266,278,179,292,174
../../CUB_200_2011/images\147.Least_Tern/Least_Tern_0082_154396.jpg,500,456,147.Least_Tern,63,58,480,406,271,232,417,348
../../CUB_200_2011/images\147.Least_Tern/Least_Tern_0111_153308.jpg,500,360,147.Least_Tern,93,1,405,357,249,179,312,356
../../CUB_200_2011/images\147.Least_Tern/Least_Tern_0132_154149.jpg,500,333,147.Least_Tern,6,128,349,272,177,200,343,144
../../CUB_200_2011/images\147.Least_Tern/Least_Tern_0113_153415.jpg,417,339,147.Least_Tern,114,97,293,222,203,159,179,125
../../CUB_200_2011/images\147.Least_Tern/Least_Tern_0089_152912.jpg,500,289,147.Least_Tern,139,94,499,266,319,180,360,172
../../CUB_200_2011/images\147.Least_Tern/Least_Tern_0119_153950.jpg,479,500,147.Least_Tern,160,79,478,442,319,260,318,363
../../CUB_200_2011/images\147.Least_Tern/Least_Tern_0035_152932.jpg,500,416,147.Least_Tern,146,78,464,375,305,226,318,297
../../CUB_200_2011/images\147.Least_Tern/Least_Tern_0129_153449.jpg,500,420,147.Least_Tern,140,95,458,335,299,215,318,240
../../CUB_200_2011/images\147.Least_Tern/Least_Tern_0034_153963.jpg,500,333,147.Least_Tern,26,91,335,255,180,173,309,164
../../CUB_200_2011/images\147.Least_Tern/Least_Tern_0056_153965.jpg,500,333,147.Least_Tern,73,14,400,307,236,160,327,293
../../CUB_200_2011/images\147.Least_Tern/Least_Tern_0020_153458.jpg,500,340,147.Least_Tern,91,84,442,284,266,184,351,200
../../CUB_200_2011/images\147.Least_Tern/Least_Tern_0100_153461.jpg,500,406,147.Least_Tern,136,193,370,337,253,265,234,144
../../CUB_200_2011/images\147.Least_Tern/Least_Tern_0104_152950.jpg,500,375,147.Least_Tern,70,35,475,207,272,121,405,172
../../CUB_200_2011/images\147.Least_Tern/Least_Tern_0021_153979.jpg,500,333,147.Least_Tern,157,145,387,268,272,206,230,123
../../CUB_200_2011/images\147.Least_Tern/Least_Tern_0041_153470.jpg,500,424,147.Least_Tern,31,127,500,371,265,249,469,244
../../CUB_200_2011/images\147.Least_Tern/Least_Tern_0131_153983.jpg,500,336,147.Least_Tern,163,68,349,174,256,121,186,106
../../CUB_200_2011/images\147.Least_Tern/Least_Tern_0006_153921.jpg,500,375,147.Least_Tern,215,143,333,269,274,206,118,126
../../CUB_200_2011/images\147.Least_Tern/Least_Tern_0125_153996.jpg,500,375,147.Least_Tern,139,40,421,337,280,188,282,297
../../CUB_200_2011/images\147.Least_Tern/Least_Tern_0107_154015.jpg,500,281,147.Least_Tern,15,14,488,194,251,104,473,180
../../CUB_200_2011/images\147.Least_Tern/Least_Tern_0052_154021.jpg,500,376,147.Least_Tern,30,185,302,294,166,239,272,109
../../CUB_200_2011/images\147.Least_Tern/Least_Tern_0046_153006.jpg,500,332,147.Least_Tern,55,97,324,302,189,199,269,205
../../CUB_200_2011/images\147.Least_Tern/Least_Tern_0122_153012.jpg,500,371,147.Least_Tern,74,80,392,283,233,181,318,203
../../CUB_200_2011/images\147.Least_Tern/Least_Tern_0048_153550.jpg,500,334,147.Least_Tern,134,157,415,263,274,210,281,106
../../CUB_200_2011/images\147.Least_Tern/Least_Tern_0040_153039.jpg,500,333,147.Least_Tern,188,151,374,275,281,213,186,124
../../CUB_200_2011/images\147.Least_Tern/Least_Tern_0029_154064.jpg,500,345,147.Least_Tern,53,89,426,264,239,176,373,175
../../CUB_200_2011/images\147.Least_Tern/Least_Tern_0050_153254.jpg,500,400,147.Least_Tern,67,177,322,306,194,241,255,129
../../CUB_200_2011/images\147.Least_Tern/Least_Tern_0112_153074.jpg,500,375,147.Least_Tern,27,23,422,286,224,154,395,263
../../CUB_200_2011/images\147.Least_Tern/Least_Tern_0038_153087.jpg,500,361,147.Least_Tern,29,54,461,246,245,150,432,192
../../CUB_200_2011/images\148.Green_tailed_Towhee/Green_Tailed_Towhee_0109_797440.jpg,500,375,148.Green_tailed_Towhee,30,70,339,323,184,196,309,253
../../CUB_200_2011/images\148.Green_tailed_Towhee/Green_Tailed_Towhee_0061_154880.jpg,500,375,148.Green_tailed_Towhee,106,45,341,341,223,193,235,296
../../CUB_200_2011/images\148.Green_tailed_Towhee/Green_Tailed_Towhee_0099_154882.jpg,500,335,148.Green_tailed_Towhee,25,93,412,309,218,201,387,216
../../CUB_200_2011/images\148.Green_tailed_Towhee/Green_Tailed_Towhee_0077_797443.jpg,500,500,148.Green_tailed_Towhee,218,116,413,495,315,305,195,379
../../CUB_200_2011/images\148.Green_tailed_Towhee/Green_Tailed_Towhee_0069_797441.jpg,307,260,148.Green_tailed_Towhee,100,33,202,241,151,137,102,208
../../CUB_200_2011/images\148.Green_tailed_Towhee/Green_Tailed_Towhee_0035_154888.jpg,500,389,148.Green_tailed_Towhee,150,85,421,310,285,197,271,225
../../CUB_200_2011/images\148.Green_tailed_Towhee/Green_Tailed_Towhee_0022_154892.jpg,500,375,148.Green_tailed_Towhee,165,170,303,330,234,250,138,160
../../CUB_200_2011/images\148.Green_tailed_Towhee/Green_Tailed_Towhee_0050_154898.jpg,357,500,148.Green_tailed_Towhee,51,63,318,399,184,231,267,336
../../CUB_200_2011/images\148.Green_tailed_Towhee/Green_Tailed_Towhee_0101_154907.jpg,500,333,148.Green_tailed_Towhee,17,49,385,328,201,188,368,279
../../CUB_200_2011/images\148.Green_tailed_Towhee/Green_Tailed_Towhee_0074_154915.jpg,380,500,148.Green_tailed_Towhee,54,26,371,483,212,254,317,457
../../CUB_200_2011/images\148.Green_tailed_Towhee/Green_Tailed_Towhee_0021_797404.jpg,350,464,148.Green_tailed_Towhee,81,154,216,412,148,283,135,258
../../CUB_200_2011/images\148.Green_tailed_Towhee/Green_Tailed_Towhee_0044_154934.jpg,500,357,148.Green_tailed_Towhee,19,62,458,342,238,202,439,280
../../CUB_200_2011/images\148.Green_tailed_Towhee/Green_Tailed_Towhee_0054_154938.jpg,500,333,148.Green_tailed_Towhee,57,56,342,304,199,180,285,248
../../CUB_200_2011/images\148.Green_tailed_Towhee/Green_Tailed_Towhee_0096_154945.jpg,500,333,148.Green_tailed_Towhee,14,33,288,311,151,172,274,278
../../CUB_200_2011/images\148.Green_tailed_Towhee/Green_Tailed_Towhee_0072_154946.jpg,500,343,148.Green_tailed_Towhee,170,53,295,320,232,186,125,267
../../CUB_200_2011/images\148.Green_tailed_Towhee/Green_Tailed_Towhee_0004_154951.jpg,500,333,148.Green_tailed_Towhee,218,126,409,267,313,196,191,141
../../CUB_200_2011/images\148.Green_tailed_Towhee/Green_Tailed_Towhee_0100_154966.jpg,500,403,148.Green_tailed_Towhee,162,32,349,374,255,203,187,342
../../CUB_200_2011/images\148.Green_tailed_Towhee/Green_Tailed_Towhee_0046_154967.jpg,500,333,148.Green_tailed_Towhee,101,72,303,320,202,196,202,248
../../CUB_200_2011/images\148.Green_tailed_Towhee/Green_Tailed_Towhee_0024_154855.jpg,500,375,148.Green_tailed_Towhee,85,48,465,351,275,199,380,303
../../CUB_200_2011/images\148.Green_tailed_Towhee/Green_Tailed_Towhee_0076_154999.jpg,500,375,148.Green_tailed_Towhee,261,98,437,262,349,180,176,164
../../CUB_200_2011/images\148.Green_tailed_Towhee/Green_Tailed_Towhee_0079_154764.jpg,500,402,148.Green_tailed_Towhee,90,127,382,301,236,214,292,174
../../CUB_200_2011/images\148.Green_tailed_Towhee/Green_Tailed_Towhee_0051_154768.jpg,333,500,148.Green_tailed_Towhee,12,143,187,320,99,231,175,177
../../CUB_200_2011/images\148.Green_tailed_Towhee/Green_Tailed_Towhee_0064_154771.jpg,298,309,148.Green_tailed_Towhee,44,81,270,277,157,179,226,196
../../CUB_200_2011/images\148.Green_tailed_Towhee/Green_Tailed_Towhee_0047_154776.jpg,500,262,148.Green_tailed_Towhee,227,36,372,181,299,108,145,145
../../CUB_200_2011/images\148.Green_tailed_Towhee/Green_Tailed_Towhee_0068_154783.jpg,500,358,148.Green_tailed_Towhee,134,145,249,290,191,217,115,145
../../CUB_200_2011/images\148.Green_tailed_Towhee/Green_Tailed_Towhee_0005_154784.jpg,500,397,148.Green_tailed_Towhee,36,131,326,341,181,236,290,210
../../CUB_200_2011/images\148.Green_tailed_Towhee/Green_Tailed_Towhee_0042_154801.jpg,500,336,148.Green_tailed_Towhee,174,51,427,291,300,171,253,240
../../CUB_200_2011/images\148.Green_tailed_Towhee/Green_Tailed_Towhee_0039_154802.jpg,500,375,148.Green_tailed_Towhee,184,63,416,313,300,188,232,250
../../CUB_200_2011/images\148.Green_tailed_Towhee/Green_Tailed_Towhee_0053_154921.jpg,500,333,148.Green_tailed_Towhee,185,112,389,217,287,164,204,105
../../CUB_200_2011/images\148.Green_tailed_Towhee/Green_Tailed_Towhee_0060_154820.jpg,500,375,148.Green_tailed_Towhee,67,192,284,300,175,246,217,108
../../CUB_200_2011/images\148.Green_tailed_Towhee/Green_Tailed_Towhee_0043_797430.jpg,500,371,148.Green_tailed_Towhee,9,20,471,314,240,167,462,294
../../CUB_200_2011/images\148.Green_tailed_Towhee/Green_Tailed_Towhee_0085_154822.jpg,500,414,148.Green_tailed_Towhee,157,121,433,377,295,249,276,256
../../CUB_200_2011/images\148.Green_tailed_Towhee/Green_Tailed_Towhee_0027_154823.jpg,500,397,148.Green_tailed_Towhee,170,125,402,298,286,211,232,173
../../CUB_200_2011/images\148.Green_tailed_Towhee/Green_Tailed_Towhee_0018_154825.jpg,500,341,148.Green_tailed_Towhee,144,127,321,269,232,198,177,142
../../CUB_200_2011/images\148.Green_tailed_Towhee/Green_Tailed_Towhee_0082_797395.jpg,500,333,148.Green_tailed_Towhee,5,77,423,302,214,189,418,225
../../CUB_200_2011/images\148.Green_tailed_Towhee/Green_Tailed_Towhee_0094_797396.jpg,450,361,148.Green_tailed_Towhee,26,8,361,322,193,165,335,314
../../CUB_200_2011/images\148.Green_tailed_Towhee/Green_Tailed_Towhee_0092_797397.jpg,240,240,148.Green_tailed_Towhee,45,39,213,212,129,125,168,173
../../CUB_200_2011/images\148.Green_tailed_Towhee/Green_Tailed_Towhee_0058_797399.jpg,330,270,148.Green_tailed_Towhee,36,88,272,224,154,156,236,136
../../CUB_200_2011/images\148.Green_tailed_Towhee/Green_Tailed_Towhee_0017_797400.jpg,467,350,148.Green_tailed_Towhee,26,84,377,317,201,200,351,233
../../CUB_200_2011/images\148.Green_tailed_Towhee/Green_Tailed_Towhee_0025_797401.jpg,449,500,148.Green_tailed_Towhee,30,32,338,488,184,260,308,456
../../CUB_200_2011/images\148.Green_tailed_Towhee/Green_Tailed_Towhee_0104_797403.jpg,408,280,148.Green_tailed_Towhee,41,64,346,208,193,136,305,144
../../CUB_200_2011/images\148.Green_tailed_Towhee/Green_Tailed_Towhee_0070_154844.jpg,500,356,148.Green_tailed_Towhee,96,98,495,295,295,196,399,197
../../CUB_200_2011/images\148.Green_tailed_Towhee/Green_Tailed_Towhee_0037_797405.jpg,500,384,148.Green_tailed_Towhee,30,59,410,333,220,196,380,274
../../CUB_200_2011/images\148.Green_tailed_Towhee/Green_Tailed_Towhee_0011_797410.jpg,500,375,148.Green_tailed_Towhee,233,114,428,334,330,224,195,220
../../CUB_200_2011/images\148.Green_tailed_Towhee/Green_Tailed_Towhee_0012_797435.jpg,500,364,148.Green_tailed_Towhee,79,89,414,298,246,193,335,209
../../CUB_200_2011/images\148.Green_tailed_Towhee/Green_Tailed_Towhee_0001_797412.jpg,500,341,148.Green_tailed_Towhee,82,64,388,291,235,177,306,227
../../CUB_200_2011/images\148.Green_tailed_Towhee/Green_Tailed_Towhee_0003_797414.jpg,500,334,148.Green_tailed_Towhee,15,65,377,317,196,191,362,252
../../CUB_200_2011/images\148.Green_tailed_Towhee/Green_Tailed_Towhee_0014_797415.jpg,480,380,148.Green_tailed_Towhee,85,44,438,297,261,170,353,253
../../CUB_200_2011/images\148.Green_tailed_Towhee/Green_Tailed_Towhee_0030_797417.jpg,500,334,148.Green_tailed_Towhee,2,18,432,333,217,175,430,315
../../CUB_200_2011/images\148.Green_tailed_Towhee/Green_Tailed_Towhee_0102_797420.jpg,400,325,148.Green_tailed_Towhee,119,98,348,286,233,192,229,188
../../CUB_200_2011/images\148.Green_tailed_Towhee/Green_Tailed_Towhee_0062_797424.jpg,500,318,148.Green_tailed_Towhee,209,55,438,221,323,138,229,166
../../CUB_200_2011/images\148.Green_tailed_Towhee/Green_Tailed_Towhee_0015_797425.jpg,500,460,148.Green_tailed_Towhee,160,85,386,429,273,257,226,344
../../CUB_200_2011/images\148.Green_tailed_Towhee/Green_Tailed_Towhee_0067_797426.jpg,500,359,148.Green_tailed_Towhee,124,97,454,300,289,198,330,203
../../CUB_200_2011/images\148.Green_tailed_Towhee/Green_Tailed_Towhee_0110_154868.jpg,500,332,148.Green_tailed_Towhee,118,124,270,246,194,185,152,122
../../CUB_200_2011/images\148.Green_tailed_Towhee/Green_Tailed_Towhee_0071_154870.jpg,500,400,148.Green_tailed_Towhee,25,49,437,360,231,204,412,311
../../CUB_200_2011/images\148.Green_tailed_Towhee/Green_Tailed_Towhee_0010_797431.jpg,500,333,148.Green_tailed_Towhee,201,47,471,281,336,164,270,234
../../CUB_200_2011/images\148.Green_tailed_Towhee/Green_Tailed_Towhee_0090_797434.jpg,500,393,148.Green_tailed_Towhee,128,123,313,241,220,182,185,118
../../CUB_200_2011/images\148.Green_tailed_Towhee/Green_Tailed_Towhee_0036_154875.jpg,500,400,148.Green_tailed_Towhee,110,148,377,286,243,217,267,138
../../CUB_200_2011/images\148.Green_tailed_Towhee/Green_Tailed_Towhee_0105_797438.jpg,500,333,148.Green_tailed_Towhee,19,30,383,313,201,171,364,283
../../CUB_200_2011/images\148.Green_tailed_Towhee/Green_Tailed_Towhee_0066_797439.jpg,500,328,148.Green_tailed_Towhee,46,27,357,233,201,130,311,206
../../CUB_200_2011/images\149.Brown_Thrasher/Brown_Thrasher_0034_155139.jpg,500,400,149.Brown_Thrasher,80,58,389,360,234,209,309,302
../../CUB_200_2011/images\149.Brown_Thrasher/Brown_Thrasher_0061_155140.jpg,447,500,149.Brown_Thrasher,150,117,350,425,250,271,200,308
../../CUB_200_2011/images\149.Brown_Thrasher/Brown_Thrasher_0054_155145.jpg,500,323,149.Brown_Thrasher,63,165,315,286,189,225,252,121
../../CUB_200_2011/images\149.Brown_Thrasher/Brown_Thrasher_0069_155151.jpg,400,500,149.Brown_Thrasher,31,51,399,492,215,271,368,441
../../CUB_200_2011/images\149.Brown_Thrasher/Brown_Thrasher_0030_155152.jpg,500,334,149.Brown_Thrasher,12,76,340,316,176,196,328,240
../../CUB_200_2011/images\149.Brown_Thrasher/Brown_Thrasher_0046_155154.jpg,400,500,149.Brown_Thrasher,185,121,367,467,276,294,182,346
../../CUB_200_2011/images\149.Brown_Thrasher/Brown_Thrasher_0033_155156.jpg,500,369,149.Brown_Thrasher,109,93,340,315,224,204,231,222
../../CUB_200_2011/images\149.Brown_Thrasher/Brown_Thrasher_0021_155160.jpg,483,500,149.Brown_Thrasher,49,153,324,376,186,264,275,223
../../CUB_200_2011/images\149.Brown_Thrasher/Brown_Thrasher_0057_155164.jpg,500,376,149.Brown_Thrasher,49,64,413,292,231,178,364,228
../../CUB_200_2011/images\149.Brown_Thrasher/Brown_Thrasher_0015_155165.jpg,500,381,149.Brown_Thrasher,62,172,308,326,185,249,246,154
../../CUB_200_2011/images\149.Brown_Thrasher/Brown_Thrasher_0119_155170.jpg,500,396,149.Brown_Thrasher,104,80,433,379,268,229,329,299
../../CUB_200_2011/images\149.Brown_Thrasher/Brown_Thrasher_0005_155176.jpg,500,359,149.Brown_Thrasher,47,83,410,336,228,209,363,253
../../CUB_200_2011/images\149.Brown_Thrasher/Brown_Thrasher_0045_155182.jpg,500,375,149.Brown_Thrasher,150,73,393,368,271,220,243,295
../../CUB_200_2011/images\149.Brown_Thrasher/Brown_Thrasher_0112_155183.jpg,500,337,149.Brown_Thrasher,48,41,369,332,208,186,321,291
../../CUB_200_2011/images\149.Brown_Thrasher/Brown_Thrasher_0105_155187.jpg,500,367,149.Brown_Thrasher,95,97,407,326,251,211,312,229
../../CUB_200_2011/images\149.Brown_Thrasher/Brown_Thrasher_0084_155189.jpg,375,500,149.Brown_Thrasher,94,141,338,336,216,238,244,195
../../CUB_200_2011/images\149.Brown_Thrasher/Brown_Thrasher_0127_155193.jpg,500,400,149.Brown_Thrasher,135,140,470,320,302,230,335,180
../../CUB_200_2011/images\149.Brown_Thrasher/Brown_Thrasher_0126_155199.jpg,500,464,149.Brown_Thrasher,166,170,343,344,254,257,177,174
../../CUB_200_2011/images\149.Brown_Thrasher/Brown_Thrasher_0080_155200.jpg,500,400,149.Brown_Thrasher,43,57,432,364,237,210,389,307
../../CUB_200_2011/images\149.Brown_Thrasher/Brown_Thrasher_0042_155213.jpg,500,376,149.Brown_Thrasher,10,108,419,368,214,238,409,260
../../CUB_200_2011/images\149.Brown_Thrasher/Brown_Thrasher_0019_155216.jpg,500,375,149.Brown_Thrasher,90,121,362,288,226,204,272,167
../../CUB_200_2011/images\149.Brown_Thrasher/Brown_Thrasher_0009_155221.jpg,500,375,149.Brown_Thrasher,123,157,316,285,219,221,193,128
../../CUB_200_2011/images\149.Brown_Thrasher/Brown_Thrasher_0020_155223.jpg,500,440,149.Brown_Thrasher,112,80,363,393,237,236,251,313
../../CUB_200_2011/images\149.Brown_Thrasher/Brown_Thrasher_0065_155229.jpg,357,500,149.Brown_Thrasher,55,97,278,385,166,241,223,288
../../CUB_200_2011/images\149.Brown_Thrasher/Brown_Thrasher_0010_155231.jpg,500,320,149.Brown_Thrasher,60,107,351,257,205,182,291,150
../../CUB_200_2011/images\149.Brown_Thrasher/Brown_Thrasher_0038_155246.jpg,500,340,149.Brown_Thrasher,191,118,395,254,293,186,204,136
../../CUB_200_2011/images\149.Brown_Thrasher/Brown_Thrasher_0052_155254.jpg,500,375,149.Brown_Thrasher,135,97,445,303,290,200,310,206
../../CUB_200_2011/images\149.Brown_Thrasher/Brown_Thrasher_0081_155256.jpg,500,344,149.Brown_Thrasher,126,31,369,328,247,179,243,297
../../CUB_200_2011/images\149.Brown_Thrasher/Brown_Thrasher_0093_155309.jpg,500,333,149.Brown_Thrasher,133,35,488,319,310,177,355,284
../../CUB_200_2011/images\149.Brown_Thrasher/Brown_Thrasher_0121_155320.jpg,500,333,149.Brown_Thrasher,192,76,473,291,332,183,281,215
../../CUB_200_2011/images\149.Brown_Thrasher/Brown_Thrasher_0013_155329.jpg,500,346,149.Brown_Thrasher,37,125,280,289,158,207,243,164
../../CUB_200_2011/images\149.Brown_Thrasher/Brown_Thrasher_0132_155337.jpg,500,364,149.Brown_Thrasher,82,107,272,320,177,213,190,213
../../CUB_200_2011/images\149.Brown_Thrasher/Brown_Thrasher_0074_155339.jpg,500,305,149.Brown_Thrasher,91,88,452,292,271,190,361,204
../../CUB_200_2011/images\149.Brown_Thrasher/Brown_Thrasher_0070_155343.jpg,500,348,149.Brown_Thrasher,166,98,416,310,291,204,250,212
../../CUB_200_2011/images\149.Brown_Thrasher/Brown_Thrasher_0051_155344.jpg,500,375,149.Brown_Thrasher,62,118,422,287,242,202,360,169
../../CUB_200_2011/images\149.Brown_Thrasher/Brown_Thrasher_0130_155350.jpg,500,334,149.Brown_Thrasher,114,85,470,271,292,178,356,186
../../CUB_200_2011/images\149.Brown_Thrasher/Brown_Thrasher_0024_155363.jpg,500,345,149.Brown_Thrasher,43,117,382,262,212,189,339,145
../../CUB_200_2011/images\149.Brown_Thrasher/Brown_Thrasher_0135_155366.jpg,500,331,149.Brown_Thrasher,231,101,442,292,336,196,211,191
../../CUB_200_2011/images\149.Brown_Thrasher/Brown_Thrasher_0011_155370.jpg,500,304,149.Brown_Thrasher,35,52,491,284,263,168,456,232
../../CUB_200_2011/images\149.Brown_Thrasher/Brown_Thrasher_0073_155376.jpg,500,443,149.Brown_Thrasher,37,110,399,359,218,234,362,249
../../CUB_200_2011/images\149.Brown_Thrasher/Brown_Thrasher_0001_155380.jpg,500,357,149.Brown_Thrasher,183,97,352,241,267,169,169,144
../../CUB_200_2011/images\149.Brown_Thrasher/Brown_Thrasher_0079_155394.jpg,500,436,149.Brown_Thrasher,1,55,308,350,154,202,307,295
../../CUB_200_2011/images\149.Brown_Thrasher/Brown_Thrasher_0072_155406.jpg,500,335,149.Brown_Thrasher,162,60,289,276,225,168,127,216
../../CUB_200_2011/images\149.Brown_Thrasher/Brown_Thrasher_0096_155412.jpg,500,401,149.Brown_Thrasher,174,194,462,400,318,297,288,206
../../CUB_200_2011/images\149.Brown_Thrasher/Brown_Thrasher_0092_155415.jpg,400,500,149.Brown_Thrasher,106,76,279,450,192,263,173,374
../../CUB_200_2011/images\149.Brown_Thrasher/Brown_Thrasher_0014_155421.jpg,366,500,149.Brown_Thrasher,62,157,238,422,150,289,176,265
../../CUB_200_2011/images\149.Brown_Thrasher/Brown_Thrasher_0026_155438.jpg,500,420,149.Brown_Thrasher,151,81,428,274,289,177,277,193
../../CUB_200_2011/images\149.Brown_Thrasher/Brown_Thrasher_0085_155445.jpg,500,399,149.Brown_Thrasher,21,85,490,366,255,225,469,281
../../CUB_200_2011/images\149.Brown_Thrasher/Brown_Thrasher_0056_155048.jpg,500,401,149.Brown_Thrasher,102,31,407,376,254,203,305,345
../../CUB_200_2011/images\149.Brown_Thrasher/Brown_Thrasher_0124_155052.jpg,500,333,149.Brown_Thrasher,151,75,474,308,312,191,323,233
../../CUB_200_2011/images\149.Brown_Thrasher/Brown_Thrasher_0095_155082.jpg,397,500,149.Brown_Thrasher,140,158,349,480,244,319,209,322
../../CUB_200_2011/images\149.Brown_Thrasher/Brown_Thrasher_0106_155083.jpg,500,375,149.Brown_Thrasher,90,147,305,270,197,208,215,123
../../CUB_200_2011/images\149.Brown_Thrasher/Brown_Thrasher_0006_155106.jpg,334,500,149.Brown_Thrasher,113,295,232,435,172,365,119,140
../../CUB_200_2011/images\149.Brown_Thrasher/Brown_Thrasher_0049_155110.jpg,500,431,149.Brown_Thrasher,215,59,337,334,276,196,122,275
../../CUB_200_2011/images\149.Brown_Thrasher/Brown_Thrasher_0113_155111.jpg,500,333,149.Brown_Thrasher,71,66,350,306,210,186,279,240
../../CUB_200_2011/images\149.Brown_Thrasher/Brown_Thrasher_0012_155121.jpg,500,332,149.Brown_Thrasher,69,105,326,228,197,166,257,123
../../CUB_200_2011/images\149.Brown_Thrasher/Brown_Thrasher_0063_155127.jpg,500,341,149.Brown_Thrasher,80,84,412,284,246,184,332,200
../../CUB_200_2011/images\149.Brown_Thrasher/Brown_Thrasher_0100_155129.jpg,500,344,149.Brown_Thrasher,217,135,364,247,290,191,147,112
../../CUB_200_2011/images\149.Brown_Thrasher/Brown_Thrasher_0120_155133.jpg,500,333,149.Brown_Thrasher,105,99,430,236,267,167,325,137
../../CUB_200_2011/images\150.Sage_Thrasher/Sage_Thrasher_0097_155564.jpg,500,380,150.Sage_Thrasher,164,60,463,372,313,216,299,312
../../CUB_200_2011/images\150.Sage_Thrasher/Sage_Thrasher_0025_155661.jpg,495,500,150.Sage_Thrasher,56,19,273,339,164,179,217,320
../../CUB_200_2011/images\150.Sage_Thrasher/Sage_Thrasher_0066_155666.jpg,167,204,150.Sage_Thrasher,29,30,158,171,93,100,129,141
../../CUB_200_2011/images\150.Sage_Thrasher/Sage_Thrasher_0040_155667.jpg,483,500,150.Sage_Thrasher,105,55,407,407,256,231,302,352
../../CUB_200_2011/images\150.Sage_Thrasher/Sage_Thrasher_0018_796443.jpg,275,275,150.Sage_Thrasher,62,36,265,238,163,137,203,202
../../CUB_200_2011/images\150.Sage_Thrasher/Sage_Thrasher_0036_796444.jpg,500,401,150.Sage_Thrasher,165,80,469,364,317,222,304,284
../../CUB_200_2011/images\150.Sage_Thrasher/Sage_Thrasher_0076_796445.jpg,500,375,150.Sage_Thrasher,125,81,452,316,288,198,327,235
../../CUB_200_2011/images\150.Sage_Thrasher/Sage_Thrasher_0095_796446.jpg,500,333,150.Sage_Thrasher,132,25,362,332,247,178,230,307
../../CUB_200_2011/images\150.Sage_Thrasher/Sage_Thrasher_0098_796448.jpg,350,328,150.Sage_Thrasher,88,69,258,259,173,164,170,190
../../CUB_200_2011/images\150.Sage_Thrasher/Sage_Thrasher_0039_796449.jpg,500,290,150.Sage_Thrasher,143,59,308,218,225,138,165,159
../../CUB_200_2011/images\150.Sage_Thrasher/Sage_Thrasher_0083_796450.jpg,370,461,150.Sage_Thrasher,38,46,343,400,190,223,305,354
../../CUB_200_2011/images\150.Sage_Thrasher/Sage_Thrasher_0031_796455.jpg,424,450,150.Sage_Thrasher,27,28,408,425,217,226,381,397
../../CUB_200_2011/images\150.Sage_Thrasher/Sage_Thrasher_0056_796457.jpg,440,439,150.Sage_Thrasher,126,30,401,402,263,216,275,372
../../CUB_200_2011/images\150.Sage_Thrasher/Sage_Thrasher_0029_796459.jpg,400,500,150.Sage_Thrasher,62,173,359,409,210,291,297,236
../../CUB_200_2011/images\150.Sage_Thrasher/Sage_Thrasher_0062_796462.jpg,500,333,150.Sage_Thrasher,30,52,327,295,178,173,297,243
../../CUB_200_2011/images\150.Sage_Thrasher/Sage_Thrasher_0024_796463.jpg,500,333,150.Sage_Thrasher,23,95,392,298,207,196,369,203
../../CUB_200_2011/images\150.Sage_Thrasher/Sage_Thrasher_0003_155479.jpg,500,333,150.Sage_Thrasher,217,106,319,271,268,188,102,165
../../CUB_200_2011/images\150.Sage_Thrasher/Sage_Thrasher_0022_155447.jpg,500,337,150.Sage_Thrasher,69,61,496,313,282,187,427,252
../../CUB_200_2011/images\150.Sage_Thrasher/Sage_Thrasher_0045_155448.jpg,499,500,150.Sage_Thrasher,121,56,443,447,282,251,322,391
../../CUB_200_2011/images\150.Sage_Thrasher/Sage_Thrasher_0096_155449.jpg,500,395,150.Sage_Thrasher,129,93,442,298,285,195,313,205
../../CUB_200_2011/images\150.Sage_Thrasher/Sage_Thrasher_0068_155452.jpg,500,333,150.Sage_Thrasher,27,83,334,322,180,202,307,239
../../CUB_200_2011/images\150.Sage_Thrasher/Sage_Thrasher_0002_155455.jpg,500,400,150.Sage_Thrasher,164,49,485,335,324,192,321,286
../../CUB_200_2011/images\150.Sage_Thrasher/Sage_Thrasher_0090_155713.jpg,353,500,150.Sage_Thrasher,19,82,306,417,162,249,287,335
../../CUB_200_2011/images\150.Sage_Thrasher/Sage_Thrasher_0079_155718.jpg,500,375,150.Sage_Thrasher,66,10,285,288,175,149,219,278
../../CUB_200_2011/images\150.Sage_Thrasher/Sage_Thrasher_0051_155464.jpg,500,400,150.Sage_Thrasher,64,104,260,339,162,221,196,235
../../CUB_200_2011/images\150.Sage_Thrasher/Sage_Thrasher_0055_155467.jpg,500,333,150.Sage_Thrasher,135,91,321,253,228,172,186,162
../../CUB_200_2011/images\150.Sage_Thrasher/Sage_Thrasher_0081_155724.jpg,327,500,150.Sage_Thrasher,74,122,294,465,184,293,220,343
../../CUB_200_2011/images\150.Sage_Thrasher/Sage_Thrasher_0060_155728.jpg,333,500,150.Sage_Thrasher,45,103,268,360,156,231,223,257
../../CUB_200_2011/images\150.Sage_Thrasher/Sage_Thrasher_0050_155475.jpg,472,500,150.Sage_Thrasher,127,108,471,490,299,299,344,382
../../CUB_200_2011/images\150.Sage_Thrasher/Sage_Thrasher_0070_155732.jpg,334,500,150.Sage_Thrasher,56,211,167,443,111,327,111,232
../../CUB_200_2011/images\150.Sage_Thrasher/Sage_Thrasher_0006_155478.jpg,500,334,150.Sage_Thrasher,82,27,368,282,225,154,286,255
../../CUB_200_2011/images\150.Sage_Thrasher/Sage_Thrasher_0092_155482.jpg,500,358,150.Sage_Thrasher,231,111,393,302,312,206,162,191
../../CUB_200_2011/images\150.Sage_Thrasher/Sage_Thrasher_0057_155488.jpg,500,375,150.Sage_Thrasher,117,72,421,325,269,198,304,253
../../CUB_200_2011/images\150.Sage_Thrasher/Sage_Thrasher_0084_155490.jpg,500,335,150.Sage_Thrasher,75,97,300,275,187,186,225,178
../../CUB_200_2011/images\150.Sage_Thrasher/Sage_Thrasher_0038_155498.jpg,500,375,150.Sage_Thrasher,214,64,376,304,295,184,162,240
../../CUB_200_2011/images\150.Sage_Thrasher/Sage_Thrasher_0093_155501.jpg,500,333,150.Sage_Thrasher,70,35,359,325,214,180,289,290
../../CUB_200_2011/images\150.Sage_Thrasher/Sage_Thrasher_0033_155511.jpg,500,487,150.Sage_Thrasher,1,47,405,452,203,249,404,405
../../CUB_200_2011/images\150.Sage_Thrasher/Sage_Thrasher_0075_155527.jpg,500,400,150.Sage_Thrasher,102,71,266,336,184,203,164,265
../../CUB_200_2011/images\150.Sage_Thrasher/Sage_Thrasher_0104_155529.jpg,500,405,150.Sage_Thrasher,176,104,476,329,326,216,300,225
../../CUB_200_2011/images\150.Sage_Thrasher/Sage_Thrasher_0064_155531.jpg,500,375,150.Sage_Thrasher,115,117,342,288,228,202,227,171
../../CUB_200_2011/images\150.Sage_Thrasher/Sage_Thrasher_0072_155539.jpg,500,375,150.Sage_Thrasher,128,43,395,355,261,199,267,312
../../CUB_200_2011/images\150.Sage_Thrasher/Sage_Thrasher_0014_155541.jpg,500,317,150.Sage_Thrasher,174,70,389,234,281,152,215,164
../../CUB_200_2011/images\150.Sage_Thrasher/Sage_Thrasher_0069_155544.jpg,500,375,150.Sage_Thrasher,108,112,300,280,204,196,192,168
../../CUB_200_2011/images\150.Sage_Thrasher/Sage_Thrasher_0021_155548.jpg,500,357,150.Sage_Thrasher,91,29,486,341,288,185,395,312
../../CUB_200_2011/images\150.Sage_Thrasher/Sage_Thrasher_0061_155462.jpg,500,333,150.Sage_Thrasher,88,87,301,281,194,184,213,194
../../CUB_200_2011/images\150.Sage_Thrasher/Sage_Thrasher_0085_155562.jpg,375,500,150.Sage_Thrasher,150,132,266,324,208,228,116,192
../../CUB_200_2011/images\150.Sage_Thrasher/Sage_Thrasher_0009_155463.jpg,500,399,150.Sage_Thrasher,25,72,392,314,208,193,367,242
../../CUB_200_2011/images\150.Sage_Thrasher/Sage_Thrasher_0019_107436.jpg,333,500,150.Sage_Thrasher,70,109,296,356,183,232,226,247
../../CUB_200_2011/images\150.Sage_Thrasher/Sage_Thrasher_0016_155566.jpg,500,433,150.Sage_Thrasher,141,88,459,357,300,222,318,269
../../CUB_200_2011/images\150.Sage_Thrasher/Sage_Thrasher_0005_155569.jpg,411,500,150.Sage_Thrasher,88,147,270,349,179,248,182,202
../../CUB_200_2011/images\150.Sage_Thrasher/Sage_Thrasher_0043_155574.jpg,500,475,150.Sage_Thrasher,84,103,431,405,257,254,347,302
../../CUB_200_2011/images\150.Sage_Thrasher/Sage_Thrasher_0103_155575.jpg,500,330,150.Sage_Thrasher,12,61,330,263,171,162,318,202
../../CUB_200_2011/images\150.Sage_Thrasher/Sage_Thrasher_0052_155605.jpg,355,266,150.Sage_Thrasher,130,68,318,218,224,143,188,150
../../CUB_200_2011/images\150.Sage_Thrasher/Sage_Thrasher_0077_155608.jpg,500,353,150.Sage_Thrasher,259,57,461,310,360,183,202,253
../../CUB_200_2011/images\150.Sage_Thrasher/Sage_Thrasher_0044_155610.jpg,500,274,150.Sage_Thrasher,70,91,331,238,200,164,261,147
../../CUB_200_2011/images\150.Sage_Thrasher/Sage_Thrasher_0073_155614.jpg,400,500,150.Sage_Thrasher,141,102,288,346,214,224,147,244
../../CUB_200_2011/images\150.Sage_Thrasher/Sage_Thrasher_0106_155618.jpg,500,426,150.Sage_Thrasher,119,76,394,367,256,221,275,291
../../CUB_200_2011/images\150.Sage_Thrasher/Sage_Thrasher_0071_155642.jpg,500,375,150.Sage_Thrasher,37,74,383,359,210,216,346,285
../../CUB_200_2011/images\150.Sage_Thrasher/Sage_Thrasher_0023_796458.jpg,500,333,150.Sage_Thrasher,2,49,420,300,211,174,418,251
../../CUB_200_2011/images\150.Sage_Thrasher/Sage_Thrasher_0026_155646.jpg,500,333,150.Sage_Thrasher,10,67,412,301,211,184,402,234
../../CUB_200_2011/images\151.Black_capped_Vireo/Black_Capped_Vireo_0024_155905.jpg,500,375,151.Black_capped_Vireo,93,105,384,374,238,239,291,269
../../CUB_200_2011/images\151.Black_capped_Vireo/Black_Capped_Vireo_0044_155819.jpg,500,326,151.Black_capped_Vireo,239,93,407,267,323,180,168,174
../../CUB_200_2011/images\151.Black_capped_Vireo/Black_Capped_Vireo_0031_797446.jpg,350,350,151.Black_capped_Vireo,36,74,326,256,181,165,290,182
../../CUB_200_2011/images\151.Black_capped_Vireo/Black_Capped_Vireo_0034_797448.jpg,500,348,151.Black_capped_Vireo,131,50,479,249,305,149,348,199
../../CUB_200_2011/images\151.Black_capped_Vireo/Black_Capped_Vireo_0048_797449.jpg,333,430,151.Black_capped_Vireo,60,43,281,331,170,187,221,288
../../CUB_200_2011/images\151.Black_capped_Vireo/Black_Capped_Vireo_0015_797450.jpg,500,334,151.Black_capped_Vireo,210,72,398,332,304,202,188,260
../../CUB_200_2011/images\151.Black_capped_Vireo/Black_Capped_Vireo_0039_797451.jpg,500,409,151.Black_capped_Vireo,75,43,494,406,284,224,419,363
../../CUB_200_2011/images\151.Black_capped_Vireo/Black_Capped_Vireo_0041_797452.jpg,500,343,151.Black_capped_Vireo,84,88,337,280,210,184,253,192
../../CUB_200_2011/images\151.Black_capped_Vireo/Black_Capped_Vireo_0005_797453.jpg,500,356,151.Black_capped_Vireo,117,40,446,315,281,177,329,275
../../CUB_200_2011/images\151.Black_capped_Vireo/Black_Capped_Vireo_0008_797454.jpg,500,371,151.Black_capped_Vireo,103,64,397,260,250,162,294,196
../../CUB_200_2011/images\151.Black_capped_Vireo/Black_Capped_Vireo_0027_797455.jpg,350,339,151.Black_capped_Vireo,96,100,256,246,176,173,160,146
../../CUB_200_2011/images\151.Black_capped_Vireo/Black_Capped_Vireo_0051_797456.jpg,248,244,151.Black_capped_Vireo,14,4,225,163,119,83,211,159
../../CUB_200_2011/images\151.Black_capped_Vireo/Black_Capped_Vireo_0043_797458.jpg,180,270,151.Black_capped_Vireo,0,55,159,232,79,143,159,177
../../CUB_200_2011/images\151.Black_capped_Vireo/Black_Capped_Vireo_0022_797459.jpg,480,384,151.Black_capped_Vireo,56,75,386,295,221,185,330,220
../../CUB_200_2011/images\151.Black_capped_Vireo/Black_Capped_Vireo_0020_797461.jpg,500,331,151.Black_capped_Vireo,148,71,268,319,208,195,120,248
../../CUB_200_2011/images\151.Black_capped_Vireo/Black_Capped_Vireo_0014_797462.jpg,500,385,151.Black_capped_Vireo,105,117,480,263,292,190,375,146
../../CUB_200_2011/images\151.Black_capped_Vireo/Black_Capped_Vireo_0028_155799.jpg,500,375,151.Black_capped_Vireo,82,110,295,248,188,179,213,138
../../CUB_200_2011/images\151.Black_capped_Vireo/Black_Capped_Vireo_0045_797464.jpg,500,387,151.Black_capped_Vireo,127,59,353,304,240,181,226,245
../../CUB_200_2011/images\151.Black_capped_Vireo/Black_Capped_Vireo_0038_797465.jpg,480,384,151.Black_capped_Vireo,41,64,375,311,208,187,334,247
../../CUB_200_2011/images\151.Black_capped_Vireo/Black_Capped_Vireo_0002_797466.jpg,500,428,151.Black_capped_Vireo,73,41,499,394,286,217,426,353
../../CUB_200_2011/images\151.Black_capped_Vireo/Black_Capped_Vireo_0003_797467.jpg,500,292,151.Black_capped_Vireo,13,43,475,243,244,143,462,200
../../CUB_200_2011/images\151.Black_capped_Vireo/Black_Capped_Vireo_0049_797468.jpg,500,484,151.Black_capped_Vireo,67,84,258,381,162,232,191,297
../../CUB_200_2011/images\151.Black_capped_Vireo/Black_Capped_Vireo_0029_797469.jpg,360,268,151.Black_capped_Vireo,42,42,252,237,147,139,210,195
../../CUB_200_2011/images\151.Black_capped_Vireo/Black_Capped_Vireo_0032_797470.jpg,500,333,151.Black_capped_Vireo,173,96,309,314,241,205,136,218
../../CUB_200_2011/images\151.Black_capped_Vireo/Black_Capped_Vireo_0035_797471.jpg,350,334,151.Black_capped_Vireo,137,110,238,222,187,166,101,112
../../CUB_200_2011/images\151.Black_capped_Vireo/Black_Capped_Vireo_0012_797473.jpg,197,139,151.Black_capped_Vireo,10,10,195,139,102,74,185,129
../../CUB_200_2011/images\151.Black_capped_Vireo/Black_Capped_Vireo_0033_797474.jpg,500,410,151.Black_capped_Vireo,201,94,322,308,261,201,121,214
../../CUB_200_2011/images\151.Black_capped_Vireo/Black_Capped_Vireo_0036_797475.jpg,400,288,151.Black_capped_Vireo,137,104,281,256,209,180,144,152
../../CUB_200_2011/images\151.Black_capped_Vireo/Black_Capped_Vireo_0004_797476.jpg,230,183,151.Black_capped_Vireo,82,29,195,170,138,99,113,141
../../CUB_200_2011/images\151.Black_capped_Vireo/Black_Capped_Vireo_0053_797478.jpg,280,146,151.Black_capped_Vireo,2,6,276,142,139,74,274,136
../../CUB_200_2011/images\151.Black_capped_Vireo/Black_Capped_Vireo_0013_155815.jpg,500,413,151.Black_capped_Vireo,217,126,329,327,273,226,112,201
../../CUB_200_2011/images\151.Black_capped_Vireo/Black_Capped_Vireo_0021_797480.jpg,500,333,151.Black_capped_Vireo,113,84,346,212,229,148,233,128
../../CUB_200_2011/images\151.Black_capped_Vireo/Black_Capped_Vireo_0007_797481.jpg,500,371,151.Black_capped_Vireo,111,79,489,338,300,208,378,259
../../CUB_200_2011/images\151.Black_capped_Vireo/Black_Capped_Vireo_0042_797483.jpg,500,375,151.Black_capped_Vireo,185,95,407,256,296,175,222,161
../../CUB_200_2011/images\151.Black_capped_Vireo/Black_Capped_Vireo_0023_797486.jpg,350,239,151.Black_capped_Vireo,39,58,244,203,141,130,205,145
../../CUB_200_2011/images\151.Black_capped_Vireo/Black_Capped_Vireo_0052_797487.jpg,500,387,151.Black_capped_Vireo,154,112,423,356,288,234,269,244
../../CUB_200_2011/images\151.Black_capped_Vireo/Black_Capped_Vireo_0011_797488.jpg,500,348,151.Black_capped_Vireo,53,99,404,300,228,199,351,201
../../CUB_200_2011/images\151.Black_capped_Vireo/Black_Capped_Vireo_0016_797489.jpg,500,356,151.Black_capped_Vireo,30,127,438,339,234,233,408,212
../../CUB_200_2011/images\151.Black_capped_Vireo/Black_Capped_Vireo_0006_797491.jpg,500,357,151.Black_capped_Vireo,156,71,281,308,218,189,125,237
../../CUB_200_2011/images\151.Black_capped_Vireo/Black_Capped_Vireo_0017_797492.jpg,450,338,151.Black_capped_Vireo,83,71,309,257,196,164,226,186
../../CUB_200_2011/images\151.Black_capped_Vireo/Black_Capped_Vireo_0009_797493.jpg,500,333,151.Black_capped_Vireo,155,29,283,257,219,143,128,228
../../CUB_200_2011/images\151.Black_capped_Vireo/Black_Capped_Vireo_0046_797494.jpg,500,500,151.Black_capped_Vireo,67,175,476,360,271,267,409,185
../../CUB_200_2011/images\151.Black_capped_Vireo/Black_Capped_Vireo_0037_797495.jpg,500,350,151.Black_capped_Vireo,147,73,449,269,298,171,302,196
../../CUB_200_2011/images\151.Black_capped_Vireo/Black_Capped_Vireo_0010_155832.jpg,482,500,151.Black_capped_Vireo,172,173,315,360,243,266,143,187
../../CUB_200_2011/images\151.Black_capped_Vireo/Black_Capped_Vireo_0050_155836.jpg,500,378,151.Black_capped_Vireo,206,126,306,270,256,198,100,144
../../CUB_200_2011/images\151.Black_capped_Vireo/Black_Capped_Vireo_0030_155861.jpg,500,500,151.Black_capped_Vireo,132,120,351,364,241,242,219,244
../../CUB_200_2011/images\151.Black_capped_Vireo/Black_Capped_Vireo_0040_797463.jpg,250,170,151.Black_capped_Vireo,26,33,182,160,104,96,156,127
../../CUB_200_2011/images\151.Black_capped_Vireo/Black_Capped_Vireo_0018_155868.jpg,400,370,151.Black_capped_Vireo,55,7,387,352,221,179,332,345
../../CUB_200_2011/images\151.Black_capped_Vireo/Black_Capped_Vireo_0047_155743.jpg,500,347,151.Black_capped_Vireo,49,81,270,259,159,170,221,178
../../CUB_200_2011/images\151.Black_capped_Vireo/Black_Capped_Vireo_0026_155745.jpg,500,375,151.Black_capped_Vireo,190,163,336,268,263,215,146,105
../../CUB_200_2011/images\151.Black_capped_Vireo/Black_Capped_Vireo_0019_797479.jpg,500,331,151.Black_capped_Vireo,134,49,477,304,305,176,343,255
../../CUB_200_2011/images\152.Blue_headed_Vireo/Blue_Headed_Vireo_0088_156416.jpg,500,500,152.Blue_headed_Vireo,60,126,421,434,240,280,361,308
../../CUB_200_2011/images\152.Blue_headed_Vireo/Blue_Headed_Vireo_0060_156171.jpg,357,500,152.Blue_headed_Vireo,0,76,343,446,171,261,343,370
../../CUB_200_2011/images\152.Blue_headed_Vireo/Blue_Headed_Vireo_0012_156434.jpg,500,394,152.Blue_headed_Vireo,139,139,395,287,267,213,256,148
../../CUB_200_2011/images\152.Blue_headed_Vireo/Blue_Headed_Vireo_0075_156181.jpg,500,333,152.Blue_headed_Vireo,130,49,472,300,301,174,342,251
../../CUB_200_2011/images\152.Blue_headed_Vireo/Blue_Headed_Vireo_0025_156439.jpg,388,500,152.Blue_headed_Vireo,51,174,236,455,143,314,185,281
../../CUB_200_2011/images\152.Blue_headed_Vireo/Blue_Headed_Vireo_0022_156184.jpg,500,348,152.Blue_headed_Vireo,55,78,392,276,223,177,337,198
../../CUB_200_2011/images\152.Blue_headed_Vireo/Blue_Headed_Vireo_0123_156443.jpg,335,500,152.Blue_headed_Vireo,59,168,185,283,122,225,126,115
../../CUB_200_2011/images\152.Blue_headed_Vireo/Blue_Headed_Vireo_0020_155994.jpg,500,350,152.Blue_headed_Vireo,128,128,277,266,202,197,149,138
../../CUB_200_2011/images\152.Blue_headed_Vireo/Blue_Headed_Vireo_0091_155934.jpg,500,333,152.Blue_headed_Vireo,216,161,316,264,266,212,100,103
../../CUB_200_2011/images\152.Blue_headed_Vireo/Blue_Headed_Vireo_0118_156193.jpg,500,500,152.Blue_headed_Vireo,125,98,396,394,260,246,271,296
../../CUB_200_2011/images\152.Blue_headed_Vireo/Blue_Headed_Vireo_0112_156196.jpg,334,500,152.Blue_headed_Vireo,38,201,263,390,150,295,225,189
../../CUB_200_2011/images\152.Blue_headed_Vireo/Blue_Headed_Vireo_0054_156455.jpg,500,333,152.Blue_headed_Vireo,179,69,399,294,289,181,220,225
../../CUB_200_2011/images\152.Blue_headed_Vireo/Blue_Headed_Vireo_0101_156203.jpg,500,377,152.Blue_headed_Vireo,11,97,342,366,176,231,331,269
../../CUB_200_2011/images\152.Blue_headed_Vireo/Blue_Headed_Vireo_0087_156461.jpg,500,334,152.Blue_headed_Vireo,82,91,266,310,174,200,184,219
../../CUB_200_2011/images\152.Blue_headed_Vireo/Blue_Headed_Vireo_0008_155950.jpg,500,351,152.Blue_headed_Vireo,35,70,360,294,197,182,325,224
../../CUB_200_2011/images\152.Blue_headed_Vireo/Blue_Headed_Vireo_0110_155952.jpg,461,500,152.Blue_headed_Vireo,106,112,379,405,242,258,273,293
../../CUB_200_2011/images\152.Blue_headed_Vireo/Blue_Headed_Vireo_0076_156209.jpg,500,333,152.Blue_headed_Vireo,193,83,437,325,315,204,244,242
../../CUB_200_2011/images\152.Blue_headed_Vireo/Blue_Headed_Vireo_0037_155955.jpg,500,312,152.Blue_headed_Vireo,113,54,471,253,292,153,358,199
../../CUB_200_2011/images\152.Blue_headed_Vireo/Blue_Headed_Vireo_0028_156217.jpg,500,331,152.Blue_headed_Vireo,146,92,388,216,267,154,242,124
../../CUB_200_2011/images\152.Blue_headed_Vireo/Blue_Headed_Vireo_0082_155965.jpg,500,373,152.Blue_headed_Vireo,142,132,339,336,240,234,197,204
../../CUB_200_2011/images\152.Blue_headed_Vireo/Blue_Headed_Vireo_0068_156222.jpg,500,441,152.Blue_headed_Vireo,145,130,351,352,248,241,206,222
../../CUB_200_2011/images\152.Blue_headed_Vireo/Blue_Headed_Vireo_0105_156229.jpg,375,500,152.Blue_headed_Vireo,102,163,324,432,213,297,222,269
../../CUB_200_2011/images\152.Blue_headed_Vireo/Blue_Headed_Vireo_0121_156233.jpg,500,334,152.Blue_headed_Vireo,276,102,472,219,374,160,196,117
../../CUB_200_2011/images\152.Blue_headed_Vireo/Blue_Headed_Vireo_0032_156239.jpg,500,333,152.Blue_headed_Vireo,195,115,474,302,334,208,279,187
../../CUB_200_2011/images\152.Blue_headed_Vireo/Blue_Headed_Vireo_0002_156241.jpg,500,401,152.Blue_headed_Vireo,74,121,488,318,281,219,414,197
../../CUB_200_2011/images\152.Blue_headed_Vireo/Blue_Headed_Vireo_0072_155987.jpg,500,333,152.Blue_headed_Vireo,198,95,476,292,337,193,278,197
../../CUB_200_2011/images\152.Blue_headed_Vireo/Blue_Headed_Vireo_0086_156244.jpg,500,382,152.Blue_headed_Vireo,265,94,425,279,345,186,160,185
../../CUB_200_2011/images\152.Blue_headed_Vireo/Blue_Headed_Vireo_0026_156245.jpg,500,466,152.Blue_headed_Vireo,120,238,354,443,237,340,234,205
../../CUB_200_2011/images\152.Blue_headed_Vireo/Blue_Headed_Vireo_0055_156247.jpg,500,333,152.Blue_headed_Vireo,150,97,371,249,260,173,221,152
../../CUB_200_2011/images\152.Blue_headed_Vireo/Blue_Headed_Vireo_0034_156251.jpg,500,400,152.Blue_headed_Vireo,268,135,413,365,340,250,145,230
../../CUB_200_2011/images\152.Blue_headed_Vireo/Blue_Headed_Vireo_0117_156026.jpg,500,333,152.Blue_headed_Vireo,86,53,394,252,240,152,308,199
../../CUB_200_2011/images\152.Blue_headed_Vireo/Blue_Headed_Vireo_0027_155999.jpg,500,352,152.Blue_headed_Vireo,113,93,387,253,250,173,274,160
../../CUB_200_2011/images\152.Blue_headed_Vireo/Blue_Headed_Vireo_0111_156258.jpg,500,326,152.Blue_headed_Vireo,263,95,463,249,363,172,200,154
../../CUB_200_2011/images\152.Blue_headed_Vireo/Blue_Headed_Vireo_0119_156259.jpg,442,500,152.Blue_headed_Vireo,39,145,297,397,168,271,258,252
../../CUB_200_2011/images\152.Blue_headed_Vireo/Blue_Headed_Vireo_0065_156260.jpg,333,500,152.Blue_headed_Vireo,29,121,169,352,99,236,140,231
../../CUB_200_2011/images\152.Blue_headed_Vireo/Blue_Headed_Vireo_0058_156261.jpg,500,320,152.Blue_headed_Vireo,61,75,321,223,191,149,260,148
../../CUB_200_2011/images\152.Blue_headed_Vireo/Blue_Headed_Vireo_0005_156007.jpg,500,357,152.Blue_headed_Vireo,71,64,299,302,185,183,228,238
../../CUB_200_2011/images\152.Blue_headed_Vireo/Blue_Headed_Vireo_0095_156092.jpg,500,391,152.Blue_headed_Vireo,251,127,411,320,331,223,160,193
../../CUB_200_2011/images\152.Blue_headed_Vireo/Blue_Headed_Vireo_0097_156272.jpg,453,500,152.Blue_headed_Vireo,159,145,294,324,226,234,135,179
../../CUB_200_2011/images\152.Blue_headed_Vireo/Blue_Headed_Vireo_0122_156017.jpg,500,375,152.Blue_headed_Vireo,267,169,425,330,346,249,158,161
../../CUB_200_2011/images\152.Blue_headed_Vireo/Blue_Headed_Vireo_0011_156276.jpg,500,288,152.Blue_headed_Vireo,96,73,349,214,222,143,253,141
../../CUB_200_2011/images\152.Blue_headed_Vireo/Blue_Headed_Vireo_0096_155969.jpg,500,416,152.Blue_headed_Vireo,45,90,387,319,216,204,342,229
../../CUB_200_2011/images\152.Blue_headed_Vireo/Blue_Headed_Vireo_0019_156311.jpg,400,500,152.Blue_headed_Vireo,123,90,317,404,220,247,194,314
../../CUB_200_2011/images\152.Blue_headed_Vireo/Blue_Headed_Vireo_0031_156056.jpg,357,500,152.Blue_headed_Vireo,75,139,317,458,196,298,242,319
../../CUB_200_2011/images\152.Blue_headed_Vireo/Blue_Headed_Vireo_0089_156062.jpg,500,445,152.Blue_headed_Vireo,113,102,355,394,234,248,242,292
../../CUB_200_2011/images\152.Blue_headed_Vireo/Blue_Headed_Vireo_0017_156063.jpg,500,333,152.Blue_headed_Vireo,55,101,364,268,209,184,309,167
../../CUB_200_2011/images\152.Blue_headed_Vireo/Blue_Headed_Vireo_0113_156332.jpg,500,500,152.Blue_headed_Vireo,107,246,315,388,211,317,208,142
../../CUB_200_2011/images\152.Blue_headed_Vireo/Blue_Headed_Vireo_0044_156080.jpg,500,333,152.Blue_headed_Vireo,27,89,401,293,214,191,374,204
../../CUB_200_2011/images\152.Blue_headed_Vireo/Blue_Headed_Vireo_0049_156082.jpg,393,500,152.Blue_headed_Vireo,89,79,270,295,179,187,181,216
../../CUB_200_2011/images\152.Blue_headed_Vireo/Blue_Headed_Vireo_0079_156086.jpg,500,375,152.Blue_headed_Vireo,119,96,393,342,256,219,274,246
../../CUB_200_2011/images\152.Blue_headed_Vireo/Blue_Headed_Vireo_0010_156344.jpg,300,238,152.Blue_headed_Vireo,14,13,266,223,140,118,252,210
../../CUB_200_2011/images\152.Blue_headed_Vireo/Blue_Headed_Vireo_0098_156348.jpg,500,361,152.Blue_headed_Vireo,128,98,244,250,186,174,116,152
../../CUB_200_2011/images\152.Blue_headed_Vireo/Blue_Headed_Vireo_0115_156099.jpg,500,334,152.Blue_headed_Vireo,150,65,481,296,315,180,331,231
../../CUB_200_2011/images\152.Blue_headed_Vireo/Blue_Headed_Vireo_0009_155953.jpg,500,500,152.Blue_headed_Vireo,83,139,336,359,209,249,253,220
../../CUB_200_2011/images\152.Blue_headed_Vireo/Blue_Headed_Vireo_0062_156109.jpg,500,386,152.Blue_headed_Vireo,174,142,366,267,270,204,192,125
../../CUB_200_2011/images\152.Blue_headed_Vireo/Blue_Headed_Vireo_0023_156112.jpg,500,359,152.Blue_headed_Vireo,178,125,401,236,289,180,223,111
../../CUB_200_2011/images\152.Blue_headed_Vireo/Blue_Headed_Vireo_0107_156111.jpg,500,333,152.Blue_headed_Vireo,48,57,379,305,213,181,331,248
../../CUB_200_2011/images\152.Blue_headed_Vireo/Blue_Headed_Vireo_0103_156382.jpg,500,400,152.Blue_headed_Vireo,182,87,371,296,276,191,189,209
../../CUB_200_2011/images\152.Blue_headed_Vireo/Blue_Headed_Vireo_0116_156049.jpg,500,338,152.Blue_headed_Vireo,185,82,314,191,249,136,129,109
../../CUB_200_2011/images\152.Blue_headed_Vireo/Blue_Headed_Vireo_0039_156397.jpg,500,500,152.Blue_headed_Vireo,167,49,405,382,286,215,238,333
../../CUB_200_2011/images\153.Philadelphia_Vireo/Philadelphia_Vireo_0044_156548.jpg,500,333,153.Philadelphia_Vireo,126,56,283,297,204,176,157,241
../../CUB_200_2011/images\153.Philadelphia_Vireo/Philadelphia_Vireo_0002_156591.jpg,500,274,153.Philadelphia_Vireo,47,78,343,254,195,166,296,176
../../CUB_200_2011/images\153.Philadelphia_Vireo/Philadelphia_Vireo_0008_156551.jpg,391,500,153.Philadelphia_Vireo,82,121,371,440,226,280,289,319
../../CUB_200_2011/images\153.Philadelphia_Vireo/Philadelphia_Vireo_0060_156555.jpg,500,339,153.Philadelphia_Vireo,40,71,288,285,164,178,248,214
../../CUB_200_2011/images\153.Philadelphia_Vireo/Philadelphia_Vireo_0074_156492.jpg,500,327,153.Philadelphia_Vireo,78,39,472,305,275,172,394,266
../../CUB_200_2011/images\153.Philadelphia_Vireo/Philadelphia_Vireo_0056_156502.jpg,500,333,153.Philadelphia_Vireo,162,87,406,295,284,191,244,208
../../CUB_200_2011/images\153.Philadelphia_Vireo/Philadelphia_Vireo_0028_156510.jpg,500,333,153.Philadelphia_Vireo,73,83,438,241,255,162,365,158
../../CUB_200_2011/images\153.Philadelphia_Vireo/Philadelphia_Vireo_0047_156521.jpg,500,331,153.Philadelphia_Vireo,168,55,456,297,312,176,288,242
../../CUB_200_2011/images\153.Philadelphia_Vireo/Philadelphia_Vireo_0057_156525.jpg,500,357,153.Philadelphia_Vireo,135,103,301,286,218,194,166,183
../../CUB_200_2011/images\153.Philadelphia_Vireo/Philadelphia_Vireo_0042_156528.jpg,500,375,153.Philadelphia_Vireo,210,135,360,261,285,198,150,126
../../CUB_200_2011/images\153.Philadelphia_Vireo/Philadelphia_Vireo_0030_156533.jpg,500,410,153.Philadelphia_Vireo,76,103,450,321,263,212,374,218
../../CUB_200_2011/images\153.Philadelphia_Vireo/Philadelphia_Vireo_0050_156538.jpg,500,399,153.Philadelphia_Vireo,107,95,399,303,253,199,292,208
../../CUB_200_2011/images\153.Philadelphia_Vireo/Philadelphia_Vireo_0022_156546.jpg,500,500,153.Philadelphia_Vireo,66,137,373,382,219,259,307,245
../../CUB_200_2011/images\153.Philadelphia_Vireo/Philadelphia_Vireo_0049_794756.jpg,411,395,153.Philadelphia_Vireo,25,2,402,391,213,196,377,389
../../CUB_200_2011/images\153.Philadelphia_Vireo/Philadelphia_Vireo_0085_794757.jpg,500,375,153.Philadelphia_Vireo,162,133,347,337,254,235,185,204
../../CUB_200_2011/images\153.Philadelphia_Vireo/Philadelphia_Vireo_0070_794758.jpg,457,312,153.Philadelphia_Vireo,32,36,440,246,236,141,408,210
../../CUB_200_2011/images\153.Philadelphia_Vireo/Philadelphia_Vireo_0038_794759.jpg,230,159,153.Philadelphia_Vireo,62,11,210,154,136,82,148,143
../../CUB_200_2011/images\153.Philadelphia_Vireo/Philadelphia_Vireo_0029_794760.jpg,500,357,153.Philadelphia_Vireo,20,14,480,272,250,143,460,258
../../CUB_200_2011/images\153.Philadelphia_Vireo/Philadelphia_Vireo_0083_794761.jpg,500,500,153.Philadelphia_Vireo,143,149,378,337,260,243,235,188
../../CUB_200_2011/images\153.Philadelphia_Vireo/Philadelphia_Vireo_0001_156554.jpg,500,401,153.Philadelphia_Vireo,33,99,427,310,230,204,394,211
../../CUB_200_2011/images\153.Philadelphia_Vireo/Philadelphia_Vireo_0068_794763.jpg,400,261,153.Philadelphia_Vireo,104,50,344,226,224,138,240,176
../../CUB_200_2011/images\153.Philadelphia_Vireo/Philadelphia_Vireo_0040_794764.jpg,369,500,153.Philadelphia_Vireo,98,84,207,404,152,244,109,320
../../CUB_200_2011/images\153.Philadelphia_Vireo/Philadelphia_Vireo_0021_794765.jpg,340,334,153.Philadelphia_Vireo,57,72,298,247,177,159,241,175
../../CUB_200_2011/images\153.Philadelphia_Vireo/Philadelphia_Vireo_0034_794766.jpg,500,333,153.Philadelphia_Vireo,46,22,396,312,221,167,350,290
../../CUB_200_2011/images\153.Philadelphia_Vireo/Philadelphia_Vireo_0087_794767.jpg,400,290,153.Philadelphia_Vireo,113,43,354,225,233,134,241,182
../../CUB_200_2011/images\153.Philadelphia_Vireo/Philadelphia_Vireo_0010_794769.jpg,500,333,153.Philadelphia_Vireo,66,70,396,263,231,166,330,193
../../CUB_200_2011/images\153.Philadelphia_Vireo/Philadelphia_Vireo_0037_794770.jpg,489,500,153.Philadelphia_Vireo,9,15,470,494,239,254,461,479
../../CUB_200_2011/images\153.Philadelphia_Vireo/Philadelphia_Vireo_0013_794772.jpg,500,224,153.Philadelphia_Vireo,184,12,382,219,283,115,198,207
../../CUB_200_2011/images\153.Philadelphia_Vireo/Philadelphia_Vireo_0003_156565.jpg,500,333,153.Philadelphia_Vireo,179,107,399,224,289,165,220,117
../../CUB_200_2011/images\153.Philadelphia_Vireo/Philadelphia_Vireo_0052_794774.jpg,500,438,153.Philadelphia_Vireo,97,201,486,409,291,305,389,208
../../CUB_200_2011/images\153.Philadelphia_Vireo/Philadelphia_Vireo_0078_794776.jpg,500,369,153.Philadelphia_Vireo,135,49,328,324,231,186,193,275
../../CUB_200_2011/images\153.Philadelphia_Vireo/Philadelphia_Vireo_0062_794777.jpg,300,250,153.Philadelphia_Vireo,52,72,220,201,136,136,168,129
../../CUB_200_2011/images\153.Philadelphia_Vireo/Philadelphia_Vireo_0015_794778.jpg,500,333,153.Philadelphia_Vireo,198,101,440,285,319,193,242,184
../../CUB_200_2011/images\153.Philadelphia_Vireo/Philadelphia_Vireo_0063_794781.jpg,500,440,153.Philadelphia_Vireo,98,129,360,317,229,223,262,188
../../CUB_200_2011/images\153.Philadelphia_Vireo/Philadelphia_Vireo_0082_156574.jpg,500,400,153.Philadelphia_Vireo,179,147,325,294,252,220,146,147
../../CUB_200_2011/images\153.Philadelphia_Vireo/Philadelphia_Vireo_0055_156575.jpg,500,376,153.Philadelphia_Vireo,204,112,331,265,267,188,127,153
../../CUB_200_2011/images\153.Philadelphia_Vireo/Philadelphia_Vireo_0012_794785.jpg,500,283,153.Philadelphia_Vireo,54,25,494,208,274,116,440,183
../../CUB_200_2011/images\153.Philadelphia_Vireo/Philadelphia_Vireo_0084_794790.jpg,340,240,153.Philadelphia_Vireo,50,23,306,198,178,110,256,175
../../CUB_200_2011/images\153.Philadelphia_Vireo/Philadelphia_Vireo_0043_794792.jpg,500,358,153.Philadelphia_Vireo,168,105,348,289,258,197,180,184
../../CUB_200_2011/images\153.Philadelphia_Vireo/Philadelphia_Vireo_0027_156585.jpg,357,500,153.Philadelphia_Vireo,30,29,237,457,133,243,207,428
../../CUB_200_2011/images\153.Philadelphia_Vireo/Philadelphia_Vireo_0039_794794.jpg,333,500,153.Philadelphia_Vireo,45,148,267,372,156,260,222,224
../../CUB_200_2011/images\153.Philadelphia_Vireo/Philadelphia_Vireo_0071_794796.jpg,500,333,153.Philadelphia_Vireo,107,81,419,245,263,163,312,164
../../CUB_200_2011/images\153.Philadelphia_Vireo/Philadelphia_Vireo_0023_794797.jpg,500,346,153.Philadelphia_Vireo,127,121,322,278,224,199,195,157
../../CUB_200_2011/images\153.Philadelphia_Vireo/Philadelphia_Vireo_0046_794798.jpg,350,239,153.Philadelphia_Vireo,8,41,246,227,127,134,238,186
../../CUB_200_2011/images\153.Philadelphia_Vireo/Philadelphia_Vireo_0059_794799.jpg,500,411,153.Philadelphia_Vireo,73,101,363,315,218,208,290,214
../../CUB_200_2011/images\153.Philadelphia_Vireo/Philadelphia_Vireo_0035_156596.jpg,418,500,153.Philadelphia_Vireo,125,197,376,386,250,291,251,189
../../CUB_200_2011/images\153.Philadelphia_Vireo/Philadelphia_Vireo_0016_156598.jpg,500,357,153.Philadelphia_Vireo,160,76,300,299,230,187,140,223
../../CUB_200_2011/images\153.Philadelphia_Vireo/Philadelphia_Vireo_0005_156599.jpg,500,422,153.Philadelphia_Vireo,102,151,355,277,228,214,253,126
../../CUB_200_2011/images\153.Philadelphia_Vireo/Philadelphia_Vireo_0045_156608.jpg,480,336,153.Philadelphia_Vireo,90,137,266,271,178,204,176,134
../../CUB_200_2011/images\153.Philadelphia_Vireo/Philadelphia_Vireo_0061_156613.jpg,500,335,153.Philadelphia_Vireo,203,115,355,276,279,195,152,161
../../CUB_200_2011/images\153.Philadelphia_Vireo/Philadelphia_Vireo_0058_156558.jpg,500,361,153.Philadelphia_Vireo,109,71,408,253,258,162,299,182
../../CUB_200_2011/images\153.Philadelphia_Vireo/Philadelphia_Vireo_0007_156617.jpg,500,375,153.Philadelphia_Vireo,74,181,337,302,205,241,263,121
../../CUB_200_2011/images\153.Philadelphia_Vireo/Philadelphia_Vireo_0031_156632.jpg,500,332,153.Philadelphia_Vireo,63,49,337,231,200,140,274,182
../../CUB_200_2011/images\153.Philadelphia_Vireo/Philadelphia_Vireo_0019_156640.jpg,404,500,153.Philadelphia_Vireo,17,60,331,321,174,190,314,261
../../CUB_200_2011/images\153.Philadelphia_Vireo/Philadelphia_Vireo_0041_156642.jpg,500,295,153.Philadelphia_Vireo,156,58,468,259,312,158,312,201
../../CUB_200_2011/images\153.Philadelphia_Vireo/Philadelphia_Vireo_0024_156645.jpg,500,400,153.Philadelphia_Vireo,74,179,324,342,199,260,250,163
../../CUB_200_2011/images\153.Philadelphia_Vireo/Philadelphia_Vireo_0072_156655.jpg,500,357,153.Philadelphia_Vireo,177,168,418,293,297,230,241,125
../../CUB_200_2011/images\153.Philadelphia_Vireo/Philadelphia_Vireo_0067_156584.jpg,500,331,153.Philadelphia_Vireo,34,88,444,287,239,187,410,199
../../CUB_200_2011/images\153.Philadelphia_Vireo/Philadelphia_Vireo_0020_156663.jpg,500,333,153.Philadelphia_Vireo,154,86,302,251,228,168,148,165
../../CUB_200_2011/images\154.Red_eyed_Vireo/Red_Eyed_Vireo_0052_157185.jpg,500,332,154.Red_eyed_Vireo,86,114,271,262,178,188,185,148
../../CUB_200_2011/images\154.Red_eyed_Vireo/Red_Eyed_Vireo_0132_156686.jpg,335,500,154.Red_eyed_Vireo,52,128,231,344,141,236,179,216
../../CUB_200_2011/images\154.Red_eyed_Vireo/Red_Eyed_Vireo_0061_157202.jpg,333,500,154.Red_eyed_Vireo,66,109,332,425,199,267,266,316
../../CUB_200_2011/images\154.Red_eyed_Vireo/Red_Eyed_Vireo_0141_157205.jpg,500,375,154.Red_eyed_Vireo,141,98,280,320,210,209,139,222
../../CUB_200_2011/images\154.Red_eyed_Vireo/Red_Eyed_Vireo_0034_157219.jpg,500,333,154.Red_eyed_Vireo,89,61,394,263,241,162,305,202
../../CUB_200_2011/images\154.Red_eyed_Vireo/Red_Eyed_Vireo_0044_156708.jpg,500,333,154.Red_eyed_Vireo,127,88,315,251,221,169,188,163
../../CUB_200_2011/images\154.Red_eyed_Vireo/Red_Eyed_Vireo_0004_157224.jpg,500,328,154.Red_eyed_Vireo,140,66,383,237,261,151,243,171
../../CUB_200_2011/images\154.Red_eyed_Vireo/Red_Eyed_Vireo_0003_157226.jpg,500,333,154.Red_eyed_Vireo,115,62,386,278,250,170,271,216
../../CUB_200_2011/images\154.Red_eyed_Vireo/Red_Eyed_Vireo_0036_156727.jpg,500,378,154.Red_eyed_Vireo,4,60,422,339,213,199,418,279
../../CUB_200_2011/images\154.Red_eyed_Vireo/Red_Eyed_Vireo_0112_156742.jpg,500,380,154.Red_eyed_Vireo,209,135,449,314,329,224,240,179
../../CUB_200_2011/images\154.Red_eyed_Vireo/Red_Eyed_Vireo_0026_156751.jpg,500,314,154.Red_eyed_Vireo,184,93,414,269,299,181,230,176
../../CUB_200_2011/images\154.Red_eyed_Vireo/Red_Eyed_Vireo_0046_157265.jpg,500,362,154.Red_eyed_Vireo,117,85,488,251,302,168,371,166
../../CUB_200_2011/images\154.Red_eyed_Vireo/Red_Eyed_Vireo_0131_156765.jpg,400,500,154.Red_eyed_Vireo,142,173,320,311,231,242,178,138
../../CUB_200_2011/images\154.Red_eyed_Vireo/Red_Eyed_Vireo_0029_156777.jpg,500,335,154.Red_eyed_Vireo,120,117,266,247,193,182,146,130
../../CUB_200_2011/images\154.Red_eyed_Vireo/Red_Eyed_Vireo_0123_156780.jpg,500,333,154.Red_eyed_Vireo,173,84,454,279,313,181,281,195
../../CUB_200_2011/images\154.Red_eyed_Vireo/Red_Eyed_Vireo_0129_156781.jpg,500,325,154.Red_eyed_Vireo,150,88,430,234,290,161,280,146
../../CUB_200_2011/images\154.Red_eyed_Vireo/Red_Eyed_Vireo_0049_156785.jpg,500,499,154.Red_eyed_Vireo,87,93,359,474,223,283,272,381
../../CUB_200_2011/images\154.Red_eyed_Vireo/Red_Eyed_Vireo_0138_156798.jpg,500,333,154.Red_eyed_Vireo,164,132,319,328,241,230,155,196
../../CUB_200_2011/images\154.Red_eyed_Vireo/Red_Eyed_Vireo_0023_156800.jpg,500,379,154.Red_eyed_Vireo,92,94,411,287,251,190,319,193
../../CUB_200_2011/images\154.Red_eyed_Vireo/Red_Eyed_Vireo_0062_157324.jpg,500,380,154.Red_eyed_Vireo,156,121,356,262,256,191,200,141
../../CUB_200_2011/images\154.Red_eyed_Vireo/Red_Eyed_Vireo_0020_156875.jpg,500,400,154.Red_eyed_Vireo,143,152,371,289,257,220,228,137
../../CUB_200_2011/images\154.Red_eyed_Vireo/Red_Eyed_Vireo_0053_156885.jpg,500,420,154.Red_eyed_Vireo,62,134,431,290,246,212,369,156
../../CUB_200_2011/images\154.Red_eyed_Vireo/Red_Eyed_Vireo_0032_156897.jpg,335,500,154.Red_eyed_Vireo,84,212,236,317,160,264,152,105
../../CUB_200_2011/images\154.Red_eyed_Vireo/Red_Eyed_Vireo_0134_156919.jpg,500,357,154.Red_eyed_Vireo,56,60,420,240,238,150,364,180
../../CUB_200_2011/images\154.Red_eyed_Vireo/Red_Eyed_Vireo_0019_156921.jpg,500,334,154.Red_eyed_Vireo,24,60,326,277,175,168,302,217
../../CUB_200_2011/images\154.Red_eyed_Vireo/Red_Eyed_Vireo_0084_156943.jpg,333,500,154.Red_eyed_Vireo,35,130,303,447,169,288,268,317
../../CUB_200_2011/images\154.Red_eyed_Vireo/Red_Eyed_Vireo_0073_156944.jpg,500,357,154.Red_eyed_Vireo,71,39,448,306,259,172,377,267
../../CUB_200_2011/images\154.Red_eyed_Vireo/Red_Eyed_Vireo_0041_156954.jpg,500,336,154.Red_eyed_Vireo,57,81,409,298,233,189,352,217
../../CUB_200_2011/images\154.Red_eyed_Vireo/Red_Eyed_Vireo_0038_156963.jpg,387,500,154.Red_eyed_Vireo,78,142,362,414,220,278,284,272
../../CUB_200_2011/images\154.Red_eyed_Vireo/Red_Eyed_Vireo_0058_156965.jpg,500,334,154.Red_eyed_Vireo,21,100,453,277,237,188,432,177
../../CUB_200_2011/images\154.Red_eyed_Vireo/Red_Eyed_Vireo_0071_156967.jpg,500,379,154.Red_eyed_Vireo,18,192,359,371,188,281,341,179
../../CUB_200_2011/images\154.Red_eyed_Vireo/Red_Eyed_Vireo_0056_156968.jpg,500,333,154.Red_eyed_Vireo,15,67,286,289,150,178,271,222
../../CUB_200_2011/images\154.Red_eyed_Vireo/Red_Eyed_Vireo_0016_156971.jpg,500,333,154.Red_eyed_Vireo,219,52,458,233,338,142,239,181
../../CUB_200_2011/images\154.Red_eyed_Vireo/Red_Eyed_Vireo_0059_156974.jpg,500,381,154.Red_eyed_Vireo,49,69,469,352,259,210,420,283
../../CUB_200_2011/images\154.Red_eyed_Vireo/Red_Eyed_Vireo_0002_156470.jpg,500,399,154.Red_eyed_Vireo,106,66,386,364,246,215,280,298
../../CUB_200_2011/images\154.Red_eyed_Vireo/Red_Eyed_Vireo_0030_156987.jpg,500,357,154.Red_eyed_Vireo,63,59,435,268,249,163,372,209
../../CUB_200_2011/images\154.Red_eyed_Vireo/Red_Eyed_Vireo_0101_156988.jpg,500,351,154.Red_eyed_Vireo,137,97,444,279,290,188,307,182
../../CUB_200_2011/images\154.Red_eyed_Vireo/Red_Eyed_Vireo_0140_157237.jpg,500,368,154.Red_eyed_Vireo,101,69,360,312,230,190,259,243
../../CUB_200_2011/images\154.Red_eyed_Vireo/Red_Eyed_Vireo_0115_157004.jpg,500,419,154.Red_eyed_Vireo,45,125,408,341,226,233,363,216
../../CUB_200_2011/images\154.Red_eyed_Vireo/Red_Eyed_Vireo_0077_157005.jpg,400,290,154.Red_eyed_Vireo,27,82,267,269,147,175,240,187
../../CUB_200_2011/images\154.Red_eyed_Vireo/Red_Eyed_Vireo_0096_157013.jpg,500,333,154.Red_eyed_Vireo,110,72,454,307,282,189,344,235
../../CUB_200_2011/images\154.Red_eyed_Vireo/Red_Eyed_Vireo_0065_157019.jpg,500,357,154.Red_eyed_Vireo,100,115,437,271,268,193,337,156
../../CUB_200_2011/images\154.Red_eyed_Vireo/Red_Eyed_Vireo_0006_157025.jpg,500,351,154.Red_eyed_Vireo,93,64,411,317,252,190,318,253
../../CUB_200_2011/images\154.Red_eyed_Vireo/Red_Eyed_Vireo_0111_157030.jpg,400,500,154.Red_eyed_Vireo,143,99,265,373,204,236,122,274
../../CUB_200_2011/images\154.Red_eyed_Vireo/Red_Eyed_Vireo_0086_157038.jpg,500,401,154.Red_eyed_Vireo,172,134,379,327,275,230,207,193
../../CUB_200_2011/images\154.Red_eyed_Vireo/Red_Eyed_Vireo_0014_157062.jpg,500,363,154.Red_eyed_Vireo,35,181,333,328,184,254,298,147
../../CUB_200_2011/images\154.Red_eyed_Vireo/Red_Eyed_Vireo_0083_157063.jpg,500,442,154.Red_eyed_Vireo,96,85,358,384,227,234,262,299
../../CUB_200_2011/images\154.Red_eyed_Vireo/Red_Eyed_Vireo_0045_157252.jpg,500,375,154.Red_eyed_Vireo,113,121,402,281,257,201,289,160
../../CUB_200_2011/images\154.Red_eyed_Vireo/Red_Eyed_Vireo_0095_157082.jpg,500,357,154.Red_eyed_Vireo,93,66,382,316,237,191,289,250
../../CUB_200_2011/images\154.Red_eyed_Vireo/Red_Eyed_Vireo_0055_157096.jpg,500,333,154.Red_eyed_Vireo,199,132,402,256,300,194,203,124
../../CUB_200_2011/images\154.Red_eyed_Vireo/Red_Eyed_Vireo_0106_157102.jpg,500,363,154.Red_eyed_Vireo,92,66,304,316,198,191,212,250
../../CUB_200_2011/images\154.Red_eyed_Vireo/Red_Eyed_Vireo_0075_158151.jpg,500,400,154.Red_eyed_Vireo,151,173,464,335,307,254,313,162
../../CUB_200_2011/images\154.Red_eyed_Vireo/Red_Eyed_Vireo_0054_157158.jpg,500,440,154.Red_eyed_Vireo,90,59,370,389,230,224,280,330
../../CUB_200_2011/images\154.Red_eyed_Vireo/Red_Eyed_Vireo_0133_156668.jpg,500,375,154.Red_eyed_Vireo,27,48,317,358,172,203,290,310
../../CUB_200_2011/images\154.Red_eyed_Vireo/Red_Eyed_Vireo_0043_157162.jpg,500,468,154.Red_eyed_Vireo,85,91,333,427,209,259,248,336
../../CUB_200_2011/images\154.Red_eyed_Vireo/Red_Eyed_Vireo_0074_157170.jpg,500,399,154.Red_eyed_Vireo,73,123,282,356,177,239,209,233
../../CUB_200_2011/images\154.Red_eyed_Vireo/Red_Eyed_Vireo_0025_157173.jpg,500,367,154.Red_eyed_Vireo,98,95,380,279,239,187,282,184
../../CUB_200_2011/images\154.Red_eyed_Vireo/Red_Eyed_Vireo_0079_158198.jpg,500,290,154.Red_eyed_Vireo,185,57,386,275,285,166,201,218
../../CUB_200_2011/images\154.Red_eyed_Vireo/Red_Eyed_Vireo_0109_157176.jpg,500,375,154.Red_eyed_Vireo,121,90,391,374,256,232,270,284
../../CUB_200_2011/images\154.Red_eyed_Vireo/Red_Eyed_Vireo_0126_157179.jpg,500,442,154.Red_eyed_Vireo,199,135,304,360,251,247,105,225
../../CUB_200_2011/images\155.Warbling_Vireo/Warbling_Vireo_0009_158721.jpg,500,376,155.Warbling_Vireo,142,105,428,316,285,210,286,211
../../CUB_200_2011/images\155.Warbling_Vireo/Warbling_Vireo_0105_158727.jpg,500,333,155.Warbling_Vireo,164,85,367,304,265,194,203,219
../../CUB_200_2011/images\155.Warbling_Vireo/Warbling_Vireo_0116_158740.jpg,500,388,155.Warbling_Vireo,113,139,446,320,279,229,333,181
../../CUB_200_2011/images\155.Warbling_Vireo/Warbling_Vireo_0047_158250.jpg,500,318,155.Warbling_Vireo,136,58,396,229,266,143,260,171
../../CUB_200_2011/images\155.Warbling_Vireo/Warbling_Vireo_0036_158268.jpg,500,344,155.Warbling_Vireo,10,15,463,334,236,174,453,319
../../CUB_200_2011/images\155.Warbling_Vireo/Warbling_Vireo_0017_158271.jpg,396,500,155.Warbling_Vireo,70,48,361,437,215,242,291,389
../../CUB_200_2011/images\155.Warbling_Vireo/Warbling_Vireo_0079_158791.jpg,500,370,155.Warbling_Vireo,56,68,445,282,250,175,389,214
../../CUB_200_2011/images\155.Warbling_Vireo/Warbling_Vireo_0067_158283.jpg,500,313,155.Warbling_Vireo,4,55,333,286,168,170,329,231
../../CUB_200_2011/images\155.Warbling_Vireo/Warbling_Vireo_0083_158284.jpg,470,500,155.Warbling_Vireo,31,262,308,423,169,342,277,161
../../CUB_200_2011/images\155.Warbling_Vireo/Warbling_Vireo_0118_158285.jpg,500,379,155.Warbling_Vireo,30,117,375,338,202,227,345,221
../../CUB_200_2011/images\155.Warbling_Vireo/Warbling_Vireo_0104_158800.jpg,500,332,155.Warbling_Vireo,89,109,268,255,178,182,179,146
../../CUB_200_2011/images\155.Warbling_Vireo/Warbling_Vireo_0018_158304.jpg,500,333,155.Warbling_Vireo,91,65,368,276,229,170,277,211
../../CUB_200_2011/images\155.Warbling_Vireo/Warbling_Vireo_0119_158819.jpg,500,349,155.Warbling_Vireo,124,80,312,292,218,186,188,212
../../CUB_200_2011/images\155.Warbling_Vireo/Warbling_Vireo_0019_158313.jpg,500,375,155.Warbling_Vireo,59,81,467,315,263,198,408,234
../../CUB_200_2011/images\155.Warbling_Vireo/Warbling_Vireo_0073_158315.jpg,500,375,155.Warbling_Vireo,139,81,395,320,267,200,256,239
../../CUB_200_2011/images\155.Warbling_Vireo/Warbling_Vireo_0002_158319.jpg,500,354,155.Warbling_Vireo,136,78,407,297,271,187,271,219
../../CUB_200_2011/images\155.Warbling_Vireo/Warbling_Vireo_0054_158321.jpg,500,333,155.Warbling_Vireo,90,34,301,295,195,164,211,261
../../CUB_200_2011/images\155.Warbling_Vireo/Warbling_Vireo_0056_21117.jpg,500,333,155.Warbling_Vireo,186,112,337,259,261,185,151,147
../../CUB_200_2011/images\155.Warbling_Vireo/Warbling_Vireo_0081_158344.jpg,500,329,155.Warbling_Vireo,170,108,355,259,262,183,185,151
../../CUB_200_2011/images\155.Warbling_Vireo/Warbling_Vireo_0099_158744.jpg,500,333,155.Warbling_Vireo,52,108,289,256,170,182,237,148
../../CUB_200_2011/images\155.Warbling_Vireo/Warbling_Vireo_0087_158355.jpg,500,345,155.Warbling_Vireo,223,95,405,241,314,168,182,146
../../CUB_200_2011/images\155.Warbling_Vireo/Warbling_Vireo_0004_158376.jpg,500,375,155.Warbling_Vireo,260,84,364,326,312,205,104,242
../../CUB_200_2011/images\155.Warbling_Vireo/Warbling_Vireo_0001_158397.jpg,500,383,155.Warbling_Vireo,63,73,415,254,239,163,352,181
../../CUB_200_2011/images\155.Warbling_Vireo/Warbling_Vireo_0045_158399.jpg,500,371,155.Warbling_Vireo,166,111,318,278,242,194,152,167
../../CUB_200_2011/images\155.Warbling_Vireo/Warbling_Vireo_0090_158403.jpg,500,369,155.Warbling_Vireo,138,88,369,307,253,197,231,219
../../CUB_200_2011/images\155.Warbling_Vireo/Warbling_Vireo_0014_158412.jpg,484,323,155.Warbling_Vireo,93,70,343,322,218,196,250,252
../../CUB_200_2011/images\155.Warbling_Vireo/Warbling_Vireo_0091_158419.jpg,276,500,155.Warbling_Vireo,38,67,146,384,92,225,108,317
../../CUB_200_2011/images\155.Warbling_Vireo/Warbling_Vireo_0132_158420.jpg,500,444,155.Warbling_Vireo,167,62,346,382,256,222,179,320
../../CUB_200_2011/images\155.Warbling_Vireo/Warbling_Vireo_0072_158422.jpg,403,500,155.Warbling_Vireo,70,63,332,432,201,247,262,369
../../CUB_200_2011/images\155.Warbling_Vireo/Warbling_Vireo_0111_158423.jpg,375,500,155.Warbling_Vireo,178,197,336,386,257,291,158,189
../../CUB_200_2011/images\155.Warbling_Vireo/Warbling_Vireo_0077_158427.jpg,500,400,155.Warbling_Vireo,146,138,287,268,216,203,141,130
../../CUB_200_2011/images\155.Warbling_Vireo/Warbling_Vireo_0064_158437.jpg,500,400,155.Warbling_Vireo,68,107,336,253,202,180,268,146
../../CUB_200_2011/images\155.Warbling_Vireo/Warbling_Vireo_0088_158452.jpg,500,422,155.Warbling_Vireo,132,72,414,326,273,199,282,254
../../CUB_200_2011/images\155.Warbling_Vireo/Warbling_Vireo_0107_158453.jpg,426,500,155.Warbling_Vireo,46,78,333,280,189,179,287,202
../../CUB_200_2011/images\155.Warbling_Vireo/Warbling_Vireo_0070_158459.jpg,333,500,155.Warbling_Vireo,17,149,262,446,139,297,245,297
../../CUB_200_2011/images\155.Warbling_Vireo/Warbling_Vireo_0006_158467.jpg,392,500,155.Warbling_Vireo,46,111,306,423,176,267,260,312
../../CUB_200_2011/images\155.Warbling_Vireo/Warbling_Vireo_0075_158480.jpg,500,311,155.Warbling_Vireo,68,102,336,256,202,179,268,154
../../CUB_200_2011/images\155.Warbling_Vireo/Warbling_Vireo_0003_158484.jpg,500,351,155.Warbling_Vireo,187,120,314,285,250,202,127,165
../../CUB_200_2011/images\155.Warbling_Vireo/Warbling_Vireo_0030_158488.jpg,400,500,155.Warbling_Vireo,4,110,274,419,139,264,270,309
../../CUB_200_2011/images\155.Warbling_Vireo/Warbling_Vireo_0028_158492.jpg,500,333,155.Warbling_Vireo,56,84,261,273,158,178,205,189
../../CUB_200_2011/images\155.Warbling_Vireo/Warbling_Vireo_0061_158494.jpg,500,400,155.Warbling_Vireo,109,103,303,301,206,202,194,198
../../CUB_200_2011/images\155.Warbling_Vireo/Warbling_Vireo_0076_158500.jpg,500,376,155.Warbling_Vireo,94,75,311,314,202,194,217,239
../../CUB_200_2011/images\155.Warbling_Vireo/Warbling_Vireo_0089_158519.jpg,500,333,155.Warbling_Vireo,46,57,477,276,261,166,431,219
../../CUB_200_2011/images\155.Warbling_Vireo/Warbling_Vireo_0131_158522.jpg,500,379,155.Warbling_Vireo,174,102,329,288,251,195,155,186
../../CUB_200_2011/images\155.Warbling_Vireo/Warbling_Vireo_0052_158534.jpg,500,375,155.Warbling_Vireo,161,117,316,350,238,233,155,233
../../CUB_200_2011/images\155.Warbling_Vireo/Warbling_Vireo_0058_158539.jpg,500,333,155.Warbling_Vireo,161,93,316,294,238,193,155,201
../../CUB_200_2011/images\155.Warbling_Vireo/Warbling_Vireo_0086_158564.jpg,500,375,155.Warbling_Vireo,162,83,431,221,296,152,269,138
../../CUB_200_2011/images\155.Warbling_Vireo/Warbling_Vireo_0027_158576.jpg,500,335,155.Warbling_Vireo,66,110,319,292,192,201,253,182
../../CUB_200_2011/images\155.Warbling_Vireo/Warbling_Vireo_0097_158579.jpg,500,335,155.Warbling_Vireo,88,117,337,263,212,190,249,146
../../CUB_200_2011/images\155.Warbling_Vireo/Warbling_Vireo_0113_158588.jpg,500,466,155.Warbling_Vireo,36,117,421,350,228,233,385,233
../../CUB_200_2011/images\155.Warbling_Vireo/Warbling_Vireo_0127_158601.jpg,420,280,155.Warbling_Vireo,95,50,403,224,249,137,308,174
../../CUB_200_2011/images\155.Warbling_Vireo/Warbling_Vireo_0022_158144.jpg,500,375,155.Warbling_Vireo,100,100,364,289,232,194,264,189
../../CUB_200_2011/images\155.Warbling_Vireo/Warbling_Vireo_0053_158675.jpg,500,333,155.Warbling_Vireo,187,104,294,261,240,182,107,157
../../CUB_200_2011/images\155.Warbling_Vireo/Warbling_Vireo_0029_158679.jpg,500,334,155.Warbling_Vireo,29,65,445,303,237,184,416,238
../../CUB_200_2011/images\155.Warbling_Vireo/Warbling_Vireo_0016_158681.jpg,500,296,155.Warbling_Vireo,56,57,239,201,147,129,183,144
../../CUB_200_2011/images\155.Warbling_Vireo/Warbling_Vireo_0068_158684.jpg,500,333,155.Warbling_Vireo,76,108,321,288,198,198,245,180
../../CUB_200_2011/images\155.Warbling_Vireo/Warbling_Vireo_0092_158688.jpg,357,500,155.Warbling_Vireo,69,101,314,340,191,220,245,239
../../CUB_200_2011/images\155.Warbling_Vireo/Warbling_Vireo_0126_158696.jpg,500,363,155.Warbling_Vireo,103,91,430,315,266,203,327,224
../../CUB_200_2011/images\155.Warbling_Vireo/Warbling_Vireo_0102_158704.jpg,500,333,155.Warbling_Vireo,31,128,239,275,135,201,208,147
../../CUB_200_2011/images\155.Warbling_Vireo/Warbling_Vireo_0007_158717.jpg,500,333,155.Warbling_Vireo,94,128,280,277,187,202,186,149
../../CUB_200_2011/images\156.White_eyed_Vireo/White_Eyed_Vireo_0045_159232.jpg,500,308,156.White_eyed_Vireo,59,91,278,266,168,178,219,175
../../CUB_200_2011/images\156.White_eyed_Vireo/White_Eyed_Vireo_0001_159237.jpg,500,333,156.White_eyed_Vireo,226,108,457,250,341,179,231,142
../../CUB_200_2011/images\156.White_eyed_Vireo/White_Eyed_Vireo_0136_156418.jpg,500,333,156.White_eyed_Vireo,186,81,483,299,334,190,297,218
../../CUB_200_2011/images\156.White_eyed_Vireo/White_Eyed_Vireo_0094_158894.jpg,500,492,156.White_eyed_Vireo,50,167,392,360,221,263,342,193
../../CUB_200_2011/images\156.White_eyed_Vireo/White_Eyed_Vireo_0030_159265.jpg,500,333,156.White_eyed_Vireo,93,22,317,326,205,174,224,304
../../CUB_200_2011/images\156.White_eyed_Vireo/White_Eyed_Vireo_0074_159279.jpg,327,500,156.White_eyed_Vireo,58,143,259,363,158,253,201,220
../../CUB_200_2011/images\156.White_eyed_Vireo/White_Eyed_Vireo_0122_159284.jpg,482,500,156.White_eyed_Vireo,94,64,338,458,216,261,244,394
../../CUB_200_2011/images\156.White_eyed_Vireo/White_Eyed_Vireo_0064_159286.jpg,500,334,156.White_eyed_Vireo,174,117,364,259,269,188,190,142
../../CUB_200_2011/images\156.White_eyed_Vireo/White_Eyed_Vireo_0120_158991.jpg,500,333,156.White_eyed_Vireo,153,39,431,333,292,186,278,294
../../CUB_200_2011/images\156.White_eyed_Vireo/White_Eyed_Vireo_0029_159334.jpg,404,500,156.White_eyed_Vireo,96,128,276,393,186,260,180,265
../../CUB_200_2011/images\156.White_eyed_Vireo/White_Eyed_Vireo_0129_158823.jpg,500,400,156.White_eyed_Vireo,72,82,357,359,214,220,285,277
../../CUB_200_2011/images\156.White_eyed_Vireo/White_Eyed_Vireo_0132_158908.jpg,500,489,156.White_eyed_Vireo,81,209,285,341,183,275,204,132
../../CUB_200_2011/images\156.White_eyed_Vireo/White_Eyed_Vireo_0050_158829.jpg,500,388,156.White_eyed_Vireo,21,124,383,316,202,220,362,192
../../CUB_200_2011/images\156.White_eyed_Vireo/White_Eyed_Vireo_0009_158830.jpg,500,346,156.White_eyed_Vireo,221,158,494,296,357,227,273,138
../../CUB_200_2011/images\156.White_eyed_Vireo/White_Eyed_Vireo_0049_158835.jpg,500,346,156.White_eyed_Vireo,155,88,453,247,304,167,298,159
../../CUB_200_2011/images\156.White_eyed_Vireo/White_Eyed_Vireo_0046_158849.jpg,500,394,156.White_eyed_Vireo,98,152,317,276,207,214,219,124
../../CUB_200_2011/images\156.White_eyed_Vireo/White_Eyed_Vireo_0126_159341.jpg,500,349,156.White_eyed_Vireo,122,144,255,264,188,204,133,120
../../CUB_200_2011/images\156.White_eyed_Vireo/White_Eyed_Vireo_0111_158864.jpg,500,444,156.White_eyed_Vireo,11,61,446,369,228,215,435,308
../../CUB_200_2011/images\156.White_eyed_Vireo/White_Eyed_Vireo_0078_159382.jpg,500,378,156.White_eyed_Vireo,111,97,445,341,278,219,334,244
../../CUB_200_2011/images\156.White_eyed_Vireo/White_Eyed_Vireo_0095_158886.jpg,500,441,156.White_eyed_Vireo,58,128,348,375,203,251,290,247
../../CUB_200_2011/images\156.White_eyed_Vireo/White_Eyed_Vireo_0134_158889.jpg,401,500,156.White_eyed_Vireo,171,224,300,426,235,325,129,202
../../CUB_200_2011/images\156.White_eyed_Vireo/White_Eyed_Vireo_0102_159420.jpg,500,342,156.White_eyed_Vireo,171,20,424,279,297,149,253,259
../../CUB_200_2011/images\156.White_eyed_Vireo/White_Eyed_Vireo_0115_158932.jpg,500,400,156.White_eyed_Vireo,118,81,428,278,273,179,310,197
../../CUB_200_2011/images\156.White_eyed_Vireo/White_Eyed_Vireo_0099_158933.jpg,400,500,156.White_eyed_Vireo,75,107,245,446,160,276,170,339
../../CUB_200_2011/images\156.White_eyed_Vireo/White_Eyed_Vireo_0018_159450.jpg,400,500,156.White_eyed_Vireo,57,85,260,465,158,275,203,380
../../CUB_200_2011/images\156.White_eyed_Vireo/White_Eyed_Vireo_0110_158947.jpg,500,353,156.White_eyed_Vireo,310,75,477,279,393,177,167,204
../../CUB_200_2011/images\156.White_eyed_Vireo/White_Eyed_Vireo_0135_158955.jpg,363,500,156.White_eyed_Vireo,123,71,343,313,233,192,220,242
../../CUB_200_2011/images\156.White_eyed_Vireo/White_Eyed_Vireo_0090_158958.jpg,407,324,156.White_eyed_Vireo,159,122,296,244,227,183,137,122
../../CUB_200_2011/images\156.White_eyed_Vireo/White_Eyed_Vireo_0026_158963.jpg,500,280,156.White_eyed_Vireo,95,107,361,219,228,163,266,112
../../CUB_200_2011/images\156.White_eyed_Vireo/White_Eyed_Vireo_0066_159477.jpg,500,379,156.White_eyed_Vireo,161,128,276,280,218,204,115,152
../../CUB_200_2011/images\156.White_eyed_Vireo/White_Eyed_Vireo_0016_158978.jpg,500,403,156.White_eyed_Vireo,76,99,489,381,282,240,413,282
../../CUB_200_2011/images\156.White_eyed_Vireo/White_Eyed_Vireo_0012_159495.jpg,500,388,156.White_eyed_Vireo,26,94,377,326,201,210,351,232
../../CUB_200_2011/images\156.White_eyed_Vireo/White_Eyed_Vireo_0128_158993.jpg,500,333,156.White_eyed_Vireo,163,107,465,269,314,188,302,162
../../CUB_200_2011/images\156.White_eyed_Vireo/White_Eyed_Vireo_0042_159012.jpg,500,333,156.White_eyed_Vireo,117,57,372,295,244,176,255,238
../../CUB_200_2011/images\156.White_eyed_Vireo/White_Eyed_Vireo_0116_159028.jpg,500,376,156.White_eyed_Vireo,111,70,452,270,281,170,341,200
../../CUB_200_2011/images\156.White_eyed_Vireo/White_Eyed_Vireo_0041_159032.jpg,500,375,156.White_eyed_Vireo,99,77,454,374,276,225,355,297
../../CUB_200_2011/images\156.White_eyed_Vireo/White_Eyed_Vireo_0051_159033.jpg,364,500,156.White_eyed_Vireo,80,62,245,439,162,250,165,377
../../CUB_200_2011/images\156.White_eyed_Vireo/White_Eyed_Vireo_0118_159036.jpg,500,378,156.White_eyed_Vireo,110,103,293,272,201,187,183,169
../../CUB_200_2011/images\156.White_eyed_Vireo/White_Eyed_Vireo_0022_159037.jpg,500,332,156.White_eyed_Vireo,54,73,293,276,173,174,239,203
../../CUB_200_2011/images\156.White_eyed_Vireo/White_Eyed_Vireo_0061_159042.jpg,500,359,156.White_eyed_Vireo,80,115,369,290,224,202,289,175
../../CUB_200_2011/images\156.White_eyed_Vireo/White_Eyed_Vireo_0091_159045.jpg,500,357,156.White_eyed_Vireo,80,100,400,291,240,195,320,191
../../CUB_200_2011/images\156.White_eyed_Vireo/White_Eyed_Vireo_0071_159072.jpg,500,445,156.White_eyed_Vireo,15,94,478,363,246,228,463,269
../../CUB_200_2011/images\156.White_eyed_Vireo/White_Eyed_Vireo_0130_159075.jpg,500,333,156.White_eyed_Vireo,179,37,355,313,267,175,176,276
../../CUB_200_2011/images\156.White_eyed_Vireo/White_Eyed_Vireo_0125_159078.jpg,500,452,156.White_eyed_Vireo,102,135,476,332,289,233,374,197
../../CUB_200_2011/images\156.White_eyed_Vireo/White_Eyed_Vireo_0033_159079.jpg,500,381,156.White_eyed_Vireo,103,85,433,351,268,218,330,266
../../CUB_200_2011/images\156.White_eyed_Vireo/White_Eyed_Vireo_0015_159081.jpg,500,324,156.White_eyed_Vireo,95,61,403,249,249,155,308,188
../../CUB_200_2011/images\156.White_eyed_Vireo/White_Eyed_Vireo_0088_159084.jpg,500,333,156.White_eyed_Vireo,195,77,429,234,312,155,234,157
../../CUB_200_2011/images\156.White_eyed_Vireo/White_Eyed_Vireo_0080_159087.jpg,500,355,156.White_eyed_Vireo,86,47,490,339,288,193,404,292
../../CUB_200_2011/images\156.White_eyed_Vireo/White_Eyed_Vireo_0019_159095.jpg,500,482,156.White_eyed_Vireo,41,113,390,299,215,206,349,186
../../CUB_200_2011/images\156.White_eyed_Vireo/White_Eyed_Vireo_0040_159101.jpg,500,355,156.White_eyed_Vireo,51,89,308,323,179,206,257,234
../../CUB_200_2011/images\156.White_eyed_Vireo/White_Eyed_Vireo_0085_159119.jpg,500,333,156.White_eyed_Vireo,54,69,323,279,188,174,269,210
../../CUB_200_2011/images\156.White_eyed_Vireo/White_Eyed_Vireo_0032_159145.jpg,476,500,156.White_eyed_Vireo,120,60,451,479,285,269,331,419
../../CUB_200_2011/images\156.White_eyed_Vireo/White_Eyed_Vireo_0112_159147.jpg,334,500,156.White_eyed_Vireo,22,168,270,371,146,269,248,203
../../CUB_200_2011/images\156.White_eyed_Vireo/White_Eyed_Vireo_0002_159180.jpg,500,335,156.White_eyed_Vireo,171,157,288,257,229,207,117,100
../../CUB_200_2011/images\156.White_eyed_Vireo/White_Eyed_Vireo_0082_159186.jpg,500,390,156.White_eyed_Vireo,131,114,438,364,284,239,307,250
../../CUB_200_2011/images\156.White_eyed_Vireo/White_Eyed_Vireo_0024_159193.jpg,500,333,156.White_eyed_Vireo,103,105,380,298,241,201,277,193
../../CUB_200_2011/images\156.White_eyed_Vireo/White_Eyed_Vireo_0086_159202.jpg,500,333,156.White_eyed_Vireo,89,97,385,208,237,152,296,111
../../CUB_200_2011/images\156.White_eyed_Vireo/White_Eyed_Vireo_0083_159203.jpg,318,500,156.White_eyed_Vireo,7,116,270,390,138,253,263,274
../../CUB_200_2011/images\156.White_eyed_Vireo/White_Eyed_Vireo_0114_159206.jpg,500,362,156.White_eyed_Vireo,171,123,292,299,231,211,121,176
../../CUB_200_2011/images\156.White_eyed_Vireo/White_Eyed_Vireo_0059_159225.jpg,500,335,156.White_eyed_Vireo,113,99,351,256,232,177,238,157
../../CUB_200_2011/images\157.Yellow_throated_Vireo/Yellow_Throated_Vireo_0072_794969.jpg,500,351,157.Yellow_throated_Vireo,192,68,392,314,292,191,200,246
../../CUB_200_2011/images\157.Yellow_throated_Vireo/Yellow_Throated_Vireo_0022_795012.jpg,500,400,157.Yellow_throated_Vireo,145,135,399,346,272,240,254,211
../../CUB_200_2011/images\157.Yellow_throated_Vireo/Yellow_Throated_Vireo_0085_159580.jpg,500,333,157.Yellow_throated_Vireo,121,87,310,233,215,160,189,146
../../CUB_200_2011/images\157.Yellow_throated_Vireo/Yellow_Throated_Vireo_0013_159531.jpg,500,332,157.Yellow_throated_Vireo,57,113,298,244,177,178,241,131
../../CUB_200_2011/images\157.Yellow_throated_Vireo/Yellow_Throated_Vireo_0055_159532.jpg,500,333,157.Yellow_throated_Vireo,221,131,423,285,322,208,202,154
../../CUB_200_2011/images\157.Yellow_throated_Vireo/Yellow_Throated_Vireo_0052_794973.jpg,500,400,157.Yellow_throated_Vireo,138,110,283,322,210,216,145,212
../../CUB_200_2011/images\157.Yellow_throated_Vireo/Yellow_Throated_Vireo_0005_159588.jpg,500,375,157.Yellow_throated_Vireo,55,36,479,306,267,171,424,270
../../CUB_200_2011/images\157.Yellow_throated_Vireo/Yellow_Throated_Vireo_0023_159584.jpg,500,326,157.Yellow_throated_Vireo,182,104,289,248,235,176,107,144
../../CUB_200_2011/images\157.Yellow_throated_Vireo/Yellow_Throated_Vireo_0076_794984.jpg,428,338,157.Yellow_throated_Vireo,28,33,397,257,212,145,369,224
../../CUB_200_2011/images\157.Yellow_throated_Vireo/Yellow_Throated_Vireo_0057_159570.jpg,450,500,157.Yellow_throated_Vireo,106,137,252,493,179,315,146,356
../../CUB_200_2011/images\157.Yellow_throated_Vireo/Yellow_Throated_Vireo_0074_159571.jpg,500,388,157.Yellow_throated_Vireo,97,83,232,332,164,207,135,249
../../CUB_200_2011/images\157.Yellow_throated_Vireo/Yellow_Throated_Vireo_0008_159573.jpg,500,339,157.Yellow_throated_Vireo,132,58,403,316,267,187,271,258
../../CUB_200_2011/images\157.Yellow_throated_Vireo/Yellow_Throated_Vireo_0079_159576.jpg,400,500,157.Yellow_throated_Vireo,48,121,384,337,216,229,336,216
../../CUB_200_2011/images\157.Yellow_throated_Vireo/Yellow_Throated_Vireo_0059_794970.jpg,500,354,157.Yellow_throated_Vireo,76,118,374,277,225,197,298,159
../../CUB_200_2011/images\157.Yellow_throated_Vireo/Yellow_Throated_Vireo_0021_794971.jpg,500,386,157.Yellow_throated_Vireo,8,73,421,350,214,211,413,277
../../CUB_200_2011/images\157.Yellow_throated_Vireo/Yellow_Throated_Vireo_0007_794972.jpg,500,364,157.Yellow_throated_Vireo,210,119,374,253,292,186,164,134
../../CUB_200_2011/images\157.Yellow_throated_Vireo/Yellow_Throated_Vireo_0077_159581.jpg,500,400,157.Yellow_throated_Vireo,76,110,431,306,253,208,355,196
../../CUB_200_2011/images\157.Yellow_throated_Vireo/Yellow_Throated_Vireo_0003_794974.jpg,320,254,157.Yellow_throated_Vireo,55,48,273,217,164,132,218,169
../../CUB_200_2011/images\157.Yellow_throated_Vireo/Yellow_Throated_Vireo_0073_159583.jpg,500,357,157.Yellow_throated_Vireo,26,93,462,328,244,210,436,235
../../CUB_200_2011/images\157.Yellow_throated_Vireo/Yellow_Throated_Vireo_0009_794976.jpg,500,404,157.Yellow_throated_Vireo,1,6,495,402,248,204,494,396
../../CUB_200_2011/images\157.Yellow_throated_Vireo/Yellow_Throated_Vireo_0012_794977.jpg,300,325,157.Yellow_throated_Vireo,14,89,254,242,134,165,240,153
../../CUB_200_2011/images\157.Yellow_throated_Vireo/Yellow_Throated_Vireo_0050_794979.jpg,320,224,157.Yellow_throated_Vireo,34,41,228,168,131,104,194,127
../../CUB_200_2011/images\157.Yellow_throated_Vireo/Yellow_Throated_Vireo_0016_794981.jpg,450,344,157.Yellow_throated_Vireo,71,56,437,287,254,171,366,231
../../CUB_200_2011/images\157.Yellow_throated_Vireo/Yellow_Throated_Vireo_0048_794982.jpg,325,266,157.Yellow_throated_Vireo,58,65,249,218,153,141,191,153
../../CUB_200_2011/images\157.Yellow_throated_Vireo/Yellow_Throated_Vireo_0029_794985.jpg,240,185,157.Yellow_throated_Vireo,36,15,192,154,114,84,156,139
../../CUB_200_2011/images\157.Yellow_throated_Vireo/Yellow_Throated_Vireo_0011_794986.jpg,500,333,157.Yellow_throated_Vireo,59,54,377,249,218,151,318,195
../../CUB_200_2011/images\157.Yellow_throated_Vireo/Yellow_Throated_Vireo_0036_159595.jpg,500,398,157.Yellow_throated_Vireo,91,81,446,342,268,211,355,261
../../CUB_200_2011/images\157.Yellow_throated_Vireo/Yellow_Throated_Vireo_0017_794988.jpg,500,427,157.Yellow_throated_Vireo,58,79,456,331,257,205,398,252
../../CUB_200_2011/images\157.Yellow_throated_Vireo/Yellow_Throated_Vireo_0027_794989.jpg,375,500,157.Yellow_throated_Vireo,3,6,274,497,138,251,271,491
../../CUB_200_2011/images\157.Yellow_throated_Vireo/Yellow_Throated_Vireo_0080_794990.jpg,500,332,157.Yellow_throated_Vireo,186,125,286,227,236,176,100,102
../../CUB_200_2011/images\157.Yellow_throated_Vireo/Yellow_Throated_Vireo_0035_794991.jpg,500,370,157.Yellow_throated_Vireo,127,63,471,270,299,166,344,207
../../CUB_200_2011/images\157.Yellow_throated_Vireo/Yellow_Throated_Vireo_0064_794992.jpg,500,386,157.Yellow_throated_Vireo,116,65,471,243,293,154,355,178
../../CUB_200_2011/images\157.Yellow_throated_Vireo/Yellow_Throated_Vireo_0034_794993.jpg,350,350,157.Yellow_throated_Vireo,27,70,328,302,177,186,301,232
../../CUB_200_2011/images\157.Yellow_throated_Vireo/Yellow_Throated_Vireo_0058_794994.jpg,400,373,157.Yellow_throated_Vireo,53,63,211,316,132,189,158,253
../../CUB_200_2011/images\157.Yellow_throated_Vireo/Yellow_Throated_Vireo_0041_794998.jpg,500,333,157.Yellow_throated_Vireo,33,68,211,174,122,121,178,106
../../CUB_200_2011/images\157.Yellow_throated_Vireo/Yellow_Throated_Vireo_0010_795000.jpg,500,333,157.Yellow_throated_Vireo,144,79,470,280,307,179,326,201
../../CUB_200_2011/images\157.Yellow_throated_Vireo/Yellow_Throated_Vireo_0075_795004.jpg,500,385,157.Yellow_throated_Vireo,67,108,333,295,200,201,266,187
../../CUB_200_2011/images\157.Yellow_throated_Vireo/Yellow_Throated_Vireo_0066_795007.jpg,500,335,157.Yellow_throated_Vireo,53,71,320,267,186,169,267,196
../../CUB_200_2011/images\157.Yellow_throated_Vireo/Yellow_Throated_Vireo_0028_795008.jpg,400,299,157.Yellow_throated_Vireo,59,98,223,243,141,170,164,145
../../CUB_200_2011/images\157.Yellow_throated_Vireo/Yellow_Throated_Vireo_0025_795009.jpg,500,316,157.Yellow_throated_Vireo,67,65,361,281,214,173,294,216
../../CUB_200_2011/images\157.Yellow_throated_Vireo/Yellow_Throated_Vireo_0068_159620.jpg,500,474,157.Yellow_throated_Vireo,77,57,413,448,245,252,336,391
../../CUB_200_2011/images\157.Yellow_throated_Vireo/Yellow_Throated_Vireo_0040_159624.jpg,413,500,157.Yellow_throated_Vireo,119,132,254,346,186,239,135,214
../../CUB_200_2011/images\157.Yellow_throated_Vireo/Yellow_Throated_Vireo_0002_159625.jpg,500,348,157.Yellow_throated_Vireo,80,121,393,269,236,195,313,148
../../CUB_200_2011/images\157.Yellow_throated_Vireo/Yellow_Throated_Vireo_0043_159628.jpg,500,372,157.Yellow_throated_Vireo,63,108,405,326,234,217,342,218
../../CUB_200_2011/images\157.Yellow_throated_Vireo/Yellow_Throated_Vireo_0082_159597.jpg,500,358,157.Yellow_throated_Vireo,54,120,296,277,175,198,242,157
../../CUB_200_2011/images\157.Yellow_throated_Vireo/Yellow_Throated_Vireo_0032_159632.jpg,500,333,157.Yellow_throated_Vireo,175,51,447,267,311,159,272,216
../../CUB_200_2011/images\157.Yellow_throated_Vireo/Yellow_Throated_Vireo_0020_159634.jpg,500,312,157.Yellow_throated_Vireo,46,40,356,296,201,168,310,256
../../CUB_200_2011/images\157.Yellow_throated_Vireo/Yellow_Throated_Vireo_0054_159635.jpg,500,390,157.Yellow_throated_Vireo,161,104,295,253,228,178,134,149
../../CUB_200_2011/images\157.Yellow_throated_Vireo/Yellow_Throated_Vireo_0084_159639.jpg,500,396,157.Yellow_throated_Vireo,104,86,311,312,207,199,207,226
../../CUB_200_2011/images\157.Yellow_throated_Vireo/Yellow_Throated_Vireo_0042_159655.jpg,500,366,157.Yellow_throated_Vireo,54,57,435,287,244,172,381,230
../../CUB_200_2011/images\157.Yellow_throated_Vireo/Yellow_Throated_Vireo_0070_159602.jpg,413,500,157.Yellow_throated_Vireo,140,166,320,410,230,288,180,244
../../CUB_200_2011/images\157.Yellow_throated_Vireo/Yellow_Throated_Vireo_0046_159668.jpg,500,365,157.Yellow_throated_Vireo,86,29,460,341,273,185,374,312
../../CUB_200_2011/images\157.Yellow_throated_Vireo/Yellow_Throated_Vireo_0063_159677.jpg,500,375,157.Yellow_throated_Vireo,38,72,302,235,170,153,264,163
../../CUB_200_2011/images\157.Yellow_throated_Vireo/Yellow_Throated_Vireo_0026_159686.jpg,500,352,157.Yellow_throated_Vireo,150,100,408,282,279,191,258,182
../../CUB_200_2011/images\157.Yellow_throated_Vireo/Yellow_Throated_Vireo_0006_159693.jpg,500,384,157.Yellow_throated_Vireo,27,112,422,332,224,222,395,220
../../CUB_200_2011/images\157.Yellow_throated_Vireo/Yellow_Throated_Vireo_0078_159694.jpg,500,490,157.Yellow_throated_Vireo,134,119,373,374,253,246,239,255
../../CUB_200_2011/images\157.Yellow_throated_Vireo/Yellow_Throated_Vireo_0071_159707.jpg,500,349,157.Yellow_throated_Vireo,148,36,322,278,235,157,174,242
../../CUB_200_2011/images\157.Yellow_throated_Vireo/Yellow_Throated_Vireo_0014_159709.jpg,382,500,157.Yellow_throated_Vireo,2,157,311,452,156,304,309,295
../../CUB_200_2011/images\157.Yellow_throated_Vireo/Yellow_Throated_Vireo_0031_159712.jpg,500,333,157.Yellow_throated_Vireo,164,90,397,252,280,171,233,162
../../CUB_200_2011/images\158.Bay_breasted_Warbler/Bay_Breasted_Warbler_0026_159744.jpg,500,333,158.Bay_breasted_Warbler,159,93,490,299,324,196,331,206
../../CUB_200_2011/images\158.Bay_breasted_Warbler/Bay_Breasted_Warbler_0080_159749.jpg,500,334,158.Bay_breasted_Warbler,155,87,447,308,301,197,292,221
../../CUB_200_2011/images\158.Bay_breasted_Warbler/Bay_Breasted_Warbler_0099_159753.jpg,500,500,158.Bay_breasted_Warbler,146,140,484,375,315,257,338,235
../../CUB_200_2011/images\158.Bay_breasted_Warbler/Bay_Breasted_Warbler_0055_159740.jpg,500,333,158.Bay_breasted_Warbler,182,65,437,275,309,170,255,210
../../CUB_200_2011/images\158.Bay_breasted_Warbler/Bay_Breasted_Warbler_0093_159764.jpg,500,400,158.Bay_breasted_Warbler,135,153,414,285,274,219,279,132
../../CUB_200_2011/images\158.Bay_breasted_Warbler/Bay_Breasted_Warbler_0062_159783.jpg,500,333,158.Bay_breasted_Warbler,149,66,435,230,292,148,286,164
../../CUB_200_2011/images\158.Bay_breasted_Warbler/Bay_Breasted_Warbler_0013_159787.jpg,500,372,158.Bay_breasted_Warbler,83,89,408,297,245,193,325,208
../../CUB_200_2011/images\158.Bay_breasted_Warbler/Bay_Breasted_Warbler_0032_797150.jpg,500,333,158.Bay_breasted_Warbler,48,98,313,296,180,197,265,198
../../CUB_200_2011/images\158.Bay_breasted_Warbler/Bay_Breasted_Warbler_0057_159818.jpg,500,400,158.Bay_breasted_Warbler,94,111,481,309,287,210,387,198
../../CUB_200_2011/images\158.Bay_breasted_Warbler/Bay_Breasted_Warbler_0112_159839.jpg,500,317,158.Bay_breasted_Warbler,60,84,473,261,266,172,413,177
../../CUB_200_2011/images\158.Bay_breasted_Warbler/Bay_Breasted_Warbler_0086_159860.jpg,500,500,158.Bay_breasted_Warbler,164,170,393,308,278,239,229,138
../../CUB_200_2011/images\158.Bay_breasted_Warbler/Bay_Breasted_Warbler_0034_159861.jpg,500,357,158.Bay_breasted_Warbler,229,113,476,293,352,203,247,180
../../CUB_200_2011/images\158.Bay_breasted_Warbler/Bay_Breasted_Warbler_0060_159863.jpg,500,333,158.Bay_breasted_Warbler,155,55,358,231,256,143,203,176
../../CUB_200_2011/images\158.Bay_breasted_Warbler/Bay_Breasted_Warbler_0065_159722.jpg,500,417,158.Bay_breasted_Warbler,94,75,401,365,247,220,307,290
../../CUB_200_2011/images\158.Bay_breasted_Warbler/Bay_Breasted_Warbler_0019_159871.jpg,500,333,158.Bay_breasted_Warbler,72,88,406,280,239,184,334,192
../../CUB_200_2011/images\158.Bay_breasted_Warbler/Bay_Breasted_Warbler_0109_159883.jpg,397,500,158.Bay_breasted_Warbler,70,104,275,474,172,289,205,370
../../CUB_200_2011/images\158.Bay_breasted_Warbler/Bay_Breasted_Warbler_0102_159887.jpg,500,332,158.Bay_breasted_Warbler,215,127,324,253,269,190,109,126
../../CUB_200_2011/images\158.Bay_breasted_Warbler/Bay_Breasted_Warbler_0067_159895.jpg,500,375,158.Bay_breasted_Warbler,163,111,299,240,231,175,136,129
../../CUB_200_2011/images\158.Bay_breasted_Warbler/Bay_Breasted_Warbler_0018_159897.jpg,500,393,158.Bay_breasted_Warbler,22,85,296,325,159,205,274,240
../../CUB_200_2011/images\158.Bay_breasted_Warbler/Bay_Breasted_Warbler_0033_159912.jpg,473,500,158.Bay_breasted_Warbler,36,85,430,297,233,191,394,212
../../CUB_200_2011/images\158.Bay_breasted_Warbler/Bay_Breasted_Warbler_0085_797107.jpg,500,334,158.Bay_breasted_Warbler,168,98,438,274,303,186,270,176
../../CUB_200_2011/images\158.Bay_breasted_Warbler/Bay_Breasted_Warbler_0071_797108.jpg,500,333,158.Bay_breasted_Warbler,186,58,479,244,332,151,293,186
../../CUB_200_2011/images\158.Bay_breasted_Warbler/Bay_Breasted_Warbler_0064_797109.jpg,450,364,158.Bay_breasted_Warbler,92,42,372,326,232,184,280,284
../../CUB_200_2011/images\158.Bay_breasted_Warbler/Bay_Breasted_Warbler_0095_797113.jpg,396,286,158.Bay_breasted_Warbler,138,41,341,278,239,159,203,237
../../CUB_200_2011/images\158.Bay_breasted_Warbler/Bay_Breasted_Warbler_0072_797114.jpg,500,419,158.Bay_breasted_Warbler,105,145,294,328,199,236,189,183
../../CUB_200_2011/images\158.Bay_breasted_Warbler/Bay_Breasted_Warbler_0008_797115.jpg,500,384,158.Bay_breasted_Warbler,104,159,463,350,283,254,359,191
../../CUB_200_2011/images\158.Bay_breasted_Warbler/Bay_Breasted_Warbler_0007_797118.jpg,400,314,158.Bay_breasted_Warbler,45,76,315,192,180,134,270,116
../../CUB_200_2011/images\158.Bay_breasted_Warbler/Bay_Breasted_Warbler_0028_797119.jpg,200,247,158.Bay_breasted_Warbler,2,2,194,226,98,114,192,224
../../CUB_200_2011/images\158.Bay_breasted_Warbler/Bay_Breasted_Warbler_0082_797121.jpg,500,257,158.Bay_breasted_Warbler,16,29,499,245,257,137,483,216
../../CUB_200_2011/images\158.Bay_breasted_Warbler/Bay_Breasted_Warbler_0087_797122.jpg,500,464,158.Bay_breasted_Warbler,167,95,467,296,317,195,300,201
../../CUB_200_2011/images\158.Bay_breasted_Warbler/Bay_Breasted_Warbler_0054_797124.jpg,400,344,158.Bay_breasted_Warbler,91,54,395,259,243,156,304,205
../../CUB_200_2011/images\158.Bay_breasted_Warbler/Bay_Breasted_Warbler_0052_797125.jpg,500,333,158.Bay_breasted_Warbler,198,57,459,282,328,169,261,225
../../CUB_200_2011/images\158.Bay_breasted_Warbler/Bay_Breasted_Warbler_0090_797128.jpg,300,240,158.Bay_breasted_Warbler,67,42,284,175,175,108,217,133
../../CUB_200_2011/images\158.Bay_breasted_Warbler/Bay_Breasted_Warbler_0049_797129.jpg,500,375,158.Bay_breasted_Warbler,139,117,381,279,260,198,242,162
../../CUB_200_2011/images\158.Bay_breasted_Warbler/Bay_Breasted_Warbler_0051_797132.jpg,500,322,158.Bay_breasted_Warbler,54,69,307,262,180,165,253,193
../../CUB_200_2011/images\158.Bay_breasted_Warbler/Bay_Breasted_Warbler_0068_797133.jpg,350,350,158.Bay_breasted_Warbler,51,57,313,324,182,190,262,267
../../CUB_200_2011/images\158.Bay_breasted_Warbler/Bay_Breasted_Warbler_0016_797134.jpg,500,364,158.Bay_breasted_Warbler,226,126,415,273,320,199,189,147
../../CUB_200_2011/images\158.Bay_breasted_Warbler/Bay_Breasted_Warbler_0045_797135.jpg,500,333,158.Bay_breasted_Warbler,48,55,330,232,189,143,282,177
../../CUB_200_2011/images\158.Bay_breasted_Warbler/Bay_Breasted_Warbler_0031_797137.jpg,400,305,158.Bay_breasted_Warbler,44,86,290,226,167,156,246,140
../../CUB_200_2011/images\158.Bay_breasted_Warbler/Bay_Breasted_Warbler_0073_797138.jpg,500,325,158.Bay_breasted_Warbler,133,97,479,293,306,195,346,196
../../CUB_200_2011/images\158.Bay_breasted_Warbler/Bay_Breasted_Warbler_0025_159957.jpg,500,364,158.Bay_breasted_Warbler,180,130,434,272,307,201,254,142
../../CUB_200_2011/images\158.Bay_breasted_Warbler/Bay_Breasted_Warbler_0100_797142.jpg,500,357,158.Bay_breasted_Warbler,202,116,458,296,330,206,256,180
../../CUB_200_2011/images\158.Bay_breasted_Warbler/Bay_Breasted_Warbler_0105_797143.jpg,461,400,158.Bay_breasted_Warbler,193,181,362,385,277,283,169,204
../../CUB_200_2011/images\158.Bay_breasted_Warbler/Bay_Breasted_Warbler_0077_797144.jpg,500,338,158.Bay_breasted_Warbler,129,92,422,243,275,167,293,151
../../CUB_200_2011/images\158.Bay_breasted_Warbler/Bay_Breasted_Warbler_0101_797146.jpg,500,237,158.Bay_breasted_Warbler,203,51,343,203,273,127,140,152
../../CUB_200_2011/images\158.Bay_breasted_Warbler/Bay_Breasted_Warbler_0081_159963.jpg,500,404,158.Bay_breasted_Warbler,88,119,475,323,281,221,387,204
../../CUB_200_2011/images\158.Bay_breasted_Warbler/Bay_Breasted_Warbler_0039_797152.jpg,500,356,158.Bay_breasted_Warbler,138,117,446,324,292,220,308,207
../../CUB_200_2011/images\158.Bay_breasted_Warbler/Bay_Breasted_Warbler_0043_797154.jpg,411,429,158.Bay_breasted_Warbler,23,32,387,359,205,195,364,327
../../CUB_200_2011/images\158.Bay_breasted_Warbler/Bay_Breasted_Warbler_0053_797157.jpg,500,333,158.Bay_breasted_Warbler,92,100,356,274,224,187,264,174
../../CUB_200_2011/images\158.Bay_breasted_Warbler/Bay_Breasted_Warbler_0097_159974.jpg,500,375,158.Bay_breasted_Warbler,159,36,390,365,274,200,231,329
../../CUB_200_2011/images\158.Bay_breasted_Warbler/Bay_Breasted_Warbler_0042_797160.jpg,340,297,158.Bay_breasted_Warbler,48,42,256,158,152,100,208,116
../../CUB_200_2011/images\158.Bay_breasted_Warbler/Bay_Breasted_Warbler_0078_797163.jpg,500,357,158.Bay_breasted_Warbler,46,55,481,230,263,142,435,175
../../CUB_200_2011/images\158.Bay_breasted_Warbler/Bay_Breasted_Warbler_0012_797171.jpg,500,352,158.Bay_breasted_Warbler,11,42,458,321,234,181,447,279
../../CUB_200_2011/images\158.Bay_breasted_Warbler/Bay_Breasted_Warbler_0110_159735.jpg,500,376,158.Bay_breasted_Warbler,158,119,404,253,281,186,246,134
../../CUB_200_2011/images\158.Bay_breasted_Warbler/Bay_Breasted_Warbler_0011_159736.jpg,500,346,158.Bay_breasted_Warbler,65,92,418,305,241,198,353,213
../../CUB_200_2011/images\158.Bay_breasted_Warbler/Bay_Breasted_Warbler_0020_159737.jpg,500,400,158.Bay_breasted_Warbler,183,119,457,307,320,213,274,188
../../CUB_200_2011/images\158.Bay_breasted_Warbler/Bay_Breasted_Warbler_0005_159739.jpg,500,311,158.Bay_breasted_Warbler,171,29,487,285,329,157,316,256
../../CUB_200_2011/images\158.Bay_breasted_Warbler/Bay_Breasted_Warbler_0076_159996.jpg,500,333,158.Bay_breasted_Warbler,0,97,324,283,162,190,324,186
../../CUB_200_2011/images\158.Bay_breasted_Warbler/Bay_Breasted_Warbler_0079_159998.jpg,500,335,158.Bay_breasted_Warbler,97,117,223,221,160,169,126,104
../../CUB_200_2011/images\158.Bay_breasted_Warbler/Bay_Breasted_Warbler_0089_797141.jpg,425,393,158.Bay_breasted_Warbler,71,74,352,328,211,201,281,254
../../CUB_200_2011/images\159.Black_and_white_Warbler/Black_And_White_Warbler_0031_160773.jpg,459,500,159.Black_and_white_Warbler,280,93,399,237,339,165,119,144
../../CUB_200_2011/images\159.Black_and_white_Warbler/Black_And_White_Warbler_0048_160287.jpg,500,401,159.Black_and_white_Warbler,123,125,469,316,296,220,346,191
../../CUB_200_2011/images\159.Black_and_white_Warbler/Black_And_White_Warbler_0128_160803.jpg,500,375,159.Black_and_white_Warbler,71,115,477,348,274,231,406,233
../../CUB_200_2011/images\159.Black_and_white_Warbler/Black_And_White_Warbler_0098_160808.jpg,333,500,159.Black_and_white_Warbler,73,177,322,327,197,252,249,150
../../CUB_200_2011/images\159.Black_and_white_Warbler/Black_And_White_Warbler_0071_160308.jpg,500,349,159.Black_and_white_Warbler,74,81,417,318,245,199,343,237
../../CUB_200_2011/images\159.Black_and_white_Warbler/Black_And_White_Warbler_0135_160334.jpg,500,392,159.Black_and_white_Warbler,167,173,467,378,317,275,300,205
../../CUB_200_2011/images\159.Black_and_white_Warbler/Black_And_White_Warbler_0111_160342.jpg,500,377,159.Black_and_white_Warbler,242,114,374,306,308,210,132,192
../../CUB_200_2011/images\159.Black_and_white_Warbler/Black_And_White_Warbler_0001_160352.jpg,500,333,159.Black_and_white_Warbler,105,13,398,330,251,171,293,317
../../CUB_200_2011/images\159.Black_and_white_Warbler/Black_And_White_Warbler_0072_160353.jpg,500,316,159.Black_and_white_Warbler,56,104,457,310,256,207,401,206
../../CUB_200_2011/images\159.Black_and_white_Warbler/Black_And_White_Warbler_0070_160354.jpg,500,332,159.Black_and_white_Warbler,6,84,394,265,200,174,388,181
../../CUB_200_2011/images\159.Black_and_white_Warbler/Black_And_White_Warbler_0074_160361.jpg,500,473,159.Black_and_white_Warbler,56,90,444,341,250,215,388,251
../../CUB_200_2011/images\159.Black_and_white_Warbler/Black_And_White_Warbler_0118_160363.jpg,500,426,159.Black_and_white_Warbler,86,86,477,330,281,208,391,244
../../CUB_200_2011/images\159.Black_and_white_Warbler/Black_And_White_Warbler_0078_160365.jpg,500,376,159.Black_and_white_Warbler,153,31,383,212,268,121,230,181
../../CUB_200_2011/images\159.Black_and_white_Warbler/Black_And_White_Warbler_0117_160369.jpg,500,333,159.Black_and_white_Warbler,198,76,370,285,284,180,172,209
../../CUB_200_2011/images\159.Black_and_white_Warbler/Black_And_White_Warbler_0089_160370.jpg,400,500,159.Black_and_white_Warbler,100,109,336,438,218,273,236,329
../../CUB_200_2011/images\159.Black_and_white_Warbler/Black_And_White_Warbler_0028_160371.jpg,400,500,159.Black_and_white_Warbler,56,129,320,307,188,218,264,178
../../CUB_200_2011/images\159.Black_and_white_Warbler/Black_And_White_Warbler_0080_160375.jpg,500,333,159.Black_and_white_Warbler,122,75,346,314,234,194,224,239
../../CUB_200_2011/images\159.Black_and_white_Warbler/Black_And_White_Warbler_0002_160376.jpg,500,281,159.Black_and_white_Warbler,213,56,396,168,304,112,183,112
../../CUB_200_2011/images\159.Black_and_white_Warbler/Black_And_White_Warbler_0091_160896.jpg,400,500,159.Black_and_white_Warbler,117,142,285,397,201,269,168,255
../../CUB_200_2011/images\159.Black_and_white_Warbler/Black_And_White_Warbler_0119_160898.jpg,500,333,159.Black_and_white_Warbler,51,80,405,286,228,183,354,206
../../CUB_200_2011/images\159.Black_and_white_Warbler/Black_And_White_Warbler_0061_160404.jpg,452,500,159.Black_and_white_Warbler,163,171,344,327,253,249,181,156
../../CUB_200_2011/images\159.Black_and_white_Warbler/Black_And_White_Warbler_0095_160406.jpg,500,400,159.Black_and_white_Warbler,23,66,320,295,171,180,297,229
../../CUB_200_2011/images\159.Black_and_white_Warbler/Black_And_White_Warbler_0018_160438.jpg,500,399,159.Black_and_white_Warbler,57,49,310,285,183,167,253,236
../../CUB_200_2011/images\159.Black_and_white_Warbler/Black_And_White_Warbler_0077_160440.jpg,500,384,159.Black_and_white_Warbler,68,117,339,300,203,208,271,183
../../CUB_200_2011/images\159.Black_and_white_Warbler/Black_And_White_Warbler_0125_160482.jpg,500,400,159.Black_and_white_Warbler,161,74,376,343,268,208,215,269
../../CUB_200_2011/images\159.Black_and_white_Warbler/Black_And_White_Warbler_0022_160512.jpg,500,478,159.Black_and_white_Warbler,165,139,320,327,242,233,155,188
../../CUB_200_2011/images\159.Black_and_white_Warbler/Black_And_White_Warbler_0053_160010.jpg,500,400,159.Black_and_white_Warbler,24,98,384,346,204,222,360,248
../../CUB_200_2011/images\159.Black_and_white_Warbler/Black_And_White_Warbler_0106_160014.jpg,500,337,159.Black_and_white_Warbler,22,104,297,289,159,196,275,185
../../CUB_200_2011/images\159.Black_and_white_Warbler/Black_And_White_Warbler_0114_160537.jpg,500,397,159.Black_and_white_Warbler,33,109,396,316,214,212,363,207
../../CUB_200_2011/images\159.Black_and_white_Warbler/Black_And_White_Warbler_0073_160539.jpg,500,387,159.Black_and_white_Warbler,90,24,444,327,267,175,354,303
../../CUB_200_2011/images\159.Black_and_white_Warbler/Black_And_White_Warbler_0127_160031.jpg,373,500,159.Black_and_white_Warbler,37,43,327,476,182,259,290,433
../../CUB_200_2011/images\159.Black_and_white_Warbler/Black_And_White_Warbler_0047_160547.jpg,500,333,159.Black_and_white_Warbler,170,73,333,306,251,189,163,233
../../CUB_200_2011/images\159.Black_and_white_Warbler/Black_And_White_Warbler_0057_160037.jpg,500,335,159.Black_and_white_Warbler,22,46,290,280,156,163,268,234
../../CUB_200_2011/images\159.Black_and_white_Warbler/Black_And_White_Warbler_0024_160057.jpg,500,375,159.Black_and_white_Warbler,45,52,447,322,246,187,402,270
../../CUB_200_2011/images\159.Black_and_white_Warbler/Black_And_White_Warbler_0081_110906.jpg,500,334,159.Black_and_white_Warbler,50,60,300,260,175,160,250,200
../../CUB_200_2011/images\159.Black_and_white_Warbler/Black_And_White_Warbler_0025_160584.jpg,500,333,159.Black_and_white_Warbler,153,104,488,284,320,194,335,180
../../CUB_200_2011/images\159.Black_and_white_Warbler/Black_And_White_Warbler_0102_160073.jpg,500,334,159.Black_and_white_Warbler,147,52,358,256,252,154,211,204
../../CUB_200_2011/images\159.Black_and_white_Warbler/Black_And_White_Warbler_0030_160592.jpg,500,375,159.Black_and_white_Warbler,76,76,411,321,243,198,335,245
../../CUB_200_2011/images\159.Black_and_white_Warbler/Black_And_White_Warbler_0032_160569.jpg,500,375,159.Black_and_white_Warbler,97,151,340,265,218,208,243,114
../../CUB_200_2011/images\159.Black_and_white_Warbler/Black_And_White_Warbler_0051_160603.jpg,500,276,159.Black_and_white_Warbler,205,125,341,243,273,184,136,118
../../CUB_200_2011/images\159.Black_and_white_Warbler/Black_And_White_Warbler_0035_160102.jpg,500,333,159.Black_and_white_Warbler,35,75,297,279,166,177,262,204
../../CUB_200_2011/images\159.Black_and_white_Warbler/Black_And_White_Warbler_0122_160106.jpg,500,375,159.Black_and_white_Warbler,140,71,479,288,309,179,339,217
../../CUB_200_2011/images\159.Black_and_white_Warbler/Black_And_White_Warbler_0085_160110.jpg,357,500,159.Black_and_white_Warbler,29,74,333,471,181,272,304,397
../../CUB_200_2011/images\159.Black_and_white_Warbler/Black_And_White_Warbler_0065_160111.jpg,500,351,159.Black_and_white_Warbler,98,62,426,272,262,167,328,210
../../CUB_200_2011/images\159.Black_and_white_Warbler/Black_And_White_Warbler_0041_160639.jpg,500,401,159.Black_and_white_Warbler,155,148,432,373,293,260,277,225
../../CUB_200_2011/images\159.Black_and_white_Warbler/Black_And_White_Warbler_0115_160654.jpg,500,375,159.Black_and_white_Warbler,188,102,419,302,303,202,231,200
../../CUB_200_2011/images\159.Black_and_white_Warbler/Black_And_White_Warbler_0083_160237.jpg,500,400,159.Black_and_white_Warbler,175,107,495,291,335,199,320,184
../../CUB_200_2011/images\159.Black_and_white_Warbler/Black_And_White_Warbler_0088_160668.jpg,500,333,159.Black_and_white_Warbler,209,146,368,260,288,203,159,114
../../CUB_200_2011/images\159.Black_and_white_Warbler/Black_And_White_Warbler_0086_160836.jpg,500,365,159.Black_and_white_Warbler,67,46,443,356,255,201,376,310
../../CUB_200_2011/images\159.Black_and_white_Warbler/Black_And_White_Warbler_0076_160173.jpg,500,333,159.Black_and_white_Warbler,149,70,369,323,259,196,220,253
../../CUB_200_2011/images\159.Black_and_white_Warbler/Black_And_White_Warbler_0021_160686.jpg,500,359,159.Black_and_white_Warbler,138,79,400,292,269,185,262,213
../../CUB_200_2011/images\159.Black_and_white_Warbler/Black_And_White_Warbler_0034_160695.jpg,500,333,159.Black_and_white_Warbler,230,40,332,279,281,159,102,239
../../CUB_200_2011/images\159.Black_and_white_Warbler/Black_And_White_Warbler_0010_160200.jpg,500,332,159.Black_and_white_Warbler,138,18,433,235,285,126,295,217
../../CUB_200_2011/images\159.Black_and_white_Warbler/Black_And_White_Warbler_0046_160202.jpg,375,500,159.Black_and_white_Warbler,68,125,309,284,188,204,241,159
../../CUB_200_2011/images\159.Black_and_white_Warbler/Black_And_White_Warbler_0090_160247.jpg,500,490,159.Black_and_white_Warbler,51,89,404,346,227,217,353,257
../../CUB_200_2011/images\159.Black_and_white_Warbler/Black_And_White_Warbler_0003_160228.jpg,397,500,159.Black_and_white_Warbler,79,4,330,435,204,219,251,431
../../CUB_200_2011/images\159.Black_and_white_Warbler/Black_And_White_Warbler_0049_160749.jpg,500,333,159.Black_and_white_Warbler,152,110,309,211,230,160,157,101
../../CUB_200_2011/images\159.Black_and_white_Warbler/Black_And_White_Warbler_0109_160245.jpg,381,500,159.Black_and_white_Warbler,31,26,347,489,189,257,316,463
../../CUB_200_2011/images\159.Black_and_white_Warbler/Black_And_White_Warbler_0007_160758.jpg,500,332,159.Black_and_white_Warbler,169,79,434,255,301,167,265,176
../../CUB_200_2011/images\159.Black_and_white_Warbler/Black_And_White_Warbler_0060_160764.jpg,500,333,159.Black_and_white_Warbler,20,46,466,304,243,175,446,258
../../CUB_200_2011/images\160.Black_throated_Blue_Warbler/Black_Throated_Blue_Warbler_0129_161399.jpg,500,454,160.Black_throated_Blue_Warbler,28,67,474,434,251,250,446,367
../../CUB_200_2011/images\160.Black_throated_Blue_Warbler/Black_Throated_Blue_Warbler_0136_161400.jpg,500,320,160.Black_throated_Blue_Warbler,88,19,428,283,258,151,340,264
../../CUB_200_2011/images\160.Black_throated_Blue_Warbler/Black_Throated_Blue_Warbler_0004_161404.jpg,500,394,160.Black_throated_Blue_Warbler,54,74,396,343,225,208,342,269
../../CUB_200_2011/images\160.Black_throated_Blue_Warbler/Black_Throated_Blue_Warbler_0113_161407.jpg,500,333,160.Black_throated_Blue_Warbler,50,59,327,233,188,146,277,174
../../CUB_200_2011/images\160.Black_throated_Blue_Warbler/Black_Throated_Blue_Warbler_0119_161416.jpg,500,348,160.Black_throated_Blue_Warbler,72,123,270,259,171,191,198,136
../../CUB_200_2011/images\160.Black_throated_Blue_Warbler/Black_Throated_Blue_Warbler_0121_161418.jpg,500,366,160.Black_throated_Blue_Warbler,88,120,454,319,271,219,366,199
../../CUB_200_2011/images\160.Black_throated_Blue_Warbler/Black_Throated_Blue_Warbler_0081_161427.jpg,500,369,160.Black_throated_Blue_Warbler,129,125,318,279,223,202,189,154
../../CUB_200_2011/images\160.Black_throated_Blue_Warbler/Black_Throated_Blue_Warbler_0043_161438.jpg,500,333,160.Black_throated_Blue_Warbler,41,121,296,250,168,185,255,129
../../CUB_200_2011/images\160.Black_throated_Blue_Warbler/Black_Throated_Blue_Warbler_0083_161462.jpg,500,328,160.Black_throated_Blue_Warbler,166,89,413,298,289,193,247,209
../../CUB_200_2011/images\160.Black_throated_Blue_Warbler/Black_Throated_Blue_Warbler_0090_161507.jpg,500,333,160.Black_throated_Blue_Warbler,170,79,397,313,283,196,227,234
../../CUB_200_2011/images\160.Black_throated_Blue_Warbler/Black_Throated_Blue_Warbler_0101_161510.jpg,500,333,160.Black_throated_Blue_Warbler,20,98,357,257,188,177,337,159
../../CUB_200_2011/images\160.Black_throated_Blue_Warbler/Black_Throated_Blue_Warbler_0047_161511.jpg,500,371,160.Black_throated_Blue_Warbler,128,63,352,358,240,210,224,295
../../CUB_200_2011/images\160.Black_throated_Blue_Warbler/Black_Throated_Blue_Warbler_0042_161512.jpg,500,357,160.Black_throated_Blue_Warbler,78,93,329,263,203,178,251,170
../../CUB_200_2011/images\160.Black_throated_Blue_Warbler/Black_Throated_Blue_Warbler_0036_161517.jpg,500,333,160.Black_throated_Blue_Warbler,75,53,386,328,230,190,311,275
../../CUB_200_2011/images\160.Black_throated_Blue_Warbler/Black_Throated_Blue_Warbler_0022_161520.jpg,474,346,160.Black_throated_Blue_Warbler,45,58,425,294,235,176,380,236
../../CUB_200_2011/images\160.Black_throated_Blue_Warbler/Black_Throated_Blue_Warbler_0106_161523.jpg,500,334,160.Black_throated_Blue_Warbler,103,96,499,333,301,214,396,237
../../CUB_200_2011/images\160.Black_throated_Blue_Warbler/Black_Throated_Blue_Warbler_0099_161524.jpg,500,333,160.Black_throated_Blue_Warbler,156,43,360,298,258,170,204,255
../../CUB_200_2011/images\160.Black_throated_Blue_Warbler/Black_Throated_Blue_Warbler_0002_161533.jpg,500,355,160.Black_throated_Blue_Warbler,117,85,453,202,285,143,336,117
../../CUB_200_2011/images\160.Black_throated_Blue_Warbler/Black_Throated_Blue_Warbler_0009_161534.jpg,500,333,160.Black_throated_Blue_Warbler,97,129,320,250,208,189,223,121
../../CUB_200_2011/images\160.Black_throated_Blue_Warbler/Black_Throated_Blue_Warbler_0133_161539.jpg,475,500,160.Black_throated_Blue_Warbler,28,82,405,455,216,268,377,373
../../CUB_200_2011/images\160.Black_throated_Blue_Warbler/Black_Throated_Blue_Warbler_0123_161542.jpg,500,375,160.Black_throated_Blue_Warbler,156,72,372,368,264,220,216,296
../../CUB_200_2011/images\160.Black_throated_Blue_Warbler/Black_Throated_Blue_Warbler_0006_161557.jpg,500,332,160.Black_throated_Blue_Warbler,84,69,281,197,182,133,197,128
../../CUB_200_2011/images\160.Black_throated_Blue_Warbler/Black_Throated_Blue_Warbler_0073_161558.jpg,500,337,160.Black_throated_Blue_Warbler,105,35,492,238,298,136,387,203
../../CUB_200_2011/images\160.Black_throated_Blue_Warbler/Black_Throated_Blue_Warbler_0111_161615.jpg,500,457,160.Black_throated_Blue_Warbler,50,68,429,324,239,196,379,256
../../CUB_200_2011/images\160.Black_throated_Blue_Warbler/Black_Throated_Blue_Warbler_0024_161619.jpg,500,396,160.Black_throated_Blue_Warbler,258,84,434,209,346,146,176,125
../../CUB_200_2011/images\160.Black_throated_Blue_Warbler/Black_Throated_Blue_Warbler_0085_161621.jpg,500,400,160.Black_throated_Blue_Warbler,53,126,357,343,205,234,304,217
../../CUB_200_2011/images\160.Black_throated_Blue_Warbler/Black_Throated_Blue_Warbler_0100_161622.jpg,500,333,160.Black_throated_Blue_Warbler,74,95,443,261,258,178,369,166
../../CUB_200_2011/images\160.Black_throated_Blue_Warbler/Black_Throated_Blue_Warbler_0109_161635.jpg,500,333,160.Black_throated_Blue_Warbler,1,10,469,330,235,170,468,320
../../CUB_200_2011/images\160.Black_throated_Blue_Warbler/Black_Throated_Blue_Warbler_0072_161636.jpg,500,335,160.Black_throated_Blue_Warbler,217,20,432,275,324,147,215,255
../../CUB_200_2011/images\160.Black_throated_Blue_Warbler/Black_Throated_Blue_Warbler_0010_161169.jpg,500,333,160.Black_throated_Blue_Warbler,168,27,351,317,259,172,183,290
../../CUB_200_2011/images\160.Black_throated_Blue_Warbler/Black_Throated_Blue_Warbler_0060_161644.jpg,500,375,160.Black_throated_Blue_Warbler,155,92,320,268,237,180,165,176
../../CUB_200_2011/images\160.Black_throated_Blue_Warbler/Black_Throated_Blue_Warbler_0096_161654.jpg,500,362,160.Black_throated_Blue_Warbler,13,25,411,234,212,129,398,209
../../CUB_200_2011/images\160.Black_throated_Blue_Warbler/Black_Throated_Blue_Warbler_0064_161656.jpg,500,400,160.Black_throated_Blue_Warbler,30,9,412,397,221,203,382,388
../../CUB_200_2011/images\160.Black_throated_Blue_Warbler/Black_Throated_Blue_Warbler_0048_161665.jpg,500,375,160.Black_throated_Blue_Warbler,212,117,392,292,302,204,180,175
../../CUB_200_2011/images\160.Black_throated_Blue_Warbler/Black_Throated_Blue_Warbler_0050_161154.jpg,413,500,160.Black_throated_Blue_Warbler,150,151,391,441,270,296,241,290
../../CUB_200_2011/images\160.Black_throated_Blue_Warbler/Black_Throated_Blue_Warbler_0061_161667.jpg,500,349,160.Black_throated_Blue_Warbler,12,76,418,321,215,198,406,245
../../CUB_200_2011/images\160.Black_throated_Blue_Warbler/Black_Throated_Blue_Warbler_0054_161158.jpg,500,380,160.Black_throated_Blue_Warbler,99,42,422,348,260,195,323,306
../../CUB_200_2011/images\160.Black_throated_Blue_Warbler/Black_Throated_Blue_Warbler_0102_161161.jpg,500,337,160.Black_throated_Blue_Warbler,15,72,321,297,168,184,306,225
../../CUB_200_2011/images\160.Black_throated_Blue_Warbler/Black_Throated_Blue_Warbler_0076_161162.jpg,500,347,160.Black_throated_Blue_Warbler,85,70,475,327,280,198,390,257
../../CUB_200_2011/images\160.Black_throated_Blue_Warbler/Black_Throated_Blue_Warbler_0005_161168.jpg,500,393,160.Black_throated_Blue_Warbler,71,138,401,314,236,226,330,176
../../CUB_200_2011/images\160.Black_throated_Blue_Warbler/Black_Throated_Blue_Warbler_0080_161681.jpg,357,500,160.Black_throated_Blue_Warbler,46,87,298,419,172,253,252,332
../../CUB_200_2011/images\160.Black_throated_Blue_Warbler/Black_Throated_Blue_Warbler_0130_161682.jpg,500,333,160.Black_throated_Blue_Warbler,140,47,456,296,298,171,316,249
../../CUB_200_2011/images\160.Black_throated_Blue_Warbler/Black_Throated_Blue_Warbler_0053_161684.jpg,500,353,160.Black_throated_Blue_Warbler,169,93,433,297,301,195,264,204
../../CUB_200_2011/images\160.Black_throated_Blue_Warbler/Black_Throated_Blue_Warbler_0104_161686.jpg,500,261,160.Black_throated_Blue_Warbler,102,100,452,229,277,164,350,129
../../CUB_200_2011/images\160.Black_throated_Blue_Warbler/Black_Throated_Blue_Warbler_0127_161176.jpg,389,500,160.Black_throated_Blue_Warbler,52,43,374,481,213,262,322,438
../../CUB_200_2011/images\160.Black_throated_Blue_Warbler/Black_Throated_Blue_Warbler_0027_104004.jpg,500,363,160.Black_throated_Blue_Warbler,114,122,358,242,236,182,244,120
../../CUB_200_2011/images\160.Black_throated_Blue_Warbler/Black_Throated_Blue_Warbler_0001_161189.jpg,333,500,160.Black_throated_Blue_Warbler,102,101,267,399,184,250,165,298
../../CUB_200_2011/images\160.Black_throated_Blue_Warbler/Black_Throated_Blue_Warbler_0079_161194.jpg,500,370,160.Black_throated_Blue_Warbler,130,96,411,279,270,187,281,183
../../CUB_200_2011/images\160.Black_throated_Blue_Warbler/Black_Throated_Blue_Warbler_0037_161707.jpg,357,500,160.Black_throated_Blue_Warbler,59,57,261,417,160,237,202,360
../../CUB_200_2011/images\160.Black_throated_Blue_Warbler/Black_Throated_Blue_Warbler_0128_161708.jpg,420,280,160.Black_throated_Blue_Warbler,18,31,319,264,168,147,301,233
../../CUB_200_2011/images\160.Black_throated_Blue_Warbler/Black_Throated_Blue_Warbler_0108_161714.jpg,500,376,160.Black_throated_Blue_Warbler,136,78,413,260,274,169,277,182
../../CUB_200_2011/images\160.Black_throated_Blue_Warbler/Black_Throated_Blue_Warbler_0086_161716.jpg,500,295,160.Black_throated_Blue_Warbler,143,78,335,242,239,160,192,164
../../CUB_200_2011/images\160.Black_throated_Blue_Warbler/Black_Throated_Blue_Warbler_0137_161207.jpg,500,440,160.Black_throated_Blue_Warbler,113,58,287,400,200,229,174,342
../../CUB_200_2011/images\160.Black_throated_Blue_Warbler/Black_Throated_Blue_Warbler_0126_161724.jpg,500,399,160.Black_throated_Blue_Warbler,227,98,467,298,347,198,240,200
../../CUB_200_2011/images\160.Black_throated_Blue_Warbler/Black_Throated_Blue_Warbler_0063_161213.jpg,500,367,160.Black_throated_Blue_Warbler,82,78,347,253,214,165,265,175
../../CUB_200_2011/images\160.Black_throated_Blue_Warbler/Black_Throated_Blue_Warbler_0110_161726.jpg,500,381,160.Black_throated_Blue_Warbler,89,86,332,331,210,208,243,245
../../CUB_200_2011/images\160.Black_throated_Blue_Warbler/Black_Throated_Blue_Warbler_0016_161216.jpg,500,338,160.Black_throated_Blue_Warbler,237,81,365,301,301,191,128,220
../../CUB_200_2011/images\160.Black_throated_Blue_Warbler/Black_Throated_Blue_Warbler_0017_161220.jpg,500,352,160.Black_throated_Blue_Warbler,112,80,307,286,209,183,195,206
../../CUB_200_2011/images\160.Black_throated_Blue_Warbler/Black_Throated_Blue_Warbler_0107_161214.jpg,500,357,160.Black_throated_Blue_Warbler,213,83,445,309,329,196,232,226
../../CUB_200_2011/images\161.Blue_winged_Warbler/Blue_Winged_Warbler_0027_161795.jpg,343,500,161.Blue_winged_Warbler,96,196,229,355,162,275,133,159
../../CUB_200_2011/images\161.Blue_winged_Warbler/Blue_Winged_Warbler_0050_162057.jpg,500,333,161.Blue_winged_Warbler,45,116,316,296,180,206,271,180
../../CUB_200_2011/images\161.Blue_winged_Warbler/Blue_Winged_Warbler_0041_161802.jpg,500,333,161.Blue_winged_Warbler,213,100,392,241,302,170,179,141
../../CUB_200_2011/images\161.Blue_winged_Warbler/Blue_Winged_Warbler_0043_161804.jpg,500,367,161.Blue_winged_Warbler,92,111,359,330,225,220,267,219
../../CUB_200_2011/images\161.Blue_winged_Warbler/Blue_Winged_Warbler_0059_162064.jpg,329,500,161.Blue_winged_Warbler,15,69,261,410,138,239,246,341
../../CUB_200_2011/images\161.Blue_winged_Warbler/Blue_Winged_Warbler_0063_161810.jpg,500,383,161.Blue_winged_Warbler,160,150,470,368,315,259,310,218
../../CUB_200_2011/images\161.Blue_winged_Warbler/Blue_Winged_Warbler_0091_162051.jpg,500,401,161.Blue_winged_Warbler,180,145,355,303,267,224,175,158
../../CUB_200_2011/images\161.Blue_winged_Warbler/Blue_Winged_Warbler_0026_161813.jpg,500,500,161.Blue_winged_Warbler,142,125,345,432,243,278,203,307
../../CUB_200_2011/images\161.Blue_winged_Warbler/Blue_Winged_Warbler_0013_161816.jpg,500,345,161.Blue_winged_Warbler,167,56,326,273,246,164,159,217
../../CUB_200_2011/images\161.Blue_winged_Warbler/Blue_Winged_Warbler_0057_162085.jpg,500,333,161.Blue_winged_Warbler,177,137,280,260,228,198,103,123
../../CUB_200_2011/images\161.Blue_winged_Warbler/Blue_Winged_Warbler_0012_162086.jpg,409,500,161.Blue_winged_Warbler,35,154,299,413,167,283,264,259
../../CUB_200_2011/images\161.Blue_winged_Warbler/Blue_Winged_Warbler_0030_162088.jpg,378,500,161.Blue_winged_Warbler,92,224,258,393,175,308,166,169
../../CUB_200_2011/images\161.Blue_winged_Warbler/Blue_Winged_Warbler_0005_162095.jpg,500,380,161.Blue_winged_Warbler,102,86,325,281,213,183,223,195
../../CUB_200_2011/images\161.Blue_winged_Warbler/Blue_Winged_Warbler_0075_161844.jpg,500,324,161.Blue_winged_Warbler,195,92,302,256,248,174,107,164
../../CUB_200_2011/images\161.Blue_winged_Warbler/Blue_Winged_Warbler_0036_161758.jpg,500,371,161.Blue_winged_Warbler,178,127,408,290,293,208,230,163
../../CUB_200_2011/images\161.Blue_winged_Warbler/Blue_Winged_Warbler_0049_161856.jpg,333,500,161.Blue_winged_Warbler,61,87,201,338,131,212,140,251
../../CUB_200_2011/images\161.Blue_winged_Warbler/Blue_Winged_Warbler_0021_161858.jpg,500,333,161.Blue_winged_Warbler,132,67,499,332,315,199,367,265
../../CUB_200_2011/images\161.Blue_winged_Warbler/Blue_Winged_Warbler_0067_161860.jpg,500,375,161.Blue_winged_Warbler,6,138,335,373,170,255,329,235
../../CUB_200_2011/images\161.Blue_winged_Warbler/Blue_Winged_Warbler_0034_161861.jpg,500,442,161.Blue_winged_Warbler,62,97,371,373,216,235,309,276
../../CUB_200_2011/images\161.Blue_winged_Warbler/Blue_Winged_Warbler_0054_161862.jpg,500,400,161.Blue_winged_Warbler,140,103,423,297,281,200,283,194
../../CUB_200_2011/images\161.Blue_winged_Warbler/Blue_Winged_Warbler_0042_161869.jpg,500,379,161.Blue_winged_Warbler,97,122,384,333,240,227,287,211
../../CUB_200_2011/images\161.Blue_winged_Warbler/Blue_Winged_Warbler_0018_161871.jpg,376,500,161.Blue_winged_Warbler,49,74,266,386,157,230,217,312
../../CUB_200_2011/images\161.Blue_winged_Warbler/Blue_Winged_Warbler_0025_161873.jpg,500,330,161.Blue_winged_Warbler,68,91,443,295,255,193,375,204
../../CUB_200_2011/images\161.Blue_winged_Warbler/Blue_Winged_Warbler_0020_161875.jpg,500,334,161.Blue_winged_Warbler,186,54,436,214,311,134,250,160
../../CUB_200_2011/images\161.Blue_winged_Warbler/Blue_Winged_Warbler_0066_162062.jpg,500,334,161.Blue_winged_Warbler,175,109,416,315,295,212,241,206
../../CUB_200_2011/images\161.Blue_winged_Warbler/Blue_Winged_Warbler_0017_161878.jpg,500,375,161.Blue_winged_Warbler,124,102,388,299,256,200,264,197
../../CUB_200_2011/images\161.Blue_winged_Warbler/Blue_Winged_Warbler_0009_161880.jpg,500,393,161.Blue_winged_Warbler,124,113,467,337,295,225,343,224
../../CUB_200_2011/images\161.Blue_winged_Warbler/Blue_Winged_Warbler_0040_161883.jpg,500,400,161.Blue_winged_Warbler,166,120,352,264,259,192,186,144
../../CUB_200_2011/images\161.Blue_winged_Warbler/Blue_Winged_Warbler_0060_161888.jpg,500,333,161.Blue_winged_Warbler,1,40,473,331,237,185,472,291
../../CUB_200_2011/images\161.Blue_winged_Warbler/Blue_Winged_Warbler_0078_161889.jpg,500,375,161.Blue_winged_Warbler,122,97,334,356,228,226,212,259
../../CUB_200_2011/images\161.Blue_winged_Warbler/Blue_Winged_Warbler_0002_161890.jpg,430,500,161.Blue_winged_Warbler,136,131,362,428,249,279,226,297
../../CUB_200_2011/images\161.Blue_winged_Warbler/Blue_Winged_Warbler_0076_161894.jpg,500,392,161.Blue_winged_Warbler,145,135,294,257,219,196,149,122
../../CUB_200_2011/images\161.Blue_winged_Warbler/Blue_Winged_Warbler_0053_161896.jpg,400,500,161.Blue_winged_Warbler,71,202,245,370,158,286,174,168
../../CUB_200_2011/images\161.Blue_winged_Warbler/Blue_Winged_Warbler_0071_161900.jpg,500,358,161.Blue_winged_Warbler,184,91,454,271,319,181,270,180
../../CUB_200_2011/images\161.Blue_winged_Warbler/Blue_Winged_Warbler_0079_161909.jpg,500,333,161.Blue_winged_Warbler,103,93,324,280,213,186,221,187
../../CUB_200_2011/images\161.Blue_winged_Warbler/Blue_Winged_Warbler_0023_161774.jpg,418,382,161.Blue_winged_Warbler,108,151,330,306,219,228,222,155
../../CUB_200_2011/images\161.Blue_winged_Warbler/Blue_Winged_Warbler_0014_161783.jpg,500,357,161.Blue_winged_Warbler,222,150,436,287,329,218,214,137
../../CUB_200_2011/images\161.Blue_winged_Warbler/Blue_Winged_Warbler_0061_161984.jpg,500,400,161.Blue_winged_Warbler,240,103,343,233,291,168,103,130
../../CUB_200_2011/images\161.Blue_winged_Warbler/Blue_Winged_Warbler_0072_161991.jpg,472,500,161.Blue_winged_Warbler,108,193,226,339,167,266,118,146
../../CUB_200_2011/images\161.Blue_winged_Warbler/Blue_Winged_Warbler_0035_161741.jpg,500,363,161.Blue_winged_Warbler,169,112,427,266,298,189,258,154
../../CUB_200_2011/images\161.Blue_winged_Warbler/Blue_Winged_Warbler_0052_161739.jpg,332,500,161.Blue_winged_Warbler,18,284,270,404,144,344,252,120
../../CUB_200_2011/images\161.Blue_winged_Warbler/Blue_Winged_Warbler_0055_161996.jpg,500,489,161.Blue_winged_Warbler,48,30,422,485,235,257,374,455
../../CUB_200_2011/images\161.Blue_winged_Warbler/Blue_Winged_Warbler_0045_161997.jpg,500,364,161.Blue_winged_Warbler,201,142,332,258,266,200,131,116
../../CUB_200_2011/images\161.Blue_winged_Warbler/Blue_Winged_Warbler_0037_161999.jpg,500,375,161.Blue_winged_Warbler,99,123,339,332,219,227,240,209
../../CUB_200_2011/images\161.Blue_winged_Warbler/Blue_Winged_Warbler_0004_162005.jpg,500,375,161.Blue_winged_Warbler,34,116,345,357,189,236,311,241
../../CUB_200_2011/images\161.Blue_winged_Warbler/Blue_Winged_Warbler_0056_162013.jpg,500,335,161.Blue_winged_Warbler,140,65,293,232,216,148,153,167
../../CUB_200_2011/images\161.Blue_winged_Warbler/Blue_Winged_Warbler_0093_162014.jpg,500,352,161.Blue_winged_Warbler,304,99,473,216,388,157,169,117
../../CUB_200_2011/images\161.Blue_winged_Warbler/Blue_Winged_Warbler_0044_161760.jpg,500,335,161.Blue_winged_Warbler,56,109,301,263,178,186,245,154
../../CUB_200_2011/images\161.Blue_winged_Warbler/Blue_Winged_Warbler_0088_162018.jpg,500,389,161.Blue_winged_Warbler,144,74,327,306,235,190,183,232
../../CUB_200_2011/images\161.Blue_winged_Warbler/Blue_Winged_Warbler_0077_162021.jpg,500,333,161.Blue_winged_Warbler,154,108,296,208,225,158,142,100
../../CUB_200_2011/images\161.Blue_winged_Warbler/Blue_Winged_Warbler_0051_161766.jpg,500,384,161.Blue_winged_Warbler,179,102,344,308,261,205,165,206
../../CUB_200_2011/images\161.Blue_winged_Warbler/Blue_Winged_Warbler_0089_162026.jpg,500,333,161.Blue_winged_Warbler,167,60,335,269,251,164,168,209
../../CUB_200_2011/images\161.Blue_winged_Warbler/Blue_Winged_Warbler_0086_162027.jpg,500,375,161.Blue_winged_Warbler,1,114,440,355,220,234,439,241
../../CUB_200_2011/images\161.Blue_winged_Warbler/Blue_Winged_Warbler_0082_161772.jpg,500,500,161.Blue_winged_Warbler,12,72,401,442,206,257,389,370
../../CUB_200_2011/images\161.Blue_winged_Warbler/Blue_Winged_Warbler_0032_162029.jpg,500,334,161.Blue_winged_Warbler,0,73,461,334,230,203,461,261
../../CUB_200_2011/images\161.Blue_winged_Warbler/Blue_Winged_Warbler_0065_162030.jpg,500,319,161.Blue_winged_Warbler,122,79,260,205,191,142,138,126
../../CUB_200_2011/images\161.Blue_winged_Warbler/Blue_Winged_Warbler_0007_161785.jpg,500,333,161.Blue_winged_Warbler,59,72,463,293,261,182,404,221
../../CUB_200_2011/images\161.Blue_winged_Warbler/Blue_Winged_Warbler_0028_161787.jpg,500,408,161.Blue_winged_Warbler,114,134,340,287,227,210,226,153
../../CUB_200_2011/images\161.Blue_winged_Warbler/Blue_Winged_Warbler_0092_162044.jpg,500,374,161.Blue_winged_Warbler,209,136,383,270,296,203,174,134
../../CUB_200_2011/images\161.Blue_winged_Warbler/Blue_Winged_Warbler_0094_161790.jpg,500,400,161.Blue_winged_Warbler,89,122,266,305,177,213,177,183
../../CUB_200_2011/images\162.Canada_Warbler/Canada_Warbler_0094_26880.jpg,500,333,162.Canada_Warbler,23,117,344,311,183,214,321,194
../../CUB_200_2011/images\162.Canada_Warbler/Canada_Warbler_0119_162307.jpg,398,500,162.Canada_Warbler,81,116,223,466,152,291,142,350
../../CUB_200_2011/images\162.Canada_Warbler/Canada_Warbler_0115_162309.jpg,500,357,162.Canada_Warbler,120,74,348,271,234,172,228,197
../../CUB_200_2011/images\162.Canada_Warbler/Canada_Warbler_0121_162310.jpg,500,400,162.Canada_Warbler,50,34,453,296,251,165,403,262
../../CUB_200_2011/images\162.Canada_Warbler/Canada_Warbler_0067_162314.jpg,500,333,162.Canada_Warbler,38,63,307,330,172,196,269,267
../../CUB_200_2011/images\162.Canada_Warbler/Canada_Warbler_0063_162324.jpg,500,400,162.Canada_Warbler,83,130,362,323,222,226,279,193
../../CUB_200_2011/images\162.Canada_Warbler/Canada_Warbler_0021_162325.jpg,500,420,162.Canada_Warbler,141,141,293,245,217,193,152,104
../../CUB_200_2011/images\162.Canada_Warbler/Canada_Warbler_0048_162326.jpg,500,400,162.Canada_Warbler,24,99,355,266,189,182,331,167
../../CUB_200_2011/images\162.Canada_Warbler/Canada_Warbler_0006_103959.jpg,500,369,162.Canada_Warbler,182,119,363,226,272,172,181,107
../../CUB_200_2011/images\162.Canada_Warbler/Canada_Warbler_0039_162330.jpg,500,333,162.Canada_Warbler,213,47,449,296,331,171,236,249
../../CUB_200_2011/images\162.Canada_Warbler/Canada_Warbler_0004_162224.jpg,500,305,162.Canada_Warbler,136,108,338,231,237,169,202,123
../../CUB_200_2011/images\162.Canada_Warbler/Canada_Warbler_0103_162339.jpg,500,339,162.Canada_Warbler,27,44,312,305,169,174,285,261
../../CUB_200_2011/images\162.Canada_Warbler/Canada_Warbler_0088_162341.jpg,420,280,162.Canada_Warbler,84,72,400,213,242,142,316,141
../../CUB_200_2011/images\162.Canada_Warbler/Canada_Warbler_0087_162342.jpg,322,500,162.Canada_Warbler,9,112,275,418,142,265,266,306
../../CUB_200_2011/images\162.Canada_Warbler/Canada_Warbler_0009_162343.jpg,500,333,162.Canada_Warbler,161,128,438,305,299,216,277,177
../../CUB_200_2011/images\162.Canada_Warbler/Canada_Warbler_0104_162345.jpg,500,357,162.Canada_Warbler,53,23,409,346,231,184,356,323
../../CUB_200_2011/images\162.Canada_Warbler/Canada_Warbler_0022_157106.jpg,500,302,162.Canada_Warbler,31,31,443,273,237,152,412,242
../../CUB_200_2011/images\162.Canada_Warbler/Canada_Warbler_0040_162352.jpg,500,375,162.Canada_Warbler,128,145,297,273,212,209,169,128
../../CUB_200_2011/images\162.Canada_Warbler/Canada_Warbler_0020_162354.jpg,500,375,162.Canada_Warbler,179,137,437,328,308,232,258,191
../../CUB_200_2011/images\162.Canada_Warbler/Canada_Warbler_0093_162356.jpg,500,408,162.Canada_Warbler,279,159,395,287,337,223,116,128
../../CUB_200_2011/images\162.Canada_Warbler/Canada_Warbler_0007_162364.jpg,500,333,162.Canada_Warbler,62,63,374,221,218,142,312,158
../../CUB_200_2011/images\162.Canada_Warbler/Canada_Warbler_0074_162366.jpg,500,333,162.Canada_Warbler,131,56,419,288,275,172,288,232
../../CUB_200_2011/images\162.Canada_Warbler/Canada_Warbler_0105_162372.jpg,377,500,162.Canada_Warbler,101,98,240,399,170,248,139,301
../../CUB_200_2011/images\162.Canada_Warbler/Canada_Warbler_0013_162375.jpg,500,334,162.Canada_Warbler,168,80,307,224,237,152,139,144
../../CUB_200_2011/images\162.Canada_Warbler/Canada_Warbler_0035_162377.jpg,355,466,162.Canada_Warbler,91,57,265,409,178,233,174,352
../../CUB_200_2011/images\162.Canada_Warbler/Canada_Warbler_0091_162378.jpg,500,458,162.Canada_Warbler,144,171,367,298,255,234,223,127
../../CUB_200_2011/images\162.Canada_Warbler/Canada_Warbler_0049_162379.jpg,474,500,162.Canada_Warbler,38,41,419,492,228,266,381,451
../../CUB_200_2011/images\162.Canada_Warbler/Canada_Warbler_0023_162383.jpg,500,411,162.Canada_Warbler,153,168,434,298,293,233,281,130
../../CUB_200_2011/images\162.Canada_Warbler/Canada_Warbler_0085_162385.jpg,500,302,162.Canada_Warbler,57,60,499,301,278,180,442,241
../../CUB_200_2011/images\162.Canada_Warbler/Canada_Warbler_0015_162388.jpg,500,333,162.Canada_Warbler,167,135,288,250,227,192,121,115
../../CUB_200_2011/images\162.Canada_Warbler/Canada_Warbler_0005_162389.jpg,500,488,162.Canada_Warbler,181,148,355,310,268,229,174,162
../../CUB_200_2011/images\162.Canada_Warbler/Canada_Warbler_0080_162392.jpg,500,386,162.Canada_Warbler,115,144,294,290,204,217,179,146
../../CUB_200_2011/images\162.Canada_Warbler/Canada_Warbler_0076_162393.jpg,500,352,162.Canada_Warbler,190,117,354,236,272,176,164,119
../../CUB_200_2011/images\162.Canada_Warbler/Canada_Warbler_0117_162394.jpg,500,427,162.Canada_Warbler,131,45,423,422,277,233,292,377
../../CUB_200_2011/images\162.Canada_Warbler/Canada_Warbler_0114_162396.jpg,500,390,162.Canada_Warbler,53,40,472,386,262,213,419,346
../../CUB_200_2011/images\162.Canada_Warbler/Canada_Warbler_0112_162398.jpg,500,333,162.Canada_Warbler,100,71,218,304,159,187,118,233
../../CUB_200_2011/images\162.Canada_Warbler/Canada_Warbler_0095_162401.jpg,500,355,162.Canada_Warbler,222,129,394,298,308,213,172,169
../../CUB_200_2011/images\162.Canada_Warbler/Canada_Warbler_0113_162403.jpg,500,334,162.Canada_Warbler,181,97,350,235,265,166,169,138
../../CUB_200_2011/images\162.Canada_Warbler/Canada_Warbler_0037_162405.jpg,500,336,162.Canada_Warbler,105,82,403,296,254,189,298,214
../../CUB_200_2011/images\162.Canada_Warbler/Canada_Warbler_0056_162407.jpg,500,375,162.Canada_Warbler,77,116,320,324,198,220,243,208
../../CUB_200_2011/images\162.Canada_Warbler/Canada_Warbler_0019_162409.jpg,500,330,162.Canada_Warbler,67,84,301,242,184,163,234,158
../../CUB_200_2011/images\162.Canada_Warbler/Canada_Warbler_0016_162411.jpg,500,334,162.Canada_Warbler,203,110,499,236,351,173,296,126
../../CUB_200_2011/images\162.Canada_Warbler/Canada_Warbler_0120_162415.jpg,500,333,162.Canada_Warbler,126,81,329,231,227,156,203,150
../../CUB_200_2011/images\162.Canada_Warbler/Canada_Warbler_0008_162416.jpg,375,500,162.Canada_Warbler,1,129,371,480,186,304,370,351
../../CUB_200_2011/images\162.Canada_Warbler/Canada_Warbler_0064_162417.jpg,500,364,162.Canada_Warbler,206,136,415,305,310,220,209,169
../../CUB_200_2011/images\162.Canada_Warbler/Canada_Warbler_0041_162418.jpg,500,335,162.Canada_Warbler,266,100,387,260,326,180,121,160
../../CUB_200_2011/images\162.Canada_Warbler/Canada_Warbler_0099_162425.jpg,500,333,162.Canada_Warbler,60,96,398,257,229,176,338,161
../../CUB_200_2011/images\162.Canada_Warbler/Canada_Warbler_0002_162426.jpg,500,333,162.Canada_Warbler,224,104,404,245,314,174,180,141
../../CUB_200_2011/images\162.Canada_Warbler/Canada_Warbler_0075_162428.jpg,500,330,162.Canada_Warbler,193,137,435,271,314,204,242,134
../../CUB_200_2011/images\162.Canada_Warbler/Canada_Warbler_0090_162432.jpg,500,399,162.Canada_Warbler,123,43,312,248,217,145,189,205
../../CUB_200_2011/images\162.Canada_Warbler/Canada_Warbler_0077_162437.jpg,500,456,162.Canada_Warbler,3,29,468,452,235,240,465,423
../../CUB_200_2011/images\162.Canada_Warbler/Canada_Warbler_0047_162439.jpg,328,245,162.Canada_Warbler,53,63,218,215,135,139,165,152
../../CUB_200_2011/images\162.Canada_Warbler/Canada_Warbler_0107_162440.jpg,500,333,162.Canada_Warbler,62,59,372,277,217,168,310,218
../../CUB_200_2011/images\162.Canada_Warbler/Canada_Warbler_0051_162447.jpg,500,288,162.Canada_Warbler,143,57,391,244,267,150,248,187
../../CUB_200_2011/images\162.Canada_Warbler/Canada_Warbler_0042_162448.jpg,500,500,162.Canada_Warbler,84,125,409,347,246,236,325,222
../../CUB_200_2011/images\162.Canada_Warbler/Canada_Warbler_0024_162218.jpg,500,376,162.Canada_Warbler,174,95,276,243,225,169,102,148
../../CUB_200_2011/images\162.Canada_Warbler/Canada_Warbler_0122_162219.jpg,500,326,162.Canada_Warbler,168,128,384,253,276,190,216,125
../../CUB_200_2011/images\162.Canada_Warbler/Canada_Warbler_0027_162223.jpg,500,375,162.Canada_Warbler,164,92,366,326,265,209,202,234
../../CUB_200_2011/images\162.Canada_Warbler/Canada_Warbler_0109_93363.jpg,500,333,162.Canada_Warbler,40,47,475,282,257,164,435,235
../../CUB_200_2011/images\162.Canada_Warbler/Canada_Warbler_0032_162229.jpg,500,386,162.Canada_Warbler,139,103,355,294,247,198,216,191
../../CUB_200_2011/images\163.Cape_May_Warbler/Cape_May_Warbler_0001_139008.jpg,500,357,163.Cape_May_Warbler,41,62,407,297,224,179,366,235
../../CUB_200_2011/images\163.Cape_May_Warbler/Cape_May_Warbler_0076_163075.jpg,500,412,163.Cape_May_Warbler,102,100,463,376,282,238,361,276
../../CUB_200_2011/images\163.Cape_May_Warbler/Cape_May_Warbler_0117_163079.jpg,500,396,163.Cape_May_Warbler,191,120,400,250,295,185,209,130
../../CUB_200_2011/images\163.Cape_May_Warbler/Cape_May_Warbler_0093_163089.jpg,500,333,163.Cape_May_Warbler,163,103,384,238,273,170,221,135
../../CUB_200_2011/images\163.Cape_May_Warbler/Cape_May_Warbler_0096_163093.jpg,500,334,163.Cape_May_Warbler,0,106,357,333,178,219,357,227
../../CUB_200_2011/images\163.Cape_May_Warbler/Cape_May_Warbler_0108_163108.jpg,500,440,163.Cape_May_Warbler,26,175,402,324,214,249,376,149
../../CUB_200_2011/images\163.Cape_May_Warbler/Cape_May_Warbler_0115_163121.jpg,500,412,163.Cape_May_Warbler,189,50,388,254,288,152,199,204
../../CUB_200_2011/images\163.Cape_May_Warbler/Cape_May_Warbler_0113_163130.jpg,500,375,163.Cape_May_Warbler,56,129,413,329,234,229,357,200
../../CUB_200_2011/images\163.Cape_May_Warbler/Cape_May_Warbler_0122_163131.jpg,500,361,163.Cape_May_Warbler,186,95,473,293,329,194,287,198
../../CUB_200_2011/images\163.Cape_May_Warbler/Cape_May_Warbler_0023_163133.jpg,500,332,163.Cape_May_Warbler,52,83,476,305,264,194,424,222
../../CUB_200_2011/images\163.Cape_May_Warbler/Cape_May_Warbler_0033_162657.jpg,500,368,163.Cape_May_Warbler,230,93,394,230,312,161,164,137
../../CUB_200_2011/images\163.Cape_May_Warbler/Cape_May_Warbler_0085_162628.jpg,500,385,163.Cape_May_Warbler,41,115,292,353,166,234,251,238
../../CUB_200_2011/images\163.Cape_May_Warbler/Cape_May_Warbler_0020_162629.jpg,500,332,163.Cape_May_Warbler,164,79,302,200,233,139,138,121
../../CUB_200_2011/images\163.Cape_May_Warbler/Cape_May_Warbler_0068_163147.jpg,500,333,163.Cape_May_Warbler,2,50,331,304,166,177,329,254
../../CUB_200_2011/images\163.Cape_May_Warbler/Cape_May_Warbler_0088_163149.jpg,500,323,163.Cape_May_Warbler,238,96,384,266,311,181,146,170
../../CUB_200_2011/images\163.Cape_May_Warbler/Cape_May_Warbler_0101_163169.jpg,500,375,163.Cape_May_Warbler,191,80,386,274,288,177,195,194
../../CUB_200_2011/images\163.Cape_May_Warbler/Cape_May_Warbler_0048_162915.jpg,398,500,163.Cape_May_Warbler,53,156,321,353,187,254,268,197
../../CUB_200_2011/images\163.Cape_May_Warbler/Cape_May_Warbler_0129_163157.jpg,500,333,163.Cape_May_Warbler,54,137,277,250,165,193,223,113
../../CUB_200_2011/images\163.Cape_May_Warbler/Cape_May_Warbler_0015_163159.jpg,500,375,163.Cape_May_Warbler,140,144,265,281,202,212,125,137
../../CUB_200_2011/images\163.Cape_May_Warbler/Cape_May_Warbler_0007_163087.jpg,500,375,163.Cape_May_Warbler,120,159,307,269,213,214,187,110
../../CUB_200_2011/images\163.Cape_May_Warbler/Cape_May_Warbler_0049_162909.jpg,500,339,163.Cape_May_Warbler,30,40,428,291,229,165,398,251
../../CUB_200_2011/images\163.Cape_May_Warbler/Cape_May_Warbler_0046_163167.jpg,500,333,163.Cape_May_Warbler,0,83,343,285,171,184,343,202
../../CUB_200_2011/images\163.Cape_May_Warbler/Cape_May_Warbler_0022_162912.jpg,500,365,163.Cape_May_Warbler,167,121,353,248,260,184,186,127
../../CUB_200_2011/images\163.Cape_May_Warbler/Cape_May_Warbler_0026_162913.jpg,347,500,163.Cape_May_Warbler,54,161,275,410,164,285,221,249
../../CUB_200_2011/images\163.Cape_May_Warbler/Cape_May_Warbler_0035_162658.jpg,500,411,163.Cape_May_Warbler,0,79,414,407,207,243,414,328
../../CUB_200_2011/images\163.Cape_May_Warbler/Cape_May_Warbler_0055_163171.jpg,500,375,163.Cape_May_Warbler,27,58,482,277,254,167,455,219
../../CUB_200_2011/images\163.Cape_May_Warbler/Cape_May_Warbler_0043_163172.jpg,424,500,163.Cape_May_Warbler,231,222,390,373,310,297,159,151
../../CUB_200_2011/images\163.Cape_May_Warbler/Cape_May_Warbler_0003_162920.jpg,500,441,163.Cape_May_Warbler,43,64,472,390,257,227,429,326
../../CUB_200_2011/images\163.Cape_May_Warbler/Cape_May_Warbler_0028_163177.jpg,500,281,163.Cape_May_Warbler,245,57,385,216,315,136,140,159
../../CUB_200_2011/images\163.Cape_May_Warbler/Cape_May_Warbler_0100_162923.jpg,500,399,163.Cape_May_Warbler,139,149,374,366,256,257,235,217
../../CUB_200_2011/images\163.Cape_May_Warbler/Cape_May_Warbler_0004_162928.jpg,500,375,163.Cape_May_Warbler,183,118,334,249,258,183,151,131
../../CUB_200_2011/images\163.Cape_May_Warbler/Cape_May_Warbler_0081_162936.jpg,500,333,163.Cape_May_Warbler,167,120,466,269,316,194,299,149
../../CUB_200_2011/images\163.Cape_May_Warbler/Cape_May_Warbler_0032_162659.jpg,500,376,163.Cape_May_Warbler,118,114,385,256,251,185,267,142
../../CUB_200_2011/images\163.Cape_May_Warbler/Cape_May_Warbler_0107_162941.jpg,333,500,163.Cape_May_Warbler,109,137,233,357,171,247,124,220
../../CUB_200_2011/images\163.Cape_May_Warbler/Cape_May_Warbler_0058_162948.jpg,404,500,163.Cape_May_Warbler,76,173,286,280,181,226,210,107
../../CUB_200_2011/images\163.Cape_May_Warbler/Cape_May_Warbler_0060_162949.jpg,420,280,163.Cape_May_Warbler,86,75,394,209,240,142,308,134
../../CUB_200_2011/images\163.Cape_May_Warbler/Cape_May_Warbler_0053_162950.jpg,500,375,163.Cape_May_Warbler,63,70,400,372,231,221,337,302
../../CUB_200_2011/images\163.Cape_May_Warbler/Cape_May_Warbler_0013_163052.jpg,500,363,163.Cape_May_Warbler,244,163,411,264,327,213,167,101
../../CUB_200_2011/images\163.Cape_May_Warbler/Cape_May_Warbler_0062_162955.jpg,500,333,163.Cape_May_Warbler,115,68,395,275,255,171,280,207
../../CUB_200_2011/images\163.Cape_May_Warbler/Cape_May_Warbler_0012_162701.jpg,485,500,163.Cape_May_Warbler,162,137,361,383,261,260,199,246
../../CUB_200_2011/images\163.Cape_May_Warbler/Cape_May_Warbler_0104_162958.jpg,357,500,163.Cape_May_Warbler,24,63,310,441,167,252,286,378
../../CUB_200_2011/images\163.Cape_May_Warbler/Cape_May_Warbler_0111_162959.jpg,500,371,163.Cape_May_Warbler,47,151,347,288,197,219,300,137
../../CUB_200_2011/images\163.Cape_May_Warbler/Cape_May_Warbler_0095_162965.jpg,500,351,163.Cape_May_Warbler,20,49,483,319,251,184,463,270
../../CUB_200_2011/images\163.Cape_May_Warbler/Cape_May_Warbler_0005_163197.jpg,499,500,163.Cape_May_Warbler,45,184,465,331,255,257,420,147
../../CUB_200_2011/images\163.Cape_May_Warbler/Cape_May_Warbler_0128_162971.jpg,500,365,163.Cape_May_Warbler,164,109,293,266,228,187,129,157
../../CUB_200_2011/images\163.Cape_May_Warbler/Cape_May_Warbler_0103_162972.jpg,500,333,163.Cape_May_Warbler,218,132,443,301,330,216,225,169
../../CUB_200_2011/images\163.Cape_May_Warbler/Cape_May_Warbler_0119_162976.jpg,370,347,163.Cape_May_Warbler,10,10,312,329,161,169,302,319
../../CUB_200_2011/images\163.Cape_May_Warbler/Cape_May_Warbler_0077_162979.jpg,500,401,163.Cape_May_Warbler,144,100,337,287,240,193,193,187
../../CUB_200_2011/images\163.Cape_May_Warbler/Cape_May_Warbler_0069_162980.jpg,500,375,163.Cape_May_Warbler,118,135,352,323,235,229,234,188
../../CUB_200_2011/images\163.Cape_May_Warbler/Cape_May_Warbler_0092_163057.jpg,500,375,163.Cape_May_Warbler,1,126,410,372,205,249,409,246
../../CUB_200_2011/images\163.Cape_May_Warbler/Cape_May_Warbler_0073_162993.jpg,500,333,163.Cape_May_Warbler,240,74,351,188,295,131,111,114
../../CUB_200_2011/images\163.Cape_May_Warbler/Cape_May_Warbler_0066_163005.jpg,500,333,163.Cape_May_Warbler,17,85,348,290,182,187,331,205
../../CUB_200_2011/images\163.Cape_May_Warbler/Cape_May_Warbler_0031_163012.jpg,500,354,163.Cape_May_Warbler,14,128,361,345,187,236,347,217
../../CUB_200_2011/images\163.Cape_May_Warbler/Cape_May_Warbler_0008_163062.jpg,500,297,163.Cape_May_Warbler,109,38,457,224,283,131,348,186
../../CUB_200_2011/images\163.Cape_May_Warbler/Cape_May_Warbler_0040_163036.jpg,500,477,163.Cape_May_Warbler,139,122,318,382,228,252,179,260
../../CUB_200_2011/images\163.Cape_May_Warbler/Cape_May_Warbler_0124_163037.jpg,463,500,163.Cape_May_Warbler,163,187,318,321,240,254,155,134
../../CUB_200_2011/images\163.Cape_May_Warbler/Cape_May_Warbler_0067_162539.jpg,500,381,163.Cape_May_Warbler,91,35,476,356,283,195,385,321
../../CUB_200_2011/images\163.Cape_May_Warbler/Cape_May_Warbler_0044_163055.jpg,500,384,163.Cape_May_Warbler,39,116,280,351,159,233,241,235
../../CUB_200_2011/images\163.Cape_May_Warbler/Cape_May_Warbler_0061_163061.jpg,500,319,163.Cape_May_Warbler,36,93,286,289,161,191,250,196
../../CUB_200_2011/images\163.Cape_May_Warbler/Cape_May_Warbler_0084_163132.jpg,500,358,163.Cape_May_Warbler,192,14,398,339,295,176,206,325
../../CUB_200_2011/images\164.Cerulean_Warbler/Cerulean_Warbler_0019_797186.jpg,500,333,164.Cerulean_Warbler,40,88,369,278,204,183,329,190
../../CUB_200_2011/images\164.Cerulean_Warbler/Cerulean_Warbler_0091_163331.jpg,500,375,164.Cerulean_Warbler,116,105,337,301,226,203,221,196
../../CUB_200_2011/images\164.Cerulean_Warbler/Cerulean_Warbler_0022_797189.jpg,283,221,164.Cerulean_Warbler,47,30,234,189,140,109,187,159
../../CUB_200_2011/images\164.Cerulean_Warbler/Cerulean_Warbler_0023_797191.jpg,400,370,164.Cerulean_Warbler,67,63,302,284,184,173,235,221
../../CUB_200_2011/images\164.Cerulean_Warbler/Cerulean_Warbler_0088_797194.jpg,500,360,164.Cerulean_Warbler,225,83,426,316,325,199,201,233
../../CUB_200_2011/images\164.Cerulean_Warbler/Cerulean_Warbler_0056_163339.jpg,500,368,164.Cerulean_Warbler,148,127,293,252,220,189,145,125
../../CUB_200_2011/images\164.Cerulean_Warbler/Cerulean_Warbler_0093_797196.jpg,350,236,164.Cerulean_Warbler,89,81,332,187,210,134,243,106
../../CUB_200_2011/images\164.Cerulean_Warbler/Cerulean_Warbler_0053_797197.jpg,200,182,164.Cerulean_Warbler,10,17,199,181,104,99,189,164
../../CUB_200_2011/images\164.Cerulean_Warbler/Cerulean_Warbler_0017_797198.jpg,500,332,164.Cerulean_Warbler,144,82,391,245,267,163,247,163
../../CUB_200_2011/images\164.Cerulean_Warbler/Cerulean_Warbler_0004_797199.jpg,500,335,164.Cerulean_Warbler,63,56,390,265,226,160,327,209
../../CUB_200_2011/images\164.Cerulean_Warbler/Cerulean_Warbler_0094_797200.jpg,500,500,164.Cerulean_Warbler,48,92,464,403,256,247,416,311
../../CUB_200_2011/images\164.Cerulean_Warbler/Cerulean_Warbler_0009_797201.jpg,500,381,164.Cerulean_Warbler,74,83,451,349,262,216,377,266
../../CUB_200_2011/images\164.Cerulean_Warbler/Cerulean_Warbler_0077_797202.jpg,261,229,164.Cerulean_Warbler,31,65,257,200,144,132,226,135
../../CUB_200_2011/images\164.Cerulean_Warbler/Cerulean_Warbler_0043_797203.jpg,334,500,164.Cerulean_Warbler,26,115,223,332,124,223,197,217
../../CUB_200_2011/images\164.Cerulean_Warbler/Cerulean_Warbler_0063_797204.jpg,434,385,164.Cerulean_Warbler,116,77,324,250,220,163,208,173
../../CUB_200_2011/images\164.Cerulean_Warbler/Cerulean_Warbler_0005_797206.jpg,500,361,164.Cerulean_Warbler,159,124,477,281,318,202,318,157
../../CUB_200_2011/images\164.Cerulean_Warbler/Cerulean_Warbler_0060_797209.jpg,500,333,164.Cerulean_Warbler,95,73,477,248,286,160,382,175
../../CUB_200_2011/images\164.Cerulean_Warbler/Cerulean_Warbler_0010_797210.jpg,500,353,164.Cerulean_Warbler,41,106,392,289,216,197,351,183
../../CUB_200_2011/images\164.Cerulean_Warbler/Cerulean_Warbler_0047_797211.jpg,500,326,164.Cerulean_Warbler,114,94,316,239,215,166,202,145
../../CUB_200_2011/images\164.Cerulean_Warbler/Cerulean_Warbler_0037_797212.jpg,500,334,164.Cerulean_Warbler,170,94,438,223,304,158,268,129
../../CUB_200_2011/images\164.Cerulean_Warbler/Cerulean_Warbler_0007_797215.jpg,500,332,164.Cerulean_Warbler,110,90,291,235,200,162,181,145
../../CUB_200_2011/images\164.Cerulean_Warbler/Cerulean_Warbler_0045_797217.jpg,500,333,164.Cerulean_Warbler,41,59,469,281,255,170,428,222
../../CUB_200_2011/images\164.Cerulean_Warbler/Cerulean_Warbler_0067_797220.jpg,150,150,164.Cerulean_Warbler,5,15,136,148,70,81,131,133
../../CUB_200_2011/images\164.Cerulean_Warbler/Cerulean_Warbler_0046_797222.jpg,500,375,164.Cerulean_Warbler,46,144,298,333,172,238,252,189
../../CUB_200_2011/images\164.Cerulean_Warbler/Cerulean_Warbler_0042_797223.jpg,500,400,164.Cerulean_Warbler,32,62,329,353,180,207,297,291
../../CUB_200_2011/images\164.Cerulean_Warbler/Cerulean_Warbler_0014_797226.jpg,500,375,164.Cerulean_Warbler,184,125,471,334,327,229,287,209
../../CUB_200_2011/images\164.Cerulean_Warbler/Cerulean_Warbler_0038_797230.jpg,350,350,164.Cerulean_Warbler,27,85,317,289,172,187,290,204
../../CUB_200_2011/images\164.Cerulean_Warbler/Cerulean_Warbler_0075_797233.jpg,166,200,164.Cerulean_Warbler,24,27,159,192,91,109,135,165
../../CUB_200_2011/images\164.Cerulean_Warbler/Cerulean_Warbler_0054_797235.jpg,250,185,164.Cerulean_Warbler,20,15,238,155,129,85,218,140
../../CUB_200_2011/images\164.Cerulean_Warbler/Cerulean_Warbler_0083_163380.jpg,500,326,164.Cerulean_Warbler,165,13,485,308,325,160,320,295
../../CUB_200_2011/images\164.Cerulean_Warbler/Cerulean_Warbler_0090_797195.jpg,500,332,164.Cerulean_Warbler,221,73,443,264,332,168,222,191
../../CUB_200_2011/images\164.Cerulean_Warbler/Cerulean_Warbler_0080_163399.jpg,500,375,164.Cerulean_Warbler,137,129,303,236,220,182,166,107
../../CUB_200_2011/images\164.Cerulean_Warbler/Cerulean_Warbler_0024_163406.jpg,500,375,164.Cerulean_Warbler,93,57,484,286,288,171,391,229
../../CUB_200_2011/images\164.Cerulean_Warbler/Cerulean_Warbler_0089_163412.jpg,500,286,164.Cerulean_Warbler,26,114,234,244,130,179,208,130
../../CUB_200_2011/images\164.Cerulean_Warbler/Cerulean_Warbler_0012_163417.jpg,500,333,164.Cerulean_Warbler,199,114,458,280,328,197,259,166
../../CUB_200_2011/images\164.Cerulean_Warbler/Cerulean_Warbler_0039_163420.jpg,500,331,164.Cerulean_Warbler,171,112,409,284,290,198,238,172
../../CUB_200_2011/images\164.Cerulean_Warbler/Cerulean_Warbler_0087_163451.jpg,180,180,164.Cerulean_Warbler,1,26,169,148,85,87,168,122
../../CUB_200_2011/images\164.Cerulean_Warbler/Cerulean_Warbler_0092_163455.jpg,500,375,164.Cerulean_Warbler,145,65,330,269,237,167,185,204
../../CUB_200_2011/images\164.Cerulean_Warbler/Cerulean_Warbler_0072_163200.jpg,382,500,164.Cerulean_Warbler,41,67,345,416,193,241,304,349
../../CUB_200_2011/images\164.Cerulean_Warbler/Cerulean_Warbler_0071_163201.jpg,500,357,164.Cerulean_Warbler,112,110,290,276,201,193,178,166
../../CUB_200_2011/images\164.Cerulean_Warbler/Cerulean_Warbler_0040_163219.jpg,500,421,164.Cerulean_Warbler,155,82,390,355,272,218,235,273
../../CUB_200_2011/images\164.Cerulean_Warbler/Cerulean_Warbler_0020_163353.jpg,389,300,164.Cerulean_Warbler,80,63,361,225,220,144,281,162
../../CUB_200_2011/images\164.Cerulean_Warbler/Cerulean_Warbler_0057_163227.jpg,500,363,164.Cerulean_Warbler,30,131,377,336,203,233,347,205
../../CUB_200_2011/images\164.Cerulean_Warbler/Cerulean_Warbler_0051_163244.jpg,500,333,164.Cerulean_Warbler,48,128,281,285,164,206,233,157
../../CUB_200_2011/images\164.Cerulean_Warbler/Cerulean_Warbler_0086_797214.jpg,400,280,164.Cerulean_Warbler,61,51,305,227,183,139,244,176
../../CUB_200_2011/images\164.Cerulean_Warbler/Cerulean_Warbler_0016_163265.jpg,401,336,164.Cerulean_Warbler,72,75,334,277,203,176,262,202
../../CUB_200_2011/images\164.Cerulean_Warbler/Cerulean_Warbler_0055_163524.jpg,500,397,164.Cerulean_Warbler,140,68,338,284,239,176,198,216
../../CUB_200_2011/images\164.Cerulean_Warbler/Cerulean_Warbler_0035_163269.jpg,500,329,164.Cerulean_Warbler,157,75,469,255,313,165,312,180
../../CUB_200_2011/images\164.Cerulean_Warbler/Cerulean_Warbler_0078_163271.jpg,500,362,164.Cerulean_Warbler,171,91,487,298,329,194,316,207
../../CUB_200_2011/images\164.Cerulean_Warbler/Cerulean_Warbler_0041_163535.jpg,500,408,164.Cerulean_Warbler,55,120,351,305,203,212,296,185
../../CUB_200_2011/images\164.Cerulean_Warbler/Cerulean_Warbler_0002_797219.jpg,300,238,164.Cerulean_Warbler,87,70,234,181,160,125,147,111
../../CUB_200_2011/images\164.Cerulean_Warbler/Cerulean_Warbler_0076_163294.jpg,500,369,164.Cerulean_Warbler,103,80,364,288,233,184,261,208
../../CUB_200_2011/images\164.Cerulean_Warbler/Cerulean_Warbler_0028_163302.jpg,500,338,164.Cerulean_Warbler,58,74,283,219,170,146,225,145
../../CUB_200_2011/images\164.Cerulean_Warbler/Cerulean_Warbler_0003_163305.jpg,500,385,164.Cerulean_Warbler,39,133,446,321,242,227,407,188
../../CUB_200_2011/images\164.Cerulean_Warbler/Cerulean_Warbler_0025_797232.jpg,500,400,164.Cerulean_Warbler,17,23,240,277,128,150,223,254
../../CUB_200_2011/images\164.Cerulean_Warbler/Cerulean_Warbler_0033_797176.jpg,300,401,164.Cerulean_Warbler,19,132,270,390,144,261,251,258
../../CUB_200_2011/images\164.Cerulean_Warbler/Cerulean_Warbler_0084_797177.jpg,500,334,164.Cerulean_Warbler,54,60,397,263,225,161,343,203
../../CUB_200_2011/images\164.Cerulean_Warbler/Cerulean_Warbler_0081_797179.jpg,500,500,164.Cerulean_Warbler,109,130,438,408,273,269,329,278
../../CUB_200_2011/images\164.Cerulean_Warbler/Cerulean_Warbler_0082_797180.jpg,320,288,164.Cerulean_Warbler,25,63,309,243,167,153,284,180
../../CUB_200_2011/images\164.Cerulean_Warbler/Cerulean_Warbler_0018_797183.jpg,500,335,164.Cerulean_Warbler,191,107,433,246,312,176,242,139
../../CUB_200_2011/images\165.Chestnut_sided_Warbler/Chestnut_Sided_Warbler_0098_164352.jpg,500,458,165.Chestnut_sided_Warbler,40,97,466,436,253,266,426,339
../../CUB_200_2011/images\165.Chestnut_sided_Warbler/Chestnut_Sided_Warbler_0038_164354.jpg,500,333,165.Chestnut_sided_Warbler,185,105,408,271,296,188,223,166
../../CUB_200_2011/images\165.Chestnut_sided_Warbler/Chestnut_Sided_Warbler_0035_163587.jpg,500,333,165.Chestnut_sided_Warbler,27,47,366,269,196,158,339,222
../../CUB_200_2011/images\165.Chestnut_sided_Warbler/Chestnut_Sided_Warbler_0108_164356.jpg,500,333,165.Chestnut_sided_Warbler,154,7,442,264,298,135,288,257
../../CUB_200_2011/images\165.Chestnut_sided_Warbler/Chestnut_Sided_Warbler_0030_163847.jpg,500,500,165.Chestnut_sided_Warbler,57,105,398,437,227,271,341,332
../../CUB_200_2011/images\165.Chestnut_sided_Warbler/Chestnut_Sided_Warbler_0124_164109.jpg,500,385,165.Chestnut_sided_Warbler,120,179,316,319,218,249,196,140
../../CUB_200_2011/images\165.Chestnut_sided_Warbler/Chestnut_Sided_Warbler_0081_163854.jpg,500,393,165.Chestnut_sided_Warbler,73,121,314,308,193,214,241,187
../../CUB_200_2011/images\165.Chestnut_sided_Warbler/Chestnut_Sided_Warbler_0046_163856.jpg,500,500,165.Chestnut_sided_Warbler,74,149,345,316,209,232,271,167
../../CUB_200_2011/images\165.Chestnut_sided_Warbler/Chestnut_Sided_Warbler_0096_163672.jpg,500,369,165.Chestnut_sided_Warbler,40,64,323,257,181,160,283,193
../../CUB_200_2011/images\165.Chestnut_sided_Warbler/Chestnut_Sided_Warbler_0006_163858.jpg,500,343,165.Chestnut_sided_Warbler,152,139,354,249,253,194,202,110
../../CUB_200_2011/images\165.Chestnut_sided_Warbler/Chestnut_Sided_Warbler_0062_163859.jpg,500,360,165.Chestnut_sided_Warbler,174,121,393,312,283,216,219,191
../../CUB_200_2011/images\165.Chestnut_sided_Warbler/Chestnut_Sided_Warbler_0127_163860.jpg,500,333,165.Chestnut_sided_Warbler,125,78,346,288,235,183,221,210
../../CUB_200_2011/images\165.Chestnut_sided_Warbler/Chestnut_Sided_Warbler_0033_163607.jpg,500,307,165.Chestnut_sided_Warbler,111,128,250,246,180,187,139,118
../../CUB_200_2011/images\165.Chestnut_sided_Warbler/Chestnut_Sided_Warbler_0073_163868.jpg,500,339,165.Chestnut_sided_Warbler,242,148,426,267,334,207,184,119
../../CUB_200_2011/images\165.Chestnut_sided_Warbler/Chestnut_Sided_Warbler_0121_164125.jpg,500,320,165.Chestnut_sided_Warbler,62,41,499,320,280,180,437,279
../../CUB_200_2011/images\165.Chestnut_sided_Warbler/Chestnut_Sided_Warbler_0053_163615.jpg,500,357,165.Chestnut_sided_Warbler,105,72,257,285,181,178,152,213
../../CUB_200_2011/images\165.Chestnut_sided_Warbler/Chestnut_Sided_Warbler_0084_163872.jpg,500,500,165.Chestnut_sided_Warbler,79,180,437,423,258,301,358,243
../../CUB_200_2011/images\165.Chestnut_sided_Warbler/Chestnut_Sided_Warbler_0036_163622.jpg,500,400,165.Chestnut_sided_Warbler,199,69,445,230,322,149,246,161
../../CUB_200_2011/images\165.Chestnut_sided_Warbler/Chestnut_Sided_Warbler_0090_163629.jpg,500,375,165.Chestnut_sided_Warbler,172,59,407,295,289,177,235,236
../../CUB_200_2011/images\165.Chestnut_sided_Warbler/Chestnut_Sided_Warbler_0018_164148.jpg,500,473,165.Chestnut_sided_Warbler,74,136,385,338,229,237,311,202
../../CUB_200_2011/images\165.Chestnut_sided_Warbler/Chestnut_Sided_Warbler_0104_163638.jpg,500,332,165.Chestnut_sided_Warbler,24,38,489,329,256,183,465,291
../../CUB_200_2011/images\165.Chestnut_sided_Warbler/Chestnut_Sided_Warbler_0094_164152.jpg,500,362,165.Chestnut_sided_Warbler,176,100,450,295,313,197,274,195
../../CUB_200_2011/images\165.Chestnut_sided_Warbler/Chestnut_Sided_Warbler_0034_163911.jpg,500,357,165.Chestnut_sided_Warbler,20,52,374,205,197,128,354,153
../../CUB_200_2011/images\165.Chestnut_sided_Warbler/Chestnut_Sided_Warbler_0110_164023.jpg,500,343,165.Chestnut_sided_Warbler,166,111,304,249,235,180,138,138
../../CUB_200_2011/images\165.Chestnut_sided_Warbler/Chestnut_Sided_Warbler_0069_163921.jpg,500,366,165.Chestnut_sided_Warbler,101,58,460,320,280,189,359,262
../../CUB_200_2011/images\165.Chestnut_sided_Warbler/Chestnut_Sided_Warbler_0103_163669.jpg,500,375,165.Chestnut_sided_Warbler,40,180,303,306,171,243,263,126
../../CUB_200_2011/images\165.Chestnut_sided_Warbler/Chestnut_Sided_Warbler_0063_163927.jpg,500,334,165.Chestnut_sided_Warbler,147,60,398,251,272,155,251,191
../../CUB_200_2011/images\165.Chestnut_sided_Warbler/Chestnut_Sided_Warbler_0068_164184.jpg,500,387,165.Chestnut_sided_Warbler,141,132,479,276,310,204,338,144
../../CUB_200_2011/images\165.Chestnut_sided_Warbler/Chestnut_Sided_Warbler_0101_164324.jpg,449,500,165.Chestnut_sided_Warbler,32,106,378,417,205,261,346,311
../../CUB_200_2011/images\165.Chestnut_sided_Warbler/Chestnut_Sided_Warbler_0041_163944.jpg,500,333,165.Chestnut_sided_Warbler,23,122,499,331,261,226,476,209
../../CUB_200_2011/images\165.Chestnut_sided_Warbler/Chestnut_Sided_Warbler_0043_164114.jpg,500,332,165.Chestnut_sided_Warbler,136,93,386,289,261,191,250,196
../../CUB_200_2011/images\165.Chestnut_sided_Warbler/Chestnut_Sided_Warbler_0128_163696.jpg,500,347,165.Chestnut_sided_Warbler,214,135,472,315,343,225,258,180
../../CUB_200_2011/images\165.Chestnut_sided_Warbler/Chestnut_Sided_Warbler_0057_163957.jpg,375,500,165.Chestnut_sided_Warbler,101,169,242,294,171,231,141,125
../../CUB_200_2011/images\165.Chestnut_sided_Warbler/Chestnut_Sided_Warbler_0087_164221.jpg,500,375,165.Chestnut_sided_Warbler,31,85,443,314,237,199,412,229
../../CUB_200_2011/images\165.Chestnut_sided_Warbler/Chestnut_Sided_Warbler_0044_163975.jpg,500,333,165.Chestnut_sided_Warbler,85,54,459,282,272,168,374,228
../../CUB_200_2011/images\165.Chestnut_sided_Warbler/Chestnut_Sided_Warbler_0037_164233.jpg,500,333,165.Chestnut_sided_Warbler,99,74,429,240,264,157,330,166
../../CUB_200_2011/images\165.Chestnut_sided_Warbler/Chestnut_Sided_Warbler_0061_163978.jpg,500,375,165.Chestnut_sided_Warbler,37,83,376,302,206,192,339,219
../../CUB_200_2011/images\165.Chestnut_sided_Warbler/Chestnut_Sided_Warbler_0052_163728.jpg,500,399,165.Chestnut_sided_Warbler,131,61,434,303,282,182,303,242
../../CUB_200_2011/images\165.Chestnut_sided_Warbler/Chestnut_Sided_Warbler_0058_163990.jpg,500,335,165.Chestnut_sided_Warbler,66,38,428,313,247,175,362,275
../../CUB_200_2011/images\165.Chestnut_sided_Warbler/Chestnut_Sided_Warbler_0049_163735.jpg,459,353,165.Chestnut_sided_Warbler,144,97,366,212,255,154,222,115
../../CUB_200_2011/images\165.Chestnut_sided_Warbler/Chestnut_Sided_Warbler_0105_163996.jpg,426,500,165.Chestnut_sided_Warbler,107,126,284,299,195,212,177,173
../../CUB_200_2011/images\165.Chestnut_sided_Warbler/Chestnut_Sided_Warbler_0008_164001.jpg,500,332,165.Chestnut_sided_Warbler,157,60,415,331,286,195,258,271
../../CUB_200_2011/images\165.Chestnut_sided_Warbler/Chestnut_Sided_Warbler_0013_163749.jpg,500,400,165.Chestnut_sided_Warbler,17,82,346,294,181,188,329,212
../../CUB_200_2011/images\165.Chestnut_sided_Warbler/Chestnut_Sided_Warbler_0097_163750.jpg,378,500,165.Chestnut_sided_Warbler,117,270,319,476,218,373,202,206
../../CUB_200_2011/images\165.Chestnut_sided_Warbler/Chestnut_Sided_Warbler_0071_163784.jpg,500,358,165.Chestnut_sided_Warbler,19,46,431,355,225,200,412,309
../../CUB_200_2011/images\165.Chestnut_sided_Warbler/Chestnut_Sided_Warbler_0004_164279.jpg,500,333,165.Chestnut_sided_Warbler,100,69,461,286,280,177,361,217
../../CUB_200_2011/images\165.Chestnut_sided_Warbler/Chestnut_Sided_Warbler_0086_164024.jpg,375,500,165.Chestnut_sided_Warbler,56,271,217,447,136,359,161,176
../../CUB_200_2011/images\165.Chestnut_sided_Warbler/Chestnut_Sided_Warbler_0089_163776.jpg,500,375,165.Chestnut_sided_Warbler,103,102,274,309,188,205,171,207
../../CUB_200_2011/images\165.Chestnut_sided_Warbler/Chestnut_Sided_Warbler_0125_164247.jpg,500,333,165.Chestnut_sided_Warbler,199,102,478,286,338,194,279,184
../../CUB_200_2011/images\165.Chestnut_sided_Warbler/Chestnut_Sided_Warbler_0107_164040.jpg,500,402,165.Chestnut_sided_Warbler,142,69,279,255,210,162,137,186
../../CUB_200_2011/images\165.Chestnut_sided_Warbler/Chestnut_Sided_Warbler_0023_164308.jpg,500,333,165.Chestnut_sided_Warbler,166,115,345,253,255,184,179,138
../../CUB_200_2011/images\165.Chestnut_sided_Warbler/Chestnut_Sided_Warbler_0083_164056.jpg,438,500,165.Chestnut_sided_Warbler,2,54,375,499,188,276,373,445
../../CUB_200_2011/images\165.Chestnut_sided_Warbler/Chestnut_Sided_Warbler_0014_163801.jpg,500,333,165.Chestnut_sided_Warbler,236,95,474,234,355,164,238,139
../../CUB_200_2011/images\165.Chestnut_sided_Warbler/Chestnut_Sided_Warbler_0016_164060.jpg,500,333,165.Chestnut_sided_Warbler,159,54,291,266,225,160,132,212
../../CUB_200_2011/images\165.Chestnut_sided_Warbler/Chestnut_Sided_Warbler_0005_164061.jpg,500,333,165.Chestnut_sided_Warbler,172,135,413,260,292,197,241,125
../../CUB_200_2011/images\165.Chestnut_sided_Warbler/Chestnut_Sided_Warbler_0117_164066.jpg,392,500,165.Chestnut_sided_Warbler,93,130,337,498,215,314,244,368
../../CUB_200_2011/images\165.Chestnut_sided_Warbler/Chestnut_Sided_Warbler_0075_164231.jpg,500,468,165.Chestnut_sided_Warbler,170,184,328,308,249,246,158,124
../../CUB_200_2011/images\165.Chestnut_sided_Warbler/Chestnut_Sided_Warbler_0001_163813.jpg,500,332,165.Chestnut_sided_Warbler,200,130,376,232,288,181,176,102
../../CUB_200_2011/images\165.Chestnut_sided_Warbler/Chestnut_Sided_Warbler_0066_164078.jpg,500,397,165.Chestnut_sided_Warbler,181,118,297,226,239,172,116,108
../../CUB_200_2011/images\165.Chestnut_sided_Warbler/Chestnut_Sided_Warbler_0126_164090.jpg,500,419,165.Chestnut_sided_Warbler,13,141,333,312,173,226,320,171
../../CUB_200_2011/images\166.Golden_winged_Warbler/Golden_Winged_Warbler_0035_164362.jpg,417,500,166.Golden_winged_Warbler,127,114,319,416,223,265,192,302
../../CUB_200_2011/images\166.Golden_winged_Warbler/Golden_Winged_Warbler_0060_164368.jpg,500,334,166.Golden_winged_Warbler,48,81,330,213,189,147,282,132
../../CUB_200_2011/images\166.Golden_winged_Warbler/Golden_Winged_Warbler_0071_164370.jpg,335,500,166.Golden_winged_Warbler,78,150,315,353,196,251,237,203
../../CUB_200_2011/images\166.Golden_winged_Warbler/Golden_Winged_Warbler_0041_164379.jpg,500,500,166.Golden_winged_Warbler,113,90,312,338,212,214,199,248
../../CUB_200_2011/images\166.Golden_winged_Warbler/Golden_Winged_Warbler_0083_794801.jpg,500,333,166.Golden_winged_Warbler,69,37,368,227,218,132,299,190
../../CUB_200_2011/images\166.Golden_winged_Warbler/Golden_Winged_Warbler_0075_794848.jpg,350,262,166.Golden_winged_Warbler,20,9,337,227,178,118,317,218
../../CUB_200_2011/images\166.Golden_winged_Warbler/Golden_Winged_Warbler_0077_164432.jpg,500,313,166.Golden_winged_Warbler,91,68,345,229,218,148,254,161
../../CUB_200_2011/images\166.Golden_winged_Warbler/Golden_Winged_Warbler_0042_164437.jpg,500,353,166.Golden_winged_Warbler,126,162,255,284,190,223,129,122
../../CUB_200_2011/images\166.Golden_winged_Warbler/Golden_Winged_Warbler_0069_164456.jpg,500,359,166.Golden_winged_Warbler,158,88,370,259,264,173,212,171
../../CUB_200_2011/images\166.Golden_winged_Warbler/Golden_Winged_Warbler_0070_164460.jpg,500,354,166.Golden_winged_Warbler,51,63,391,305,221,184,340,242
../../CUB_200_2011/images\166.Golden_winged_Warbler/Golden_Winged_Warbler_0030_164462.jpg,500,409,166.Golden_winged_Warbler,131,133,365,256,248,194,234,123
../../CUB_200_2011/images\166.Golden_winged_Warbler/Golden_Winged_Warbler_0084_164541.jpg,300,297,166.Golden_winged_Warbler,52,81,280,215,166,148,228,134
../../CUB_200_2011/images\166.Golden_winged_Warbler/Golden_Winged_Warbler_0014_164464.jpg,500,373,166.Golden_winged_Warbler,79,15,443,361,261,188,364,346
../../CUB_200_2011/images\166.Golden_winged_Warbler/Golden_Winged_Warbler_0092_164465.jpg,500,333,166.Golden_winged_Warbler,88,126,289,255,188,190,201,129
../../CUB_200_2011/images\166.Golden_winged_Warbler/Golden_Winged_Warbler_0003_164469.jpg,403,500,166.Golden_winged_Warbler,43,190,261,371,152,280,218,181
../../CUB_200_2011/images\166.Golden_winged_Warbler/Golden_Winged_Warbler_0004_164470.jpg,500,368,166.Golden_winged_Warbler,89,158,328,270,208,214,239,112
../../CUB_200_2011/images\166.Golden_winged_Warbler/Golden_Winged_Warbler_0043_164476.jpg,500,358,166.Golden_winged_Warbler,91,97,344,242,217,169,253,145
../../CUB_200_2011/images\166.Golden_winged_Warbler/Golden_Winged_Warbler_0081_164487.jpg,500,333,166.Golden_winged_Warbler,60,105,334,270,197,187,274,165
../../CUB_200_2011/images\166.Golden_winged_Warbler/Golden_Winged_Warbler_0012_164496.jpg,500,375,166.Golden_winged_Warbler,16,82,449,331,232,206,433,249
../../CUB_200_2011/images\166.Golden_winged_Warbler/Golden_Winged_Warbler_0049_164509.jpg,500,357,166.Golden_winged_Warbler,168,61,313,303,240,182,145,242
../../CUB_200_2011/images\166.Golden_winged_Warbler/Golden_Winged_Warbler_0061_164516.jpg,500,420,166.Golden_winged_Warbler,93,86,425,362,259,224,332,276
../../CUB_200_2011/images\166.Golden_winged_Warbler/Golden_Winged_Warbler_0034_794800.jpg,486,500,166.Golden_winged_Warbler,48,87,468,461,258,274,420,374
../../CUB_200_2011/images\166.Golden_winged_Warbler/Golden_Winged_Warbler_0052_164529.jpg,500,305,166.Golden_winged_Warbler,202,102,410,239,306,170,208,137
../../CUB_200_2011/images\166.Golden_winged_Warbler/Golden_Winged_Warbler_0066_794803.jpg,360,260,166.Golden_winged_Warbler,179,39,331,202,255,120,152,163
../../CUB_200_2011/images\166.Golden_winged_Warbler/Golden_Winged_Warbler_0051_794805.jpg,250,263,166.Golden_winged_Warbler,20,46,242,258,131,152,222,212
../../CUB_200_2011/images\166.Golden_winged_Warbler/Golden_Winged_Warbler_0024_794807.jpg,140,139,166.Golden_winged_Warbler,16,15,130,135,73,75,114,120
../../CUB_200_2011/images\166.Golden_winged_Warbler/Golden_Winged_Warbler_0091_794808.jpg,500,376,166.Golden_winged_Warbler,136,85,476,273,306,179,340,188
../../CUB_200_2011/images\166.Golden_winged_Warbler/Golden_Winged_Warbler_0095_794809.jpg,350,350,166.Golden_winged_Warbler,65,59,219,303,142,181,154,244
../../CUB_200_2011/images\166.Golden_winged_Warbler/Golden_Winged_Warbler_0087_794810.jpg,400,309,166.Golden_winged_Warbler,56,84,252,270,154,177,196,186
../../CUB_200_2011/images\166.Golden_winged_Warbler/Golden_Winged_Warbler_0011_794812.jpg,225,225,166.Golden_winged_Warbler,22,42,195,166,108,104,173,124
../../CUB_200_2011/images\166.Golden_winged_Warbler/Golden_Winged_Warbler_0009_794813.jpg,264,214,166.Golden_winged_Warbler,13,25,203,190,108,107,190,165
../../CUB_200_2011/images\166.Golden_winged_Warbler/Golden_Winged_Warbler_0082_164544.jpg,500,357,166.Golden_winged_Warbler,154,132,323,282,238,207,169,150
../../CUB_200_2011/images\166.Golden_winged_Warbler/Golden_Winged_Warbler_0036_794817.jpg,300,245,166.Golden_winged_Warbler,52,53,209,183,130,118,157,130
../../CUB_200_2011/images\166.Golden_winged_Warbler/Golden_Winged_Warbler_0039_794818.jpg,400,285,166.Golden_winged_Warbler,124,66,287,254,205,160,163,188
../../CUB_200_2011/images\166.Golden_winged_Warbler/Golden_Winged_Warbler_0015_794819.jpg,394,336,166.Golden_winged_Warbler,94,99,266,250,180,174,172,151
../../CUB_200_2011/images\166.Golden_winged_Warbler/Golden_Winged_Warbler_0079_794820.jpg,500,333,166.Golden_winged_Warbler,48,15,362,227,205,121,314,212
../../CUB_200_2011/images\166.Golden_winged_Warbler/Golden_Winged_Warbler_0021_794821.jpg,320,295,166.Golden_winged_Warbler,158,101,276,215,217,158,118,114
../../CUB_200_2011/images\166.Golden_winged_Warbler/Golden_Winged_Warbler_0068_794825.jpg,400,249,166.Golden_winged_Warbler,161,108,272,230,216,169,111,122
../../CUB_200_2011/images\166.Golden_winged_Warbler/Golden_Winged_Warbler_0078_794827.jpg,500,333,166.Golden_winged_Warbler,209,79,439,281,324,180,230,202
../../CUB_200_2011/images\166.Golden_winged_Warbler/Golden_Winged_Warbler_0046_794828.jpg,250,242,166.Golden_winged_Warbler,45,18,233,231,139,124,188,213
../../CUB_200_2011/images\166.Golden_winged_Warbler/Golden_Winged_Warbler_0018_164558.jpg,500,500,166.Golden_winged_Warbler,164,136,453,334,308,235,289,198
../../CUB_200_2011/images\166.Golden_winged_Warbler/Golden_Winged_Warbler_0022_794833.jpg,434,500,166.Golden_winged_Warbler,21,106,418,445,219,275,397,339
../../CUB_200_2011/images\166.Golden_winged_Warbler/Golden_Winged_Warbler_0044_794836.jpg,500,333,166.Golden_winged_Warbler,153,74,468,246,310,160,315,172
../../CUB_200_2011/images\166.Golden_winged_Warbler/Golden_Winged_Warbler_0090_794830.jpg,500,375,166.Golden_winged_Warbler,40,77,286,325,163,201,246,248
../../CUB_200_2011/images\166.Golden_winged_Warbler/Golden_Winged_Warbler_0037_794839.jpg,500,380,166.Golden_winged_Warbler,171,167,358,288,264,227,187,121
../../CUB_200_2011/images\166.Golden_winged_Warbler/Golden_Winged_Warbler_0031_794840.jpg,500,339,166.Golden_winged_Warbler,182,73,465,226,323,149,283,153
../../CUB_200_2011/images\166.Golden_winged_Warbler/Golden_Winged_Warbler_0016_794841.jpg,300,400,166.Golden_winged_Warbler,53,96,294,264,173,180,241,168
../../CUB_200_2011/images\166.Golden_winged_Warbler/Golden_Winged_Warbler_0065_794842.jpg,500,334,166.Golden_winged_Warbler,164,66,458,289,311,177,294,223
../../CUB_200_2011/images\166.Golden_winged_Warbler/Golden_Winged_Warbler_0086_794844.jpg,320,222,166.Golden_winged_Warbler,31,69,192,179,111,124,161,110
../../CUB_200_2011/images\166.Golden_winged_Warbler/Golden_Winged_Warbler_0056_794845.jpg,500,375,166.Golden_winged_Warbler,137,106,501,340,319,223,364,234
../../CUB_200_2011/images\166.Golden_winged_Warbler/Golden_Winged_Warbler_0067_794846.jpg,334,500,166.Golden_winged_Warbler,69,148,307,371,188,259,238,223
../../CUB_200_2011/images\166.Golden_winged_Warbler/Golden_Winged_Warbler_0054_794847.jpg,194,146,166.Golden_winged_Warbler,35,16,197,117,116,66,162,101
../../CUB_200_2011/images\166.Golden_winged_Warbler/Golden_Winged_Warbler_0032_794849.jpg,500,333,166.Golden_winged_Warbler,42,79,336,293,189,186,294,214
../../CUB_200_2011/images\166.Golden_winged_Warbler/Golden_Winged_Warbler_0062_794850.jpg,277,431,166.Golden_winged_Warbler,29,39,248,335,138,187,219,296
../../CUB_200_2011/images\166.Golden_winged_Warbler/Golden_Winged_Warbler_0059_794855.jpg,500,369,166.Golden_winged_Warbler,29,83,400,317,214,200,371,234
../../CUB_200_2011/images\166.Golden_winged_Warbler/Golden_Winged_Warbler_0050_164589.jpg,500,398,166.Golden_winged_Warbler,137,135,407,287,272,211,270,152
../../CUB_200_2011/images\166.Golden_winged_Warbler/Golden_Winged_Warbler_0076_164591.jpg,500,338,166.Golden_winged_Warbler,249,77,426,263,337,170,177,186
../../CUB_200_2011/images\166.Golden_winged_Warbler/Golden_Winged_Warbler_0040_164605.jpg,500,368,166.Golden_winged_Warbler,89,59,283,232,186,145,194,173
../../CUB_200_2011/images\166.Golden_winged_Warbler/Golden_Winged_Warbler_0013_794837.jpg,500,333,166.Golden_winged_Warbler,84,96,333,284,208,190,249,188
../../CUB_200_2011/images\167.Hooded_Warbler/Hooded_Warbler_0043_164864.jpg,500,413,167.Hooded_Warbler,201,97,399,305,300,201,198,208
../../CUB_200_2011/images\167.Hooded_Warbler/Hooded_Warbler_0106_164869.jpg,375,500,167.Hooded_Warbler,82,92,278,472,180,282,196,380
../../CUB_200_2011/images\167.Hooded_Warbler/Hooded_Warbler_0068_164872.jpg,500,291,167.Hooded_Warbler,152,86,383,210,267,148,231,124
../../CUB_200_2011/images\167.Hooded_Warbler/Hooded_Warbler_0028_164883.jpg,500,357,167.Hooded_Warbler,55,75,385,304,220,189,330,229
../../CUB_200_2011/images\167.Hooded_Warbler/Hooded_Warbler_0012_164891.jpg,500,404,167.Hooded_Warbler,64,169,371,311,217,240,307,142
../../CUB_200_2011/images\167.Hooded_Warbler/Hooded_Warbler_0051_164892.jpg,500,320,167.Hooded_Warbler,59,63,397,257,228,160,338,194
../../CUB_200_2011/images\167.Hooded_Warbler/Hooded_Warbler_0042_164895.jpg,500,333,167.Hooded_Warbler,164,103,499,280,331,191,335,177
../../CUB_200_2011/images\167.Hooded_Warbler/Hooded_Warbler_0030_164897.jpg,500,357,167.Hooded_Warbler,104,69,452,327,278,198,348,258
../../CUB_200_2011/images\167.Hooded_Warbler/Hooded_Warbler_0017_164911.jpg,500,333,167.Hooded_Warbler,163,121,332,243,247,182,169,122
../../CUB_200_2011/images\167.Hooded_Warbler/Hooded_Warbler_0003_164915.jpg,500,333,167.Hooded_Warbler,164,68,334,264,249,166,170,196
../../CUB_200_2011/images\167.Hooded_Warbler/Hooded_Warbler_0129_90165.jpg,500,375,167.Hooded_Warbler,223,46,469,193,346,119,246,147
../../CUB_200_2011/images\167.Hooded_Warbler/Hooded_Warbler_0124_164923.jpg,500,375,167.Hooded_Warbler,79,128,388,332,233,230,309,204
../../CUB_200_2011/images\167.Hooded_Warbler/Hooded_Warbler_0125_164925.jpg,500,375,167.Hooded_Warbler,27,151,324,312,175,231,297,161
../../CUB_200_2011/images\167.Hooded_Warbler/Hooded_Warbler_0039_164928.jpg,500,343,167.Hooded_Warbler,170,72,402,250,286,161,232,178
../../CUB_200_2011/images\167.Hooded_Warbler/Hooded_Warbler_0070_164930.jpg,500,375,167.Hooded_Warbler,208,97,437,237,322,167,229,140
../../CUB_200_2011/images\167.Hooded_Warbler/Hooded_Warbler_0128_164620.jpg,500,500,167.Hooded_Warbler,90,133,439,405,264,269,349,272
../../CUB_200_2011/images\167.Hooded_Warbler/Hooded_Warbler_0084_164944.jpg,500,384,167.Hooded_Warbler,183,133,432,325,307,229,249,192
../../CUB_200_2011/images\167.Hooded_Warbler/Hooded_Warbler_0072_22097.jpg,500,333,167.Hooded_Warbler,165,137,383,273,274,205,218,136
../../CUB_200_2011/images\167.Hooded_Warbler/Hooded_Warbler_0104_164982.jpg,333,500,167.Hooded_Warbler,57,116,333,499,195,307,276,383
../../CUB_200_2011/images\167.Hooded_Warbler/Hooded_Warbler_0118_164991.jpg,500,350,167.Hooded_Warbler,31,126,313,250,172,188,282,124
../../CUB_200_2011/images\167.Hooded_Warbler/Hooded_Warbler_0133_165016.jpg,375,500,167.Hooded_Warbler,137,188,258,461,197,324,121,273
../../CUB_200_2011/images\167.Hooded_Warbler/Hooded_Warbler_0035_165040.jpg,500,333,167.Hooded_Warbler,78,105,346,280,212,192,268,175
../../CUB_200_2011/images\167.Hooded_Warbler/Hooded_Warbler_0115_165041.jpg,500,331,167.Hooded_Warbler,94,23,360,312,227,167,266,289
../../CUB_200_2011/images\167.Hooded_Warbler/Hooded_Warbler_0021_165057.jpg,500,423,167.Hooded_Warbler,16,81,428,332,222,206,412,251
../../CUB_200_2011/images\167.Hooded_Warbler/Hooded_Warbler_0057_164137.jpg,500,378,167.Hooded_Warbler,161,112,410,225,285,168,249,113
../../CUB_200_2011/images\167.Hooded_Warbler/Hooded_Warbler_0105_165095.jpg,500,333,167.Hooded_Warbler,69,149,279,279,174,214,210,130
../../CUB_200_2011/images\167.Hooded_Warbler/Hooded_Warbler_0117_165106.jpg,240,195,167.Hooded_Warbler,13,43,229,189,121,116,216,146
../../CUB_200_2011/images\167.Hooded_Warbler/Hooded_Warbler_0078_165123.jpg,500,375,167.Hooded_Warbler,75,126,383,309,229,217,308,183
../../CUB_200_2011/images\167.Hooded_Warbler/Hooded_Warbler_0048_164622.jpg,500,333,167.Hooded_Warbler,128,110,302,255,215,182,174,145
../../CUB_200_2011/images\167.Hooded_Warbler/Hooded_Warbler_0013_164627.jpg,500,334,167.Hooded_Warbler,108,48,499,333,303,190,391,285
../../CUB_200_2011/images\167.Hooded_Warbler/Hooded_Warbler_0116_164630.jpg,500,400,167.Hooded_Warbler,5,89,435,314,220,201,430,225
../../CUB_200_2011/images\167.Hooded_Warbler/Hooded_Warbler_0053_164631.jpg,500,357,167.Hooded_Warbler,181,121,454,286,317,203,273,165
../../CUB_200_2011/images\167.Hooded_Warbler/Hooded_Warbler_0007_164633.jpg,500,400,167.Hooded_Warbler,294,145,442,256,368,200,148,111
../../CUB_200_2011/images\167.Hooded_Warbler/Hooded_Warbler_0122_164635.jpg,500,360,167.Hooded_Warbler,103,80,440,299,271,189,337,219
../../CUB_200_2011/images\167.Hooded_Warbler/Hooded_Warbler_0121_164639.jpg,500,349,167.Hooded_Warbler,42,21,424,345,233,183,382,324
../../CUB_200_2011/images\167.Hooded_Warbler/Hooded_Warbler_0089_164640.jpg,500,352,167.Hooded_Warbler,105,126,478,327,291,226,373,201
../../CUB_200_2011/images\167.Hooded_Warbler/Hooded_Warbler_0008_164641.jpg,500,420,167.Hooded_Warbler,179,147,316,360,247,253,137,213
../../CUB_200_2011/images\167.Hooded_Warbler/Hooded_Warbler_0112_164650.jpg,500,492,167.Hooded_Warbler,111,51,465,463,288,257,354,412
../../CUB_200_2011/images\167.Hooded_Warbler/Hooded_Warbler_0040_165173.jpg,500,375,167.Hooded_Warbler,160,140,344,258,252,199,184,118
../../CUB_200_2011/images\167.Hooded_Warbler/Hooded_Warbler_0050_164662.jpg,500,333,167.Hooded_Warbler,56,96,367,259,211,177,311,163
../../CUB_200_2011/images\167.Hooded_Warbler/Hooded_Warbler_0014_164672.jpg,500,350,167.Hooded_Warbler,161,62,456,322,308,192,295,260
../../CUB_200_2011/images\167.Hooded_Warbler/Hooded_Warbler_0058_164674.jpg,500,375,167.Hooded_Warbler,216,145,454,339,335,242,238,194
../../CUB_200_2011/images\167.Hooded_Warbler/Hooded_Warbler_0062_165199.jpg,389,432,167.Hooded_Warbler,72,185,239,311,155,248,167,126
../../CUB_200_2011/images\167.Hooded_Warbler/Hooded_Warbler_0033_165213.jpg,500,325,167.Hooded_Warbler,259,123,391,309,325,216,132,186
../../CUB_200_2011/images\167.Hooded_Warbler/Hooded_Warbler_0001_164704.jpg,500,339,167.Hooded_Warbler,127,110,300,255,213,182,173,145
../../CUB_200_2011/images\167.Hooded_Warbler/Hooded_Warbler_0134_164708.jpg,500,330,167.Hooded_Warbler,110,65,446,268,278,166,336,203
../../CUB_200_2011/images\167.Hooded_Warbler/Hooded_Warbler_0095_164709.jpg,500,323,167.Hooded_Warbler,76,96,327,244,201,170,251,148
../../CUB_200_2011/images\167.Hooded_Warbler/Hooded_Warbler_0019_164710.jpg,500,355,167.Hooded_Warbler,112,102,477,336,294,219,365,234
../../CUB_200_2011/images\167.Hooded_Warbler/Hooded_Warbler_0096_164739.jpg,441,500,167.Hooded_Warbler,42,62,331,479,186,270,289,417
../../CUB_200_2011/images\167.Hooded_Warbler/Hooded_Warbler_0067_164743.jpg,500,335,167.Hooded_Warbler,18,94,297,284,157,189,279,190
../../CUB_200_2011/images\167.Hooded_Warbler/Hooded_Warbler_0036_164779.jpg,500,401,167.Hooded_Warbler,170,104,405,304,287,204,235,200
../../CUB_200_2011/images\167.Hooded_Warbler/Hooded_Warbler_0090_164794.jpg,432,500,167.Hooded_Warbler,159,171,292,332,225,251,133,161
../../CUB_200_2011/images\167.Hooded_Warbler/Hooded_Warbler_0011_164801.jpg,334,500,167.Hooded_Warbler,86,158,300,310,193,234,214,152
../../CUB_200_2011/images\167.Hooded_Warbler/Hooded_Warbler_0101_164806.jpg,500,390,167.Hooded_Warbler,92,57,458,377,275,217,366,320
../../CUB_200_2011/images\167.Hooded_Warbler/Hooded_Warbler_0041_164807.jpg,500,333,167.Hooded_Warbler,81,60,313,277,197,168,232,217
../../CUB_200_2011/images\167.Hooded_Warbler/Hooded_Warbler_0135_164824.jpg,500,349,167.Hooded_Warbler,67,78,291,184,179,131,224,106
../../CUB_200_2011/images\167.Hooded_Warbler/Hooded_Warbler_0130_164826.jpg,500,339,167.Hooded_Warbler,113,67,412,298,262,182,299,231
../../CUB_200_2011/images\167.Hooded_Warbler/Hooded_Warbler_0087_164833.jpg,475,361,167.Hooded_Warbler,135,37,359,348,247,192,224,311
../../CUB_200_2011/images\167.Hooded_Warbler/Hooded_Warbler_0016_164837.jpg,500,349,167.Hooded_Warbler,84,106,294,287,189,196,210,181
../../CUB_200_2011/images\167.Hooded_Warbler/Hooded_Warbler_0085_164846.jpg,500,400,167.Hooded_Warbler,85,129,319,292,202,210,234,163
../../CUB_200_2011/images\168.Kentucky_Warbler/Kentucky_Warbler_0063_795904.jpg,375,500,168.Kentucky_Warbler,0,117,331,441,165,279,331,324
../../CUB_200_2011/images\168.Kentucky_Warbler/Kentucky_Warbler_0059_795905.jpg,500,375,168.Kentucky_Warbler,50,65,370,265,210,165,320,200
../../CUB_200_2011/images\168.Kentucky_Warbler/Kentucky_Warbler_0076_795907.jpg,500,335,168.Kentucky_Warbler,107,68,419,223,263,145,312,155
../../CUB_200_2011/images\168.Kentucky_Warbler/Kentucky_Warbler_0038_795909.jpg,500,346,168.Kentucky_Warbler,131,126,370,258,250,192,239,132
../../CUB_200_2011/images\168.Kentucky_Warbler/Kentucky_Warbler_0010_795912.jpg,276,248,168.Kentucky_Warbler,94,11,248,235,171,123,154,224
../../CUB_200_2011/images\168.Kentucky_Warbler/Kentucky_Warbler_0019_165389.jpg,401,500,168.Kentucky_Warbler,72,151,286,334,179,242,214,183
../../CUB_200_2011/images\168.Kentucky_Warbler/Kentucky_Warbler_0005_795919.jpg,375,500,168.Kentucky_Warbler,91,97,277,446,184,271,186,349
../../CUB_200_2011/images\168.Kentucky_Warbler/Kentucky_Warbler_0014_165336.jpg,500,333,168.Kentucky_Warbler,103,162,232,263,167,212,129,101
../../CUB_200_2011/images\168.Kentucky_Warbler/Kentucky_Warbler_0067_165404.jpg,500,337,168.Kentucky_Warbler,85,115,356,237,220,176,271,122
../../CUB_200_2011/images\168.Kentucky_Warbler/Kentucky_Warbler_0024_165405.jpg,500,341,168.Kentucky_Warbler,0,73,382,339,191,206,382,266
../../CUB_200_2011/images\168.Kentucky_Warbler/Kentucky_Warbler_0079_165339.jpg,500,348,168.Kentucky_Warbler,53,86,370,309,211,197,317,223
../../CUB_200_2011/images\168.Kentucky_Warbler/Kentucky_Warbler_0055_165426.jpg,500,318,168.Kentucky_Warbler,140,9,289,308,214,158,149,299
../../CUB_200_2011/images\168.Kentucky_Warbler/Kentucky_Warbler_0044_165436.jpg,500,375,168.Kentucky_Warbler,161,72,366,285,263,178,205,213
../../CUB_200_2011/images\168.Kentucky_Warbler/Kentucky_Warbler_0058_165441.jpg,500,334,168.Kentucky_Warbler,167,79,386,234,276,156,219,155
../../CUB_200_2011/images\168.Kentucky_Warbler/Kentucky_Warbler_0027_795917.jpg,500,359,168.Kentucky_Warbler,70,101,350,285,210,193,280,184
../../CUB_200_2011/images\168.Kentucky_Warbler/Kentucky_Warbler_0002_795886.jpg,500,344,168.Kentucky_Warbler,16,90,356,287,186,188,340,197
../../CUB_200_2011/images\168.Kentucky_Warbler/Kentucky_Warbler_0013_165228.jpg,500,375,168.Kentucky_Warbler,124,95,314,241,219,168,190,146
../../CUB_200_2011/images\168.Kentucky_Warbler/Kentucky_Warbler_0021_165230.jpg,500,375,168.Kentucky_Warbler,126,83,461,325,293,204,335,242
../../CUB_200_2011/images\168.Kentucky_Warbler/Kentucky_Warbler_0043_165240.jpg,500,381,168.Kentucky_Warbler,46,21,479,360,262,190,433,339
../../CUB_200_2011/images\168.Kentucky_Warbler/Kentucky_Warbler_0023_165247.jpg,500,332,168.Kentucky_Warbler,142,60,345,273,243,166,203,213
../../CUB_200_2011/images\168.Kentucky_Warbler/Kentucky_Warbler_0042_165268.jpg,500,333,168.Kentucky_Warbler,72,25,441,311,256,168,369,286
../../CUB_200_2011/images\168.Kentucky_Warbler/Kentucky_Warbler_0074_165269.jpg,500,333,168.Kentucky_Warbler,17,27,489,296,253,161,472,269
../../CUB_200_2011/images\168.Kentucky_Warbler/Kentucky_Warbler_0033_165271.jpg,500,359,168.Kentucky_Warbler,309,177,472,300,390,238,163,123
../../CUB_200_2011/images\168.Kentucky_Warbler/Kentucky_Warbler_0050_165278.jpg,500,333,168.Kentucky_Warbler,194,72,356,266,275,169,162,194
../../CUB_200_2011/images\168.Kentucky_Warbler/Kentucky_Warbler_0048_165360.jpg,360,360,168.Kentucky_Warbler,30,77,325,270,177,173,295,193
../../CUB_200_2011/images\168.Kentucky_Warbler/Kentucky_Warbler_0066_165290.jpg,500,350,168.Kentucky_Warbler,186,147,329,257,257,202,143,110
../../CUB_200_2011/images\168.Kentucky_Warbler/Kentucky_Warbler_0047_165298.jpg,500,358,168.Kentucky_Warbler,89,83,416,319,252,201,327,236
../../CUB_200_2011/images\168.Kentucky_Warbler/Kentucky_Warbler_0031_165363.jpg,500,333,168.Kentucky_Warbler,174,81,364,262,269,171,190,181
../../CUB_200_2011/images\168.Kentucky_Warbler/Kentucky_Warbler_0025_165304.jpg,500,375,168.Kentucky_Warbler,221,128,414,285,317,206,193,157
../../CUB_200_2011/images\168.Kentucky_Warbler/Kentucky_Warbler_0072_165305.jpg,500,481,168.Kentucky_Warbler,85,81,284,456,184,268,199,375
../../CUB_200_2011/images\168.Kentucky_Warbler/Kentucky_Warbler_0049_165313.jpg,500,400,168.Kentucky_Warbler,133,97,476,328,304,212,343,231
../../CUB_200_2011/images\168.Kentucky_Warbler/Kentucky_Warbler_0069_165318.jpg,500,394,168.Kentucky_Warbler,62,100,345,311,203,205,283,211
../../CUB_200_2011/images\168.Kentucky_Warbler/Kentucky_Warbler_0039_165324.jpg,500,364,168.Kentucky_Warbler,213,69,424,302,318,185,211,233
../../CUB_200_2011/images\168.Kentucky_Warbler/Kentucky_Warbler_0053_165332.jpg,500,333,168.Kentucky_Warbler,220,35,407,294,313,164,187,259
../../CUB_200_2011/images\168.Kentucky_Warbler/Kentucky_Warbler_0008_165369.jpg,500,382,168.Kentucky_Warbler,112,107,385,265,248,186,273,158
../../CUB_200_2011/images\168.Kentucky_Warbler/Kentucky_Warbler_0009_795865.jpg,500,332,168.Kentucky_Warbler,39,108,329,274,184,191,290,166
../../CUB_200_2011/images\168.Kentucky_Warbler/Kentucky_Warbler_0015_795867.jpg,261,186,168.Kentucky_Warbler,54,28,237,168,145,98,183,140
../../CUB_200_2011/images\168.Kentucky_Warbler/Kentucky_Warbler_0040_795868.jpg,400,279,168.Kentucky_Warbler,67,39,379,256,223,147,312,217
../../CUB_200_2011/images\168.Kentucky_Warbler/Kentucky_Warbler_0082_795869.jpg,500,395,168.Kentucky_Warbler,103,86,440,305,271,195,337,219
../../CUB_200_2011/images\168.Kentucky_Warbler/Kentucky_Warbler_0071_165342.jpg,400,500,168.Kentucky_Warbler,82,186,294,379,188,282,212,193
../../CUB_200_2011/images\168.Kentucky_Warbler/Kentucky_Warbler_0036_795872.jpg,500,245,168.Kentucky_Warbler,29,17,445,235,237,126,416,218
../../CUB_200_2011/images\168.Kentucky_Warbler/Kentucky_Warbler_0052_795874.jpg,500,333,168.Kentucky_Warbler,38,32,477,315,257,173,439,283
../../CUB_200_2011/images\168.Kentucky_Warbler/Kentucky_Warbler_0012_795875.jpg,500,375,168.Kentucky_Warbler,70,63,498,367,284,215,428,304
../../CUB_200_2011/images\168.Kentucky_Warbler/Kentucky_Warbler_0057_165349.jpg,500,397,168.Kentucky_Warbler,32,131,377,338,204,234,345,207
../../CUB_200_2011/images\168.Kentucky_Warbler/Kentucky_Warbler_0035_795878.jpg,500,375,168.Kentucky_Warbler,23,121,307,321,165,221,284,200
../../CUB_200_2011/images\168.Kentucky_Warbler/Kentucky_Warbler_0080_165351.jpg,500,333,168.Kentucky_Warbler,272,149,454,249,363,199,182,100
../../CUB_200_2011/images\168.Kentucky_Warbler/Kentucky_Warbler_0022_795882.jpg,500,314,168.Kentucky_Warbler,42,1,459,285,250,143,417,284
../../CUB_200_2011/images\168.Kentucky_Warbler/Kentucky_Warbler_0083_795883.jpg,500,359,168.Kentucky_Warbler,91,62,474,314,282,188,383,252
../../CUB_200_2011/images\168.Kentucky_Warbler/Kentucky_Warbler_0051_795884.jpg,500,371,168.Kentucky_Warbler,149,112,489,356,319,234,340,244
../../CUB_200_2011/images\168.Kentucky_Warbler/Kentucky_Warbler_0030_795885.jpg,500,334,168.Kentucky_Warbler,159,76,437,270,298,173,278,194
../../CUB_200_2011/images\168.Kentucky_Warbler/Kentucky_Warbler_0004_165358.jpg,500,354,168.Kentucky_Warbler,66,49,275,270,170,159,209,221
../../CUB_200_2011/images\168.Kentucky_Warbler/Kentucky_Warbler_0041_795888.jpg,334,260,168.Kentucky_Warbler,2,15,326,253,164,134,324,238
../../CUB_200_2011/images\168.Kentucky_Warbler/Kentucky_Warbler_0078_795889.jpg,500,333,168.Kentucky_Warbler,21,10,409,331,215,170,388,321
../../CUB_200_2011/images\168.Kentucky_Warbler/Kentucky_Warbler_0003_795892.jpg,500,461,168.Kentucky_Warbler,128,143,438,339,283,241,310,196
../../CUB_200_2011/images\168.Kentucky_Warbler/Kentucky_Warbler_0068_795893.jpg,500,380,168.Kentucky_Warbler,134,99,336,316,235,207,202,217
../../CUB_200_2011/images\168.Kentucky_Warbler/Kentucky_Warbler_0073_795895.jpg,500,333,168.Kentucky_Warbler,82,13,401,302,241,157,319,289
../../CUB_200_2011/images\168.Kentucky_Warbler/Kentucky_Warbler_0062_795897.jpg,357,238,168.Kentucky_Warbler,16,23,341,180,178,101,325,157
../../CUB_200_2011/images\168.Kentucky_Warbler/Kentucky_Warbler_0065_795899.jpg,444,360,168.Kentucky_Warbler,1,0,423,359,212,179,422,359
../../CUB_200_2011/images\168.Kentucky_Warbler/Kentucky_Warbler_0020_795903.jpg,375,500,168.Kentucky_Warbler,2,144,308,463,155,303,306,319
../../CUB_200_2011/images\169.Magnolia_Warbler/Magnolia_Warbler_0113_166401.jpg,421,500,169.Magnolia_Warbler,0,135,340,383,170,259,340,248
../../CUB_200_2011/images\169.Magnolia_Warbler/Magnolia_Warbler_0112_166406.jpg,500,333,169.Magnolia_Warbler,105,92,324,318,214,205,219,226
../../CUB_200_2011/images\169.Magnolia_Warbler/Magnolia_Warbler_0047_165900.jpg,500,333,169.Magnolia_Warbler,102,93,492,331,297,212,390,238
../../CUB_200_2011/images\169.Magnolia_Warbler/Magnolia_Warbler_0021_165919.jpg,500,333,169.Magnolia_Warbler,59,96,383,273,221,184,324,177
../../CUB_200_2011/images\169.Magnolia_Warbler/Magnolia_Warbler_0040_165921.jpg,500,440,169.Magnolia_Warbler,133,145,435,336,284,240,302,191
../../CUB_200_2011/images\169.Magnolia_Warbler/Magnolia_Warbler_0122_165940.jpg,500,400,169.Magnolia_Warbler,113,19,375,293,244,156,262,274
../../CUB_200_2011/images\169.Magnolia_Warbler/Magnolia_Warbler_0064_165471.jpg,500,400,169.Magnolia_Warbler,102,131,301,273,201,202,199,142
../../CUB_200_2011/images\169.Magnolia_Warbler/Magnolia_Warbler_0018_165958.jpg,500,333,169.Magnolia_Warbler,214,121,422,271,318,196,208,150
../../CUB_200_2011/images\169.Magnolia_Warbler/Magnolia_Warbler_0045_165448.jpg,500,375,169.Magnolia_Warbler,8,20,472,358,240,189,464,338
../../CUB_200_2011/images\169.Magnolia_Warbler/Magnolia_Warbler_0054_165965.jpg,500,357,169.Magnolia_Warbler,78,66,476,281,277,173,398,215
../../CUB_200_2011/images\169.Magnolia_Warbler/Magnolia_Warbler_0097_165455.jpg,500,373,169.Magnolia_Warbler,39,64,323,303,181,183,284,239
../../CUB_200_2011/images\169.Magnolia_Warbler/Magnolia_Warbler_0120_165462.jpg,500,361,169.Magnolia_Warbler,30,65,234,305,132,185,204,240
../../CUB_200_2011/images\169.Magnolia_Warbler/Magnolia_Warbler_0114_165467.jpg,500,500,169.Magnolia_Warbler,106,34,365,349,235,191,259,315
../../CUB_200_2011/images\169.Magnolia_Warbler/Magnolia_Warbler_0052_165474.jpg,411,500,169.Magnolia_Warbler,39,201,249,434,144,317,210,233
../../CUB_200_2011/images\169.Magnolia_Warbler/Magnolia_Warbler_0111_165478.jpg,500,333,169.Magnolia_Warbler,74,26,469,319,271,172,395,293
../../CUB_200_2011/images\169.Magnolia_Warbler/Magnolia_Warbler_0067_165484.jpg,500,435,169.Magnolia_Warbler,62,22,489,422,275,222,427,400
../../CUB_200_2011/images\169.Magnolia_Warbler/Magnolia_Warbler_0026_165498.jpg,500,333,169.Magnolia_Warbler,72,75,339,247,205,161,267,172
../../CUB_200_2011/images\169.Magnolia_Warbler/Magnolia_Warbler_0137_165507.jpg,500,366,169.Magnolia_Warbler,55,77,475,346,265,211,420,269
../../CUB_200_2011/images\169.Magnolia_Warbler/Magnolia_Warbler_0039_165532.jpg,500,333,169.Magnolia_Warbler,60,85,303,280,181,182,243,195
../../CUB_200_2011/images\169.Magnolia_Warbler/Magnolia_Warbler_0072_165534.jpg,500,500,169.Magnolia_Warbler,157,156,435,380,296,268,278,224
../../CUB_200_2011/images\169.Magnolia_Warbler/Magnolia_Warbler_0004_165535.jpg,500,332,169.Magnolia_Warbler,228,75,443,236,335,155,215,161
../../CUB_200_2011/images\169.Magnolia_Warbler/Magnolia_Warbler_0029_165567.jpg,500,368,169.Magnolia_Warbler,123,61,417,310,270,185,294,249
../../CUB_200_2011/images\169.Magnolia_Warbler/Magnolia_Warbler_0139_166081.jpg,500,397,169.Magnolia_Warbler,108,133,359,280,233,206,251,147
../../CUB_200_2011/images\169.Magnolia_Warbler/Magnolia_Warbler_0090_166087.jpg,500,337,169.Magnolia_Warbler,139,98,463,280,301,189,324,182
../../CUB_200_2011/images\169.Magnolia_Warbler/Magnolia_Warbler_0034_166097.jpg,500,332,169.Magnolia_Warbler,82,59,365,308,223,183,283,249
../../CUB_200_2011/images\169.Magnolia_Warbler/Magnolia_Warbler_0095_166098.jpg,500,332,169.Magnolia_Warbler,118,138,268,285,193,211,150,147
../../CUB_200_2011/images\169.Magnolia_Warbler/Magnolia_Warbler_0044_165599.jpg,500,333,169.Magnolia_Warbler,14,136,378,290,196,213,364,154
../../CUB_200_2011/images\169.Magnolia_Warbler/Magnolia_Warbler_0063_166121.jpg,500,342,169.Magnolia_Warbler,10,119,392,326,201,222,382,207
../../CUB_200_2011/images\169.Magnolia_Warbler/Magnolia_Warbler_0046_166150.jpg,500,387,169.Magnolia_Warbler,41,107,444,265,242,186,403,158
../../CUB_200_2011/images\169.Magnolia_Warbler/Magnolia_Warbler_0051_165646.jpg,500,400,169.Magnolia_Warbler,193,60,409,259,301,159,216,199
../../CUB_200_2011/images\169.Magnolia_Warbler/Magnolia_Warbler_0103_165647.jpg,500,381,169.Magnolia_Warbler,35,95,378,354,206,224,343,259
../../CUB_200_2011/images\169.Magnolia_Warbler/Magnolia_Warbler_0105_165661.jpg,453,500,169.Magnolia_Warbler,20,91,388,237,204,164,368,146
../../CUB_200_2011/images\169.Magnolia_Warbler/Magnolia_Warbler_0066_166184.jpg,500,280,169.Magnolia_Warbler,110,61,316,184,213,122,206,123
../../CUB_200_2011/images\169.Magnolia_Warbler/Magnolia_Warbler_0057_165673.jpg,500,415,169.Magnolia_Warbler,169,109,432,289,300,199,263,180
../../CUB_200_2011/images\169.Magnolia_Warbler/Magnolia_Warbler_0077_165674.jpg,500,333,169.Magnolia_Warbler,104,136,302,303,203,219,198,167
../../CUB_200_2011/images\169.Magnolia_Warbler/Magnolia_Warbler_0053_165682.jpg,500,494,169.Magnolia_Warbler,107,128,486,346,296,237,379,218
../../CUB_200_2011/images\169.Magnolia_Warbler/Magnolia_Warbler_0131_166197.jpg,500,401,169.Magnolia_Warbler,61,100,432,347,246,223,371,247
../../CUB_200_2011/images\169.Magnolia_Warbler/Magnolia_Warbler_0106_165689.jpg,500,500,169.Magnolia_Warbler,161,82,367,381,264,231,206,299
../../CUB_200_2011/images\169.Magnolia_Warbler/Magnolia_Warbler_0022_165693.jpg,500,375,169.Magnolia_Warbler,79,88,362,328,220,208,283,240
../../CUB_200_2011/images\169.Magnolia_Warbler/Magnolia_Warbler_0104_165696.jpg,500,350,169.Magnolia_Warbler,124,63,424,298,274,180,300,235
../../CUB_200_2011/images\169.Magnolia_Warbler/Magnolia_Warbler_0041_165709.jpg,500,333,169.Magnolia_Warbler,123,94,405,275,264,184,282,181
../../CUB_200_2011/images\169.Magnolia_Warbler/Magnolia_Warbler_0001_166266.jpg,466,500,169.Magnolia_Warbler,135,92,304,425,219,258,169,333
../../CUB_200_2011/images\169.Magnolia_Warbler/Magnolia_Warbler_0043_165774.jpg,500,333,169.Magnolia_Warbler,203,71,456,257,329,164,253,186
../../CUB_200_2011/images\169.Magnolia_Warbler/Magnolia_Warbler_0020_166211.jpg,500,333,169.Magnolia_Warbler,150,32,385,311,267,171,235,279
../../CUB_200_2011/images\169.Magnolia_Warbler/Magnolia_Warbler_0030_165782.jpg,500,387,169.Magnolia_Warbler,110,86,443,289,276,187,333,203
../../CUB_200_2011/images\169.Magnolia_Warbler/Magnolia_Warbler_0079_165783.jpg,500,428,169.Magnolia_Warbler,142,77,437,360,289,218,295,283
../../CUB_200_2011/images\169.Magnolia_Warbler/Magnolia_Warbler_0134_165801.jpg,500,340,169.Magnolia_Warbler,203,154,492,299,347,226,289,145
../../CUB_200_2011/images\169.Magnolia_Warbler/Magnolia_Warbler_0092_165807.jpg,500,355,169.Magnolia_Warbler,97,99,462,306,279,202,365,207
../../CUB_200_2011/images\169.Magnolia_Warbler/Magnolia_Warbler_0032_165960.jpg,500,333,169.Magnolia_Warbler,27,83,390,312,208,197,363,229
../../CUB_200_2011/images\169.Magnolia_Warbler/Magnolia_Warbler_0015_165817.jpg,410,500,169.Magnolia_Warbler,105,166,266,402,185,284,161,236
../../CUB_200_2011/images\169.Magnolia_Warbler/Magnolia_Warbler_0023_165827.jpg,400,500,169.Magnolia_Warbler,55,79,270,412,162,245,215,333
../../CUB_200_2011/images\169.Magnolia_Warbler/Magnolia_Warbler_0076_165832.jpg,500,357,169.Magnolia_Warbler,117,68,456,250,286,159,339,182
../../CUB_200_2011/images\169.Magnolia_Warbler/Magnolia_Warbler_0042_159690.jpg,500,328,169.Magnolia_Warbler,110,56,261,258,185,157,151,202
../../CUB_200_2011/images\169.Magnolia_Warbler/Magnolia_Warbler_0048_165862.jpg,500,442,169.Magnolia_Warbler,20,67,452,333,236,200,432,266
../../CUB_200_2011/images\169.Magnolia_Warbler/Magnolia_Warbler_0140_165543.jpg,500,329,169.Magnolia_Warbler,129,102,416,305,272,203,287,203
../../CUB_200_2011/images\169.Magnolia_Warbler/Magnolia_Warbler_0011_166382.jpg,500,332,169.Magnolia_Warbler,197,96,425,312,311,204,228,216
../../CUB_200_2011/images\169.Magnolia_Warbler/Magnolia_Warbler_0136_166388.jpg,500,347,169.Magnolia_Warbler,118,121,328,282,223,201,210,161
../../CUB_200_2011/images\169.Magnolia_Warbler/Magnolia_Warbler_0123_166389.jpg,500,333,169.Magnolia_Warbler,49,93,337,252,193,172,288,159
../../CUB_200_2011/images\169.Magnolia_Warbler/Magnolia_Warbler_0102_165884.jpg,333,500,169.Magnolia_Warbler,48,68,286,313,167,190,238,245
../../CUB_200_2011/images\170.Mourning_Warbler/Mourning_Warbler_0014_166427.jpg,500,334,170.Mourning_Warbler,38,60,488,289,263,174,450,229
../../CUB_200_2011/images\170.Mourning_Warbler/Mourning_Warbler_0009_166429.jpg,500,417,170.Mourning_Warbler,16,169,372,381,194,275,356,212
../../CUB_200_2011/images\170.Mourning_Warbler/Mourning_Warbler_0036_166432.jpg,500,343,170.Mourning_Warbler,177,69,465,295,321,182,288,226
../../CUB_200_2011/images\170.Mourning_Warbler/Mourning_Warbler_0081_166434.jpg,500,362,170.Mourning_Warbler,30,30,465,316,247,173,435,286
../../CUB_200_2011/images\170.Mourning_Warbler/Mourning_Warbler_0055_166436.jpg,500,367,170.Mourning_Warbler,194,29,422,328,308,178,228,299
../../CUB_200_2011/images\170.Mourning_Warbler/Mourning_Warbler_0020_166440.jpg,500,356,170.Mourning_Warbler,21,86,396,299,208,192,375,213
../../CUB_200_2011/images\170.Mourning_Warbler/Mourning_Warbler_0064_166447.jpg,500,334,170.Mourning_Warbler,58,69,478,305,268,187,420,236
../../CUB_200_2011/images\170.Mourning_Warbler/Mourning_Warbler_0008_166467.jpg,500,333,170.Mourning_Warbler,72,84,446,204,259,144,374,120
../../CUB_200_2011/images\170.Mourning_Warbler/Mourning_Warbler_0049_166469.jpg,500,375,170.Mourning_Warbler,37,45,433,372,235,208,396,327
../../CUB_200_2011/images\170.Mourning_Warbler/Mourning_Warbler_0056_166476.jpg,500,333,170.Mourning_Warbler,70,78,284,263,177,170,214,185
../../CUB_200_2011/images\170.Mourning_Warbler/Mourning_Warbler_0033_166489.jpg,500,374,170.Mourning_Warbler,174,95,481,282,327,188,307,187
../../CUB_200_2011/images\170.Mourning_Warbler/Mourning_Warbler_0066_166491.jpg,500,377,170.Mourning_Warbler,153,131,349,237,251,184,196,106
../../CUB_200_2011/images\170.Mourning_Warbler/Mourning_Warbler_0042_166493.jpg,500,363,170.Mourning_Warbler,32,65,341,347,186,206,309,282
../../CUB_200_2011/images\170.Mourning_Warbler/Mourning_Warbler_0031_166494.jpg,500,360,170.Mourning_Warbler,21,81,407,316,214,198,386,235
../../CUB_200_2011/images\170.Mourning_Warbler/Mourning_Warbler_0007_166500.jpg,500,333,170.Mourning_Warbler,210,29,451,331,330,180,241,302
../../CUB_200_2011/images\170.Mourning_Warbler/Mourning_Warbler_0012_166515.jpg,500,352,170.Mourning_Warbler,207,133,370,294,288,213,163,161
../../CUB_200_2011/images\170.Mourning_Warbler/Mourning_Warbler_0002_166520.jpg,480,465,170.Mourning_Warbler,70,120,395,409,232,264,325,289
../../CUB_200_2011/images\170.Mourning_Warbler/Mourning_Warbler_0073_166524.jpg,500,334,170.Mourning_Warbler,271,96,393,248,332,172,122,152
../../CUB_200_2011/images\170.Mourning_Warbler/Mourning_Warbler_0029_166530.jpg,500,375,170.Mourning_Warbler,46,64,406,375,226,219,360,311
../../CUB_200_2011/images\170.Mourning_Warbler/Mourning_Warbler_0062_166531.jpg,500,333,170.Mourning_Warbler,148,116,306,219,227,167,158,103
../../CUB_200_2011/images\170.Mourning_Warbler/Mourning_Warbler_0015_166535.jpg,500,333,170.Mourning_Warbler,121,110,263,243,192,176,142,133
../../CUB_200_2011/images\170.Mourning_Warbler/Mourning_Warbler_0052_166537.jpg,420,280,170.Mourning_Warbler,188,80,351,206,269,143,163,126
../../CUB_200_2011/images\170.Mourning_Warbler/Mourning_Warbler_0026_166538.jpg,500,358,170.Mourning_Warbler,146,100,368,311,257,205,222,211
../../CUB_200_2011/images\170.Mourning_Warbler/Mourning_Warbler_0039_166546.jpg,334,500,170.Mourning_Warbler,69,42,291,481,180,261,222,439
../../CUB_200_2011/images\170.Mourning_Warbler/Mourning_Warbler_0038_166549.jpg,486,500,170.Mourning_Warbler,117,183,258,361,187,272,141,178
../../CUB_200_2011/images\170.Mourning_Warbler/Mourning_Warbler_0069_166559.jpg,500,333,170.Mourning_Warbler,106,104,436,264,271,184,330,160
../../CUB_200_2011/images\170.Mourning_Warbler/Mourning_Warbler_0021_166560.jpg,500,367,170.Mourning_Warbler,226,67,422,326,324,196,196,259
../../CUB_200_2011/images\170.Mourning_Warbler/Mourning_Warbler_0079_166564.jpg,500,399,170.Mourning_Warbler,204,150,332,279,268,214,128,129
../../CUB_200_2011/images\170.Mourning_Warbler/Mourning_Warbler_0077_166567.jpg,500,374,170.Mourning_Warbler,165,65,471,341,318,203,306,276
../../CUB_200_2011/images\170.Mourning_Warbler/Mourning_Warbler_0082_166574.jpg,429,475,170.Mourning_Warbler,171,80,363,389,267,234,192,309
../../CUB_200_2011/images\170.Mourning_Warbler/Mourning_Warbler_0045_166575.jpg,500,351,170.Mourning_Warbler,235,75,392,291,313,183,157,216
../../CUB_200_2011/images\170.Mourning_Warbler/Mourning_Warbler_0035_166586.jpg,500,332,170.Mourning_Warbler,220,56,361,274,290,165,141,218
../../CUB_200_2011/images\170.Mourning_Warbler/Mourning_Warbler_0006_166595.jpg,500,375,170.Mourning_Warbler,235,146,456,311,345,228,221,165
../../CUB_200_2011/images\170.Mourning_Warbler/Mourning_Warbler_0048_166596.jpg,500,281,170.Mourning_Warbler,166,20,482,242,324,131,316,222
../../CUB_200_2011/images\170.Mourning_Warbler/Mourning_Warbler_0061_166598.jpg,500,322,170.Mourning_Warbler,128,101,264,244,196,172,136,143
../../CUB_200_2011/images\170.Mourning_Warbler/Mourning_Warbler_0057_795342.jpg,500,400,170.Mourning_Warbler,83,79,304,238,193,158,221,159
../../CUB_200_2011/images\170.Mourning_Warbler/Mourning_Warbler_0050_795343.jpg,236,249,170.Mourning_Warbler,37,17,212,229,124,123,175,212
../../CUB_200_2011/images\170.Mourning_Warbler/Mourning_Warbler_0025_166608.jpg,500,391,170.Mourning_Warbler,163,124,367,280,265,202,204,156
../../CUB_200_2011/images\170.Mourning_Warbler/Mourning_Warbler_0053_795345.jpg,500,323,170.Mourning_Warbler,168,65,469,294,318,179,301,229
../../CUB_200_2011/images\170.Mourning_Warbler/Mourning_Warbler_0019_795347.jpg,500,375,170.Mourning_Warbler,39,23,409,373,224,198,370,350
../../CUB_200_2011/images\170.Mourning_Warbler/Mourning_Warbler_0051_795352.jpg,341,500,170.Mourning_Warbler,120,66,312,394,216,230,192,328
../../CUB_200_2011/images\170.Mourning_Warbler/Mourning_Warbler_0067_795353.jpg,428,325,170.Mourning_Warbler,13,65,420,260,216,162,407,195
../../CUB_200_2011/images\170.Mourning_Warbler/Mourning_Warbler_0060_795355.jpg,400,318,170.Mourning_Warbler,90,23,325,296,207,159,235,273
../../CUB_200_2011/images\170.Mourning_Warbler/Mourning_Warbler_0041_795358.jpg,320,254,170.Mourning_Warbler,131,89,284,197,207,143,153,108
../../CUB_200_2011/images\170.Mourning_Warbler/Mourning_Warbler_0023_795362.jpg,500,334,170.Mourning_Warbler,116,76,450,261,283,168,334,185
../../CUB_200_2011/images\170.Mourning_Warbler/Mourning_Warbler_0024_795363.jpg,500,334,170.Mourning_Warbler,48,100,302,291,175,195,254,191
../../CUB_200_2011/images\170.Mourning_Warbler/Mourning_Warbler_0059_795365.jpg,500,393,170.Mourning_Warbler,116,29,469,330,292,179,353,301
../../CUB_200_2011/images\170.Mourning_Warbler/Mourning_Warbler_0074_795367.jpg,388,458,170.Mourning_Warbler,51,51,286,373,168,212,235,322
../../CUB_200_2011/images\170.Mourning_Warbler/Mourning_Warbler_0040_795370.jpg,500,333,170.Mourning_Warbler,36,117,312,274,174,195,276,157
../../CUB_200_2011/images\170.Mourning_Warbler/Mourning_Warbler_0005_795372.jpg,500,388,170.Mourning_Warbler,4,16,484,370,244,193,480,354
../../CUB_200_2011/images\170.Mourning_Warbler/Mourning_Warbler_0047_795373.jpg,500,375,170.Mourning_Warbler,19,26,344,349,181,187,325,323
../../CUB_200_2011/images\170.Mourning_Warbler/Mourning_Warbler_0065_795374.jpg,468,342,170.Mourning_Warbler,41,65,387,258,214,161,346,193
../../CUB_200_2011/images\170.Mourning_Warbler/Mourning_Warbler_0083_795376.jpg,400,300,170.Mourning_Warbler,9,55,272,265,140,160,263,210
../../CUB_200_2011/images\170.Mourning_Warbler/Mourning_Warbler_0078_795377.jpg,500,358,170.Mourning_Warbler,70,46,363,290,216,168,293,244
../../CUB_200_2011/images\170.Mourning_Warbler/Mourning_Warbler_0072_795379.jpg,140,145,170.Mourning_Warbler,20,13,133,135,76,74,113,122
../../CUB_200_2011/images\170.Mourning_Warbler/Mourning_Warbler_0011_795380.jpg,500,350,170.Mourning_Warbler,36,108,349,299,192,203,313,191
../../CUB_200_2011/images\170.Mourning_Warbler/Mourning_Warbler_0037_795381.jpg,468,332,170.Mourning_Warbler,127,10,358,315,242,162,231,305
../../CUB_200_2011/images\170.Mourning_Warbler/Mourning_Warbler_0034_795384.jpg,500,323,170.Mourning_Warbler,252,94,436,240,344,167,184,146
../../CUB_200_2011/images\170.Mourning_Warbler/Mourning_Warbler_0018_795386.jpg,500,400,170.Mourning_Warbler,95,0,376,395,235,197,281,395
../../CUB_200_2011/images\170.Mourning_Warbler/Mourning_Warbler_0054_795387.jpg,333,500,170.Mourning_Warbler,23,119,273,401,148,260,250,282
../../CUB_200_2011/images\171.Myrtle_Warbler/Myrtle_Warbler_0069_166914.jpg,500,418,171.Myrtle_Warbler,192,127,311,281,251,204,119,154
../../CUB_200_2011/images\171.Myrtle_Warbler/Myrtle_Warbler_0107_166917.jpg,325,500,171.Myrtle_Warbler,67,69,248,470,157,269,181,401
../../CUB_200_2011/images\171.Myrtle_Warbler/Myrtle_Warbler_0094_166922.jpg,500,357,171.Myrtle_Warbler,130,81,361,265,245,173,231,184
../../CUB_200_2011/images\171.Myrtle_Warbler/Myrtle_Warbler_0086_166926.jpg,452,500,171.Myrtle_Warbler,46,92,385,471,215,281,339,379
../../CUB_200_2011/images\171.Myrtle_Warbler/Myrtle_Warbler_0008_166927.jpg,357,500,171.Myrtle_Warbler,83,184,255,426,169,305,172,242
../../CUB_200_2011/images\171.Myrtle_Warbler/Myrtle_Warbler_0064_166679.jpg,500,376,171.Myrtle_Warbler,54,128,291,293,172,210,237,165
../../CUB_200_2011/images\171.Myrtle_Warbler/Myrtle_Warbler_0026_166680.jpg,500,344,171.Myrtle_Warbler,55,120,427,309,241,214,372,189
../../CUB_200_2011/images\171.Myrtle_Warbler/Myrtle_Warbler_0101_166942.jpg,500,375,171.Myrtle_Warbler,142,118,320,252,231,185,178,134
../../CUB_200_2011/images\171.Myrtle_Warbler/Myrtle_Warbler_0059_166946.jpg,500,333,171.Myrtle_Warbler,193,145,298,250,245,197,105,105
../../CUB_200_2011/images\171.Myrtle_Warbler/Myrtle_Warbler_0071_166692.jpg,500,397,171.Myrtle_Warbler,103,112,346,298,224,205,243,186
../../CUB_200_2011/images\171.Myrtle_Warbler/Myrtle_Warbler_0072_166702.jpg,382,500,171.Myrtle_Warbler,27,102,267,478,147,290,240,376
../../CUB_200_2011/images\171.Myrtle_Warbler/Myrtle_Warbler_0025_166704.jpg,400,500,171.Myrtle_Warbler,53,87,268,456,160,271,215,369
../../CUB_200_2011/images\171.Myrtle_Warbler/Myrtle_Warbler_0103_166963.jpg,500,375,171.Myrtle_Warbler,1,55,360,373,180,214,359,318
../../CUB_200_2011/images\171.Myrtle_Warbler/Myrtle_Warbler_0039_166709.jpg,500,333,171.Myrtle_Warbler,76,133,347,290,211,211,271,157
../../CUB_200_2011/images\171.Myrtle_Warbler/Myrtle_Warbler_0045_166710.jpg,500,367,171.Myrtle_Warbler,157,108,467,260,312,184,310,152
../../CUB_200_2011/images\171.Myrtle_Warbler/Myrtle_Warbler_0043_166708.jpg,464,500,171.Myrtle_Warbler,173,93,331,378,252,235,158,285
../../CUB_200_2011/images\171.Myrtle_Warbler/Myrtle_Warbler_0034_166720.jpg,500,374,171.Myrtle_Warbler,86,147,319,249,202,198,233,102
../../CUB_200_2011/images\171.Myrtle_Warbler/Myrtle_Warbler_0009_166752.jpg,500,357,171.Myrtle_Warbler,47,72,243,274,145,173,196,202
../../CUB_200_2011/images\171.Myrtle_Warbler/Myrtle_Warbler_0102_166725.jpg,500,393,171.Myrtle_Warbler,147,73,440,327,293,200,293,254
../../CUB_200_2011/images\171.Myrtle_Warbler/Myrtle_Warbler_0033_166727.jpg,386,500,171.Myrtle_Warbler,105,76,277,410,191,243,172,334
../../CUB_200_2011/images\171.Myrtle_Warbler/Myrtle_Warbler_0054_166985.jpg,422,500,171.Myrtle_Warbler,15,34,365,393,190,213,350,359
../../CUB_200_2011/images\171.Myrtle_Warbler/Myrtle_Warbler_0093_166986.jpg,500,329,171.Myrtle_Warbler,176,81,491,296,333,188,315,215
../../CUB_200_2011/images\171.Myrtle_Warbler/Myrtle_Warbler_0047_166987.jpg,500,333,171.Myrtle_Warbler,136,51,403,287,269,169,267,236
../../CUB_200_2011/images\171.Myrtle_Warbler/Myrtle_Warbler_0016_166736.jpg,500,335,171.Myrtle_Warbler,233,45,461,292,347,168,228,247
../../CUB_200_2011/images\171.Myrtle_Warbler/Myrtle_Warbler_0083_166738.jpg,500,399,171.Myrtle_Warbler,131,83,479,308,305,195,348,225
../../CUB_200_2011/images\171.Myrtle_Warbler/Myrtle_Warbler_0020_166997.jpg,500,403,171.Myrtle_Warbler,168,79,435,389,301,234,267,310
../../CUB_200_2011/images\171.Myrtle_Warbler/Myrtle_Warbler_0015_166713.jpg,500,441,171.Myrtle_Warbler,26,98,345,385,185,241,319,287
../../CUB_200_2011/images\171.Myrtle_Warbler/Myrtle_Warbler_0097_167001.jpg,500,333,171.Myrtle_Warbler,187,117,390,306,288,211,203,189
../../CUB_200_2011/images\171.Myrtle_Warbler/Myrtle_Warbler_0084_166747.jpg,500,500,171.Myrtle_Warbler,191,245,396,390,293,317,205,145
../../CUB_200_2011/images\171.Myrtle_Warbler/Myrtle_Warbler_0077_166749.jpg,500,357,171.Myrtle_Warbler,38,54,374,283,206,168,336,229
../../CUB_200_2011/images\171.Myrtle_Warbler/Myrtle_Warbler_0112_166754.jpg,500,333,171.Myrtle_Warbler,80,89,319,305,199,197,239,216
../../CUB_200_2011/images\171.Myrtle_Warbler/Myrtle_Warbler_0091_166762.jpg,500,380,171.Myrtle_Warbler,55,71,395,320,225,195,340,249
../../CUB_200_2011/images\171.Myrtle_Warbler/Myrtle_Warbler_0023_166764.jpg,500,333,171.Myrtle_Warbler,150,55,486,330,318,192,336,275
../../CUB_200_2011/images\171.Myrtle_Warbler/Myrtle_Warbler_0001_166770.jpg,500,262,171.Myrtle_Warbler,255,30,434,192,344,111,179,162
../../CUB_200_2011/images\171.Myrtle_Warbler/Myrtle_Warbler_0087_166783.jpg,500,292,171.Myrtle_Warbler,104,21,426,265,265,143,322,244
../../CUB_200_2011/images\171.Myrtle_Warbler/Myrtle_Warbler_0110_166785.jpg,432,288,171.Myrtle_Warbler,102,21,370,252,236,136,268,231
../../CUB_200_2011/images\171.Myrtle_Warbler/Myrtle_Warbler_0068_166892.jpg,500,357,171.Myrtle_Warbler,60,88,366,288,213,188,306,200
../../CUB_200_2011/images\171.Myrtle_Warbler/Myrtle_Warbler_0098_166794.jpg,500,333,171.Myrtle_Warbler,109,122,253,226,181,174,144,104
../../CUB_200_2011/images\171.Myrtle_Warbler/Myrtle_Warbler_0073_166798.jpg,500,377,171.Myrtle_Warbler,18,38,480,317,249,177,462,279
../../CUB_200_2011/images\171.Myrtle_Warbler/Myrtle_Warbler_0028_166905.jpg,365,500,171.Myrtle_Warbler,101,95,250,377,175,236,149,282
../../CUB_200_2011/images\171.Myrtle_Warbler/Myrtle_Warbler_0061_166816.jpg,500,373,171.Myrtle_Warbler,46,120,325,300,185,210,279,180
../../CUB_200_2011/images\171.Myrtle_Warbler/Myrtle_Warbler_0050_166820.jpg,500,368,171.Myrtle_Warbler,130,114,481,326,305,220,351,212
../../CUB_200_2011/images\171.Myrtle_Warbler/Myrtle_Warbler_0067_166828.jpg,500,333,171.Myrtle_Warbler,159,98,303,211,231,154,144,113
../../CUB_200_2011/images\171.Myrtle_Warbler/Myrtle_Warbler_0104_166829.jpg,500,394,171.Myrtle_Warbler,188,112,407,271,297,191,219,159
../../CUB_200_2011/images\171.Myrtle_Warbler/Myrtle_Warbler_0014_166831.jpg,500,333,171.Myrtle_Warbler,38,44,389,299,213,171,351,255
../../CUB_200_2011/images\171.Myrtle_Warbler/Myrtle_Warbler_0036_166833.jpg,500,396,171.Myrtle_Warbler,5,91,430,321,217,206,425,230
../../CUB_200_2011/images\171.Myrtle_Warbler/Myrtle_Warbler_0113_166834.jpg,400,500,171.Myrtle_Warbler,17,148,271,447,144,297,254,299
../../CUB_200_2011/images\171.Myrtle_Warbler/Myrtle_Warbler_0032_166847.jpg,500,364,171.Myrtle_Warbler,205,114,484,310,344,212,279,196
../../CUB_200_2011/images\171.Myrtle_Warbler/Myrtle_Warbler_0063_93378.jpg,500,333,171.Myrtle_Warbler,166,10,410,327,288,168,244,317
../../CUB_200_2011/images\171.Myrtle_Warbler/Myrtle_Warbler_0044_166852.jpg,500,375,171.Myrtle_Warbler,141,87,323,246,232,166,182,159
../../CUB_200_2011/images\171.Myrtle_Warbler/Myrtle_Warbler_0005_166853.jpg,500,343,171.Myrtle_Warbler,114,120,352,241,233,180,238,121
../../CUB_200_2011/images\171.Myrtle_Warbler/Myrtle_Warbler_0030_166732.jpg,400,500,171.Myrtle_Warbler,49,77,355,357,202,217,306,280
../../CUB_200_2011/images\171.Myrtle_Warbler/Myrtle_Warbler_0037_166690.jpg,500,333,171.Myrtle_Warbler,163,88,330,204,246,146,167,116
../../CUB_200_2011/images\171.Myrtle_Warbler/Myrtle_Warbler_0100_166871.jpg,500,334,171.Myrtle_Warbler,134,68,369,302,251,185,235,234
../../CUB_200_2011/images\171.Myrtle_Warbler/Myrtle_Warbler_0078_166875.jpg,500,371,171.Myrtle_Warbler,76,67,399,290,237,178,323,223
../../CUB_200_2011/images\171.Myrtle_Warbler/Myrtle_Warbler_0065_166885.jpg,500,435,171.Myrtle_Warbler,45,133,411,408,228,270,366,275
../../CUB_200_2011/images\171.Myrtle_Warbler/Myrtle_Warbler_0074_166637.jpg,500,334,171.Myrtle_Warbler,268,130,392,250,330,190,124,120
../../CUB_200_2011/images\171.Myrtle_Warbler/Myrtle_Warbler_0088_166639.jpg,500,340,171.Myrtle_Warbler,179,79,474,269,326,174,295,190
../../CUB_200_2011/images\171.Myrtle_Warbler/Myrtle_Warbler_0089_166896.jpg,500,310,171.Myrtle_Warbler,26,42,434,294,230,168,408,252
../../CUB_200_2011/images\171.Myrtle_Warbler/Myrtle_Warbler_0007_166897.jpg,500,358,171.Myrtle_Warbler,176,41,387,226,281,133,211,185
../../CUB_200_2011/images\172.Nashville_Warbler/Nashville_Warbler_0109_167428.jpg,500,343,172.Nashville_Warbler,161,35,295,305,228,170,134,270
../../CUB_200_2011/images\172.Nashville_Warbler/Nashville_Warbler_0015_167429.jpg,500,275,172.Nashville_Warbler,199,43,346,246,272,144,147,203
../../CUB_200_2011/images\172.Nashville_Warbler/Nashville_Warbler_0105_167452.jpg,500,398,172.Nashville_Warbler,143,119,388,264,265,191,245,145
../../CUB_200_2011/images\172.Nashville_Warbler/Nashville_Warbler_0040_167454.jpg,500,333,172.Nashville_Warbler,193,120,383,255,288,187,190,135
../../CUB_200_2011/images\172.Nashville_Warbler/Nashville_Warbler_0103_167455.jpg,391,500,172.Nashville_Warbler,69,152,230,400,149,276,161,248
../../CUB_200_2011/images\172.Nashville_Warbler/Nashville_Warbler_0092_167457.jpg,500,334,172.Nashville_Warbler,135,48,378,303,256,175,243,255
../../CUB_200_2011/images\172.Nashville_Warbler/Nashville_Warbler_0036_167461.jpg,500,375,172.Nashville_Warbler,13,87,425,345,219,216,412,258
../../CUB_200_2011/images\172.Nashville_Warbler/Nashville_Warbler_0128_166444.jpg,500,367,172.Nashville_Warbler,149,126,448,310,298,218,299,184
../../CUB_200_2011/images\172.Nashville_Warbler/Nashville_Warbler_0050_167475.jpg,450,324,172.Nashville_Warbler,134,80,314,215,224,147,180,135
../../CUB_200_2011/images\172.Nashville_Warbler/Nashville_Warbler_0127_167494.jpg,500,333,172.Nashville_Warbler,78,102,290,241,184,171,212,139
../../CUB_200_2011/images\172.Nashville_Warbler/Nashville_Warbler_0006_167497.jpg,500,400,172.Nashville_Warbler,196,145,332,269,264,207,136,124
../../CUB_200_2011/images\172.Nashville_Warbler/Nashville_Warbler_0057_167008.jpg,500,366,172.Nashville_Warbler,179,128,444,276,311,202,265,148
../../CUB_200_2011/images\172.Nashville_Warbler/Nashville_Warbler_0115_167039.jpg,357,500,172.Nashville_Warbler,49,219,211,394,130,306,162,175
../../CUB_200_2011/images\172.Nashville_Warbler/Nashville_Warbler_0029_167044.jpg,500,354,172.Nashville_Warbler,139,112,280,244,209,178,141,132
../../CUB_200_2011/images\172.Nashville_Warbler/Nashville_Warbler_0086_167045.jpg,500,340,172.Nashville_Warbler,86,72,320,251,203,161,234,179
../../CUB_200_2011/images\172.Nashville_Warbler/Nashville_Warbler_0129_167053.jpg,500,377,172.Nashville_Warbler,128,76,283,331,205,203,155,255
../../CUB_200_2011/images\172.Nashville_Warbler/Nashville_Warbler_0041_167534.jpg,384,500,172.Nashville_Warbler,23,157,190,309,106,233,167,152
../../CUB_200_2011/images\172.Nashville_Warbler/Nashville_Warbler_0048_167071.jpg,500,375,172.Nashville_Warbler,30,81,427,283,228,182,397,202
../../CUB_200_2011/images\172.Nashville_Warbler/Nashville_Warbler_0121_167078.jpg,500,336,172.Nashville_Warbler,72,105,255,241,163,173,183,136
../../CUB_200_2011/images\172.Nashville_Warbler/Nashville_Warbler_0104_167096.jpg,500,375,172.Nashville_Warbler,20,50,499,369,259,209,479,319
../../CUB_200_2011/images\172.Nashville_Warbler/Nashville_Warbler_0130_167101.jpg,500,460,172.Nashville_Warbler,148,142,335,350,241,246,187,208
../../CUB_200_2011/images\172.Nashville_Warbler/Nashville_Warbler_0005_167103.jpg,500,338,172.Nashville_Warbler,60,87,295,233,177,160,235,146
../../CUB_200_2011/images\172.Nashville_Warbler/Nashville_Warbler_0001_167117.jpg,500,333,172.Nashville_Warbler,199,82,371,261,285,171,172,179
../../CUB_200_2011/images\172.Nashville_Warbler/Nashville_Warbler_0056_167123.jpg,500,379,172.Nashville_Warbler,41,100,353,271,197,185,312,171
../../CUB_200_2011/images\172.Nashville_Warbler/Nashville_Warbler_0004_167146.jpg,500,333,172.Nashville_Warbler,194,111,350,264,272,187,156,153
../../CUB_200_2011/images\172.Nashville_Warbler/Nashville_Warbler_0120_167149.jpg,362,500,172.Nashville_Warbler,0,50,307,435,153,242,307,385
../../CUB_200_2011/images\172.Nashville_Warbler/Nashville_Warbler_0107_167186.jpg,357,500,172.Nashville_Warbler,108,181,223,297,165,239,115,116
../../CUB_200_2011/images\172.Nashville_Warbler/Nashville_Warbler_0014_167190.jpg,356,500,172.Nashville_Warbler,61,213,281,412,171,312,220,199
../../CUB_200_2011/images\172.Nashville_Warbler/Nashville_Warbler_0018_167191.jpg,500,402,172.Nashville_Warbler,99,130,296,312,197,221,197,182
../../CUB_200_2011/images\172.Nashville_Warbler/Nashville_Warbler_0102_167195.jpg,500,370,172.Nashville_Warbler,165,113,312,271,238,192,147,158
../../CUB_200_2011/images\172.Nashville_Warbler/Nashville_Warbler_0020_167198.jpg,500,335,172.Nashville_Warbler,59,87,314,260,186,173,255,173
../../CUB_200_2011/images\172.Nashville_Warbler/Nashville_Warbler_0079_167213.jpg,500,335,172.Nashville_Warbler,166,72,413,236,289,154,247,164
../../CUB_200_2011/images\172.Nashville_Warbler/Nashville_Warbler_0027_167224.jpg,500,469,172.Nashville_Warbler,118,206,348,314,233,260,230,108
../../CUB_200_2011/images\172.Nashville_Warbler/Nashville_Warbler_0100_167226.jpg,500,333,172.Nashville_Warbler,163,77,427,261,295,169,264,184
../../CUB_200_2011/images\172.Nashville_Warbler/Nashville_Warbler_0081_167234.jpg,500,333,172.Nashville_Warbler,81,81,281,220,181,150,200,139
../../CUB_200_2011/images\172.Nashville_Warbler/Nashville_Warbler_0023_167242.jpg,500,355,172.Nashville_Warbler,42,82,343,232,192,157,301,150
../../CUB_200_2011/images\172.Nashville_Warbler/Nashville_Warbler_0051_167250.jpg,500,500,172.Nashville_Warbler,146,104,452,312,299,208,306,208
../../CUB_200_2011/images\172.Nashville_Warbler/Nashville_Warbler_0054_167258.jpg,500,330,172.Nashville_Warbler,52,39,443,296,247,167,391,257
../../CUB_200_2011/images\172.Nashville_Warbler/Nashville_Warbler_0108_167259.jpg,500,375,172.Nashville_Warbler,138,120,371,248,254,184,233,128
../../CUB_200_2011/images\172.Nashville_Warbler/Nashville_Warbler_0068_167266.jpg,500,325,172.Nashville_Warbler,151,104,356,247,253,175,205,143
../../CUB_200_2011/images\172.Nashville_Warbler/Nashville_Warbler_0110_167268.jpg,500,355,172.Nashville_Warbler,31,76,460,351,245,213,429,275
../../CUB_200_2011/images\172.Nashville_Warbler/Nashville_Warbler_0126_167274.jpg,500,357,172.Nashville_Warbler,228,68,456,202,342,135,228,134
../../CUB_200_2011/images\172.Nashville_Warbler/Nashville_Warbler_0037_167280.jpg,500,333,172.Nashville_Warbler,79,95,387,262,233,178,308,167
../../CUB_200_2011/images\172.Nashville_Warbler/Nashville_Warbler_0035_167283.jpg,500,333,172.Nashville_Warbler,178,78,435,296,306,187,257,218
../../CUB_200_2011/images\172.Nashville_Warbler/Nashville_Warbler_0124_167285.jpg,500,357,172.Nashville_Warbler,46,67,405,312,225,189,359,245
../../CUB_200_2011/images\172.Nashville_Warbler/Nashville_Warbler_0098_167293.jpg,500,400,172.Nashville_Warbler,194,75,339,286,266,180,145,211
../../CUB_200_2011/images\172.Nashville_Warbler/Nashville_Warbler_0028_167065.jpg,500,346,172.Nashville_Warbler,188,165,375,282,281,223,187,117
../../CUB_200_2011/images\172.Nashville_Warbler/Nashville_Warbler_0123_167324.jpg,500,348,172.Nashville_Warbler,157,80,464,311,310,195,307,231
../../CUB_200_2011/images\172.Nashville_Warbler/Nashville_Warbler_0013_167326.jpg,500,334,172.Nashville_Warbler,108,79,344,298,226,188,236,219
../../CUB_200_2011/images\172.Nashville_Warbler/Nashville_Warbler_0055_167331.jpg,500,424,172.Nashville_Warbler,187,139,419,374,303,256,232,235
../../CUB_200_2011/images\172.Nashville_Warbler/Nashville_Warbler_0042_167346.jpg,500,333,172.Nashville_Warbler,74,76,296,254,185,165,222,178
../../CUB_200_2011/images\172.Nashville_Warbler/Nashville_Warbler_0060_167347.jpg,500,365,172.Nashville_Warbler,181,94,430,286,305,190,249,192
../../CUB_200_2011/images\172.Nashville_Warbler/Nashville_Warbler_0118_167350.jpg,500,315,172.Nashville_Warbler,134,69,430,263,282,166,296,194
../../CUB_200_2011/images\172.Nashville_Warbler/Nashville_Warbler_0061_167355.jpg,420,280,172.Nashville_Warbler,75,46,319,242,197,144,244,196
../../CUB_200_2011/images\172.Nashville_Warbler/Nashville_Warbler_0044_167357.jpg,500,400,172.Nashville_Warbler,129,123,459,299,294,211,330,176
../../CUB_200_2011/images\172.Nashville_Warbler/Nashville_Warbler_0032_167385.jpg,500,332,172.Nashville_Warbler,25,69,333,315,179,192,308,246
../../CUB_200_2011/images\172.Nashville_Warbler/Nashville_Warbler_0076_167389.jpg,486,500,172.Nashville_Warbler,162,163,330,347,246,255,168,184
../../CUB_200_2011/images\172.Nashville_Warbler/Nashville_Warbler_0053_167403.jpg,500,333,172.Nashville_Warbler,149,106,439,247,294,176,290,141
../../CUB_200_2011/images\172.Nashville_Warbler/Nashville_Warbler_0064_167411.jpg,500,355,172.Nashville_Warbler,108,102,319,223,213,162,211,121
../../CUB_200_2011/images\172.Nashville_Warbler/Nashville_Warbler_0075_167419.jpg,500,335,172.Nashville_Warbler,54,94,288,240,171,167,234,146
../../CUB_200_2011/images\173.Orange_crowned_Warbler/Orange_Crowned_Warbler_0083_167948.jpg,500,357,173.Orange_crowned_Warbler,273,50,406,305,339,177,133,255
../../CUB_200_2011/images\173.Orange_crowned_Warbler/Orange_Crowned_Warbler_0066_167949.jpg,500,436,173.Orange_crowned_Warbler,52,68,435,434,243,251,383,366
../../CUB_200_2011/images\173.Orange_crowned_Warbler/Orange_Crowned_Warbler_0065_167952.jpg,500,448,173.Orange_crowned_Warbler,46,142,315,367,180,254,269,225
../../CUB_200_2011/images\173.Orange_crowned_Warbler/Orange_Crowned_Warbler_0064_166929.jpg,500,359,173.Orange_crowned_Warbler,40,48,472,348,256,198,432,300
../../CUB_200_2011/images\173.Orange_crowned_Warbler/Orange_Crowned_Warbler_0080_167960.jpg,500,342,173.Orange_crowned_Warbler,95,70,484,277,289,173,389,207
../../CUB_200_2011/images\173.Orange_crowned_Warbler/Orange_Crowned_Warbler_0078_167964.jpg,405,500,173.Orange_crowned_Warbler,36,71,355,401,195,236,319,330
../../CUB_200_2011/images\173.Orange_crowned_Warbler/Orange_Crowned_Warbler_0049_167974.jpg,500,329,173.Orange_crowned_Warbler,69,105,495,284,282,194,426,179
../../CUB_200_2011/images\173.Orange_crowned_Warbler/Orange_Crowned_Warbler_0037_167687.jpg,500,334,173.Orange_crowned_Warbler,217,69,490,290,353,179,273,221
../../CUB_200_2011/images\173.Orange_crowned_Warbler/Orange_Crowned_Warbler_0113_167984.jpg,500,359,173.Orange_crowned_Warbler,166,82,404,240,285,161,238,158
../../CUB_200_2011/images\173.Orange_crowned_Warbler/Orange_Crowned_Warbler_0117_167987.jpg,500,357,173.Orange_crowned_Warbler,14,104,391,339,202,221,377,235
../../CUB_200_2011/images\173.Orange_crowned_Warbler/Orange_Crowned_Warbler_0033_167991.jpg,500,388,173.Orange_crowned_Warbler,133,156,278,301,205,228,145,145
../../CUB_200_2011/images\173.Orange_crowned_Warbler/Orange_Crowned_Warbler_0006_167998.jpg,500,375,173.Orange_crowned_Warbler,104,128,372,325,238,226,268,197
../../CUB_200_2011/images\173.Orange_crowned_Warbler/Orange_Crowned_Warbler_0051_168002.jpg,500,333,173.Orange_crowned_Warbler,268,103,453,229,360,166,185,126
../../CUB_200_2011/images\173.Orange_crowned_Warbler/Orange_Crowned_Warbler_0097_168004.jpg,500,333,173.Orange_crowned_Warbler,39,72,332,252,185,162,293,180
../../CUB_200_2011/images\173.Orange_crowned_Warbler/Orange_Crowned_Warbler_0090_167607.jpg,500,452,173.Orange_crowned_Warbler,189,199,456,326,322,262,267,127
../../CUB_200_2011/images\173.Orange_crowned_Warbler/Orange_Crowned_Warbler_0128_168012.jpg,500,343,173.Orange_crowned_Warbler,143,81,434,278,288,179,291,197
../../CUB_200_2011/images\173.Orange_crowned_Warbler/Orange_Crowned_Warbler_0052_168013.jpg,500,333,173.Orange_crowned_Warbler,116,123,228,262,172,192,112,139
../../CUB_200_2011/images\173.Orange_crowned_Warbler/Orange_Crowned_Warbler_0040_168029.jpg,500,375,173.Orange_crowned_Warbler,185,118,378,237,281,177,193,119
../../CUB_200_2011/images\173.Orange_crowned_Warbler/Orange_Crowned_Warbler_0111_168040.jpg,500,333,173.Orange_crowned_Warbler,63,85,421,288,242,186,358,203
../../CUB_200_2011/images\173.Orange_crowned_Warbler/Orange_Crowned_Warbler_0088_168052.jpg,500,332,173.Orange_crowned_Warbler,234,137,423,258,328,197,189,121
../../CUB_200_2011/images\173.Orange_crowned_Warbler/Orange_Crowned_Warbler_0042_167614.jpg,500,386,173.Orange_crowned_Warbler,37,100,494,356,265,228,457,256
../../CUB_200_2011/images\173.Orange_crowned_Warbler/Orange_Crowned_Warbler_0103_168566.jpg,500,281,173.Orange_crowned_Warbler,292,98,455,224,373,161,163,126
../../CUB_200_2011/images\173.Orange_crowned_Warbler/Orange_Crowned_Warbler_0007_167545.jpg,500,375,173.Orange_crowned_Warbler,168,116,376,287,272,201,208,171
../../CUB_200_2011/images\173.Orange_crowned_Warbler/Orange_Crowned_Warbler_0016_168082.jpg,500,333,173.Orange_crowned_Warbler,46,130,330,266,188,198,284,136
../../CUB_200_2011/images\173.Orange_crowned_Warbler/Orange_Crowned_Warbler_0055_168600.jpg,500,298,173.Orange_crowned_Warbler,142,37,377,255,259,146,235,218
../../CUB_200_2011/images\173.Orange_crowned_Warbler/Orange_Crowned_Warbler_0091_167578.jpg,375,500,173.Orange_crowned_Warbler,165,176,351,375,258,275,186,199
../../CUB_200_2011/images\173.Orange_crowned_Warbler/Orange_Crowned_Warbler_0094_167584.jpg,500,299,173.Orange_crowned_Warbler,131,50,461,253,296,151,330,203
../../CUB_200_2011/images\173.Orange_crowned_Warbler/Orange_Crowned_Warbler_0068_167585.jpg,500,375,173.Orange_crowned_Warbler,197,99,444,287,320,193,247,188
../../CUB_200_2011/images\173.Orange_crowned_Warbler/Orange_Crowned_Warbler_0120_167587.jpg,500,327,173.Orange_crowned_Warbler,178,74,462,308,320,191,284,234
../../CUB_200_2011/images\173.Orange_crowned_Warbler/Orange_Crowned_Warbler_0067_167588.jpg,500,477,173.Orange_crowned_Warbler,298,110,497,287,397,198,199,177
../../CUB_200_2011/images\173.Orange_crowned_Warbler/Orange_Crowned_Warbler_0032_167589.jpg,498,500,173.Orange_crowned_Warbler,198,197,385,354,291,275,187,157
../../CUB_200_2011/images\173.Orange_crowned_Warbler/Orange_Crowned_Warbler_0071_167595.jpg,500,465,173.Orange_crowned_Warbler,106,80,347,341,226,210,241,261
../../CUB_200_2011/images\173.Orange_crowned_Warbler/Orange_Crowned_Warbler_0062_168119.jpg,500,295,173.Orange_crowned_Warbler,40,58,200,213,120,135,160,155
../../CUB_200_2011/images\173.Orange_crowned_Warbler/Orange_Crowned_Warbler_0048_167610.jpg,500,333,173.Orange_crowned_Warbler,181,73,332,213,256,143,151,140
../../CUB_200_2011/images\173.Orange_crowned_Warbler/Orange_Crowned_Warbler_0018_168126.jpg,500,335,173.Orange_crowned_Warbler,81,47,316,313,198,180,235,266
../../CUB_200_2011/images\173.Orange_crowned_Warbler/Orange_Crowned_Warbler_0011_167615.jpg,333,500,173.Orange_crowned_Warbler,106,166,272,389,189,277,166,223
../../CUB_200_2011/images\173.Orange_crowned_Warbler/Orange_Crowned_Warbler_0019_167626.jpg,500,396,173.Orange_crowned_Warbler,60,57,407,265,233,161,347,208
../../CUB_200_2011/images\173.Orange_crowned_Warbler/Orange_Crowned_Warbler_0118_167640.jpg,500,340,173.Orange_crowned_Warbler,122,52,497,240,309,146,375,188
../../CUB_200_2011/images\173.Orange_crowned_Warbler/Orange_Crowned_Warbler_0028_167641.jpg,500,375,173.Orange_crowned_Warbler,8,45,492,354,250,199,484,309
../../CUB_200_2011/images\173.Orange_crowned_Warbler/Orange_Crowned_Warbler_0081_167647.jpg,500,333,173.Orange_crowned_Warbler,78,101,324,217,201,159,246,116
../../CUB_200_2011/images\173.Orange_crowned_Warbler/Orange_Crowned_Warbler_0050_168166.jpg,360,240,173.Orange_crowned_Warbler,12,20,349,229,180,124,337,209
../../CUB_200_2011/images\173.Orange_crowned_Warbler/Orange_Crowned_Warbler_0119_167658.jpg,500,368,173.Orange_crowned_Warbler,36,174,266,345,151,259,230,171
../../CUB_200_2011/images\173.Orange_crowned_Warbler/Orange_Crowned_Warbler_0001_167660.jpg,500,333,173.Orange_crowned_Warbler,49,21,198,273,123,147,149,252
../../CUB_200_2011/images\173.Orange_crowned_Warbler/Orange_Crowned_Warbler_0034_168185.jpg,500,333,173.Orange_crowned_Warbler,92,102,356,237,224,169,264,135
../../CUB_200_2011/images\173.Orange_crowned_Warbler/Orange_Crowned_Warbler_0102_168189.jpg,500,351,173.Orange_crowned_Warbler,83,148,266,261,174,204,183,113
../../CUB_200_2011/images\173.Orange_crowned_Warbler/Orange_Crowned_Warbler_0015_168196.jpg,500,332,173.Orange_crowned_Warbler,46,76,333,302,189,189,287,226
../../CUB_200_2011/images\173.Orange_crowned_Warbler/Orange_Crowned_Warbler_0009_168228.jpg,500,389,173.Orange_crowned_Warbler,79,46,432,359,255,202,353,313
../../CUB_200_2011/images\173.Orange_crowned_Warbler/Orange_Crowned_Warbler_0114_167732.jpg,500,363,173.Orange_crowned_Warbler,42,68,417,331,229,199,375,263
../../CUB_200_2011/images\173.Orange_crowned_Warbler/Orange_Crowned_Warbler_0059_168259.jpg,372,500,173.Orange_crowned_Warbler,31,42,348,438,189,240,317,396
../../CUB_200_2011/images\173.Orange_crowned_Warbler/Orange_Crowned_Warbler_0021_168263.jpg,500,333,173.Orange_crowned_Warbler,226,126,327,253,276,189,101,127
../../CUB_200_2011/images\173.Orange_crowned_Warbler/Orange_Crowned_Warbler_0005_168314.jpg,330,403,173.Orange_crowned_Warbler,9,184,319,367,164,275,310,183
../../CUB_200_2011/images\173.Orange_crowned_Warbler/Orange_Crowned_Warbler_0079_168372.jpg,500,334,173.Orange_crowned_Warbler,206,81,416,285,311,183,210,204
../../CUB_200_2011/images\173.Orange_crowned_Warbler/Orange_Crowned_Warbler_0030_168376.jpg,398,500,173.Orange_crowned_Warbler,71,160,372,398,221,279,301,238
../../CUB_200_2011/images\173.Orange_crowned_Warbler/Orange_Crowned_Warbler_0027_168381.jpg,500,333,173.Orange_crowned_Warbler,127,103,370,247,248,175,243,144
../../CUB_200_2011/images\173.Orange_crowned_Warbler/Orange_Crowned_Warbler_0038_168384.jpg,500,398,173.Orange_crowned_Warbler,79,116,408,290,243,203,329,174
../../CUB_200_2011/images\173.Orange_crowned_Warbler/Orange_Crowned_Warbler_0056_167876.jpg,500,333,173.Orange_crowned_Warbler,229,111,437,257,333,184,208,146
../../CUB_200_2011/images\173.Orange_crowned_Warbler/Orange_Crowned_Warbler_0057_168424.jpg,412,500,173.Orange_crowned_Warbler,107,84,385,264,246,174,278,180
../../CUB_200_2011/images\173.Orange_crowned_Warbler/Orange_Crowned_Warbler_0112_168437.jpg,500,380,173.Orange_crowned_Warbler,140,136,359,278,249,207,219,142
../../CUB_200_2011/images\173.Orange_crowned_Warbler/Orange_Crowned_Warbler_0087_168439.jpg,500,241,173.Orange_crowned_Warbler,181,79,366,190,273,134,185,111
../../CUB_200_2011/images\173.Orange_crowned_Warbler/Orange_Crowned_Warbler_0126_168445.jpg,432,346,173.Orange_crowned_Warbler,92,98,286,233,189,165,194,135
../../CUB_200_2011/images\174.Palm_Warbler/Palm_Warbler_0007_169473.jpg,395,500,174.Palm_Warbler,90,67,362,464,226,265,272,397
../../CUB_200_2011/images\174.Palm_Warbler/Palm_Warbler_0093_170499.jpg,500,375,174.Palm_Warbler,139,78,419,353,279,215,280,275
../../CUB_200_2011/images\174.Palm_Warbler/Palm_Warbler_0024_170501.jpg,500,415,174.Palm_Warbler,93,41,428,330,260,185,335,289
../../CUB_200_2011/images\174.Palm_Warbler/Palm_Warbler_0089_168968.jpg,500,330,174.Palm_Warbler,174,82,334,252,254,167,160,170
../../CUB_200_2011/images\174.Palm_Warbler/Palm_Warbler_0051_169487.jpg,500,375,174.Palm_Warbler,202,119,405,238,303,178,203,119
../../CUB_200_2011/images\174.Palm_Warbler/Palm_Warbler_0110_169490.jpg,500,373,174.Palm_Warbler,95,94,329,300,212,197,234,206
../../CUB_200_2011/images\174.Palm_Warbler/Palm_Warbler_0117_170073.jpg,420,280,174.Palm_Warbler,127,21,296,265,211,143,169,244
../../CUB_200_2011/images\174.Palm_Warbler/Palm_Warbler_0002_169527.jpg,500,417,174.Palm_Warbler,41,74,499,416,270,245,458,342
../../CUB_200_2011/images\174.Palm_Warbler/Palm_Warbler_0050_170042.jpg,500,400,174.Palm_Warbler,70,103,312,314,191,208,242,211
../../CUB_200_2011/images\174.Palm_Warbler/Palm_Warbler_0056_168740.jpg,500,400,174.Palm_Warbler,56,70,386,291,221,180,330,221
../../CUB_200_2011/images\174.Palm_Warbler/Palm_Warbler_0077_169042.jpg,500,500,174.Palm_Warbler,63,189,350,414,206,301,287,225
../../CUB_200_2011/images\174.Palm_Warbler/Palm_Warbler_0113_170080.jpg,500,375,174.Palm_Warbler,123,149,311,282,217,215,188,133
../../CUB_200_2011/images\174.Palm_Warbler/Palm_Warbler_0118_170081.jpg,500,333,174.Palm_Warbler,94,106,348,303,221,204,254,197
../../CUB_200_2011/images\174.Palm_Warbler/Palm_Warbler_0106_169571.jpg,500,435,174.Palm_Warbler,70,108,313,290,191,199,243,182
../../CUB_200_2011/images\174.Palm_Warbler/Palm_Warbler_0133_169575.jpg,500,388,174.Palm_Warbler,108,50,399,370,253,210,291,320
../../CUB_200_2011/images\174.Palm_Warbler/Palm_Warbler_0092_170604.jpg,500,400,174.Palm_Warbler,64,102,392,325,228,213,328,223
../../CUB_200_2011/images\174.Palm_Warbler/Palm_Warbler_0112_169595.jpg,500,371,174.Palm_Warbler,231,44,389,342,310,193,158,298
../../CUB_200_2011/images\174.Palm_Warbler/Palm_Warbler_0107_170620.jpg,500,333,174.Palm_Warbler,47,45,388,321,217,183,341,276
../../CUB_200_2011/images\174.Palm_Warbler/Palm_Warbler_0046_169837.jpg,500,456,174.Palm_Warbler,38,97,378,419,208,258,340,322
../../CUB_200_2011/images\174.Palm_Warbler/Palm_Warbler_0015_169626.jpg,500,407,174.Palm_Warbler,220,143,451,370,335,256,231,227
../../CUB_200_2011/images\174.Palm_Warbler/Palm_Warbler_0028_169670.jpg,500,335,174.Palm_Warbler,176,121,305,257,240,189,129,136
../../CUB_200_2011/images\174.Palm_Warbler/Palm_Warbler_0095_170610.jpg,500,334,174.Palm_Warbler,143,91,362,318,252,204,219,227
../../CUB_200_2011/images\174.Palm_Warbler/Palm_Warbler_0111_169663.jpg,500,375,174.Palm_Warbler,140,110,376,310,258,210,236,200
../../CUB_200_2011/images\174.Palm_Warbler/Palm_Warbler_0086_169676.jpg,500,343,174.Palm_Warbler,133,61,361,263,247,162,228,202
../../CUB_200_2011/images\174.Palm_Warbler/Palm_Warbler_0054_169175.jpg,500,356,174.Palm_Warbler,152,123,271,304,211,213,119,181
../../CUB_200_2011/images\174.Palm_Warbler/Palm_Warbler_0136_170276.jpg,500,378,174.Palm_Warbler,179,104,379,328,279,216,200,224
../../CUB_200_2011/images\174.Palm_Warbler/Palm_Warbler_0055_170219.jpg,500,400,174.Palm_Warbler,54,31,422,346,238,188,368,315
../../CUB_200_2011/images\174.Palm_Warbler/Palm_Warbler_0060_168686.jpg,500,379,174.Palm_Warbler,70,64,480,363,275,213,410,299
../../CUB_200_2011/images\174.Palm_Warbler/Palm_Warbler_0068_170243.jpg,500,488,174.Palm_Warbler,73,137,338,394,205,265,265,257
../../CUB_200_2011/images\174.Palm_Warbler/Palm_Warbler_0082_168709.jpg,500,400,174.Palm_Warbler,33,72,357,387,195,229,324,315
../../CUB_200_2011/images\174.Palm_Warbler/Palm_Warbler_0100_168725.jpg,500,333,174.Palm_Warbler,114,87,385,257,249,172,271,170
../../CUB_200_2011/images\174.Palm_Warbler/Palm_Warbler_0081_169256.jpg,500,330,174.Palm_Warbler,120,90,383,271,251,180,263,181
../../CUB_200_2011/images\174.Palm_Warbler/Palm_Warbler_0083_170281.jpg,500,333,174.Palm_Warbler,157,78,441,304,299,191,284,226
../../CUB_200_2011/images\174.Palm_Warbler/Palm_Warbler_0075_168751.jpg,500,400,174.Palm_Warbler,100,36,238,377,169,206,138,341
../../CUB_200_2011/images\174.Palm_Warbler/Palm_Warbler_0073_169781.jpg,341,500,174.Palm_Warbler,40,89,293,410,166,249,253,321
../../CUB_200_2011/images\174.Palm_Warbler/Palm_Warbler_0001_170297.jpg,500,333,174.Palm_Warbler,197,107,362,225,279,166,165,118
../../CUB_200_2011/images\174.Palm_Warbler/Palm_Warbler_0066_169284.jpg,500,333,174.Palm_Warbler,51,51,186,204,118,127,135,153
../../CUB_200_2011/images\174.Palm_Warbler/Palm_Warbler_0126_170311.jpg,476,500,174.Palm_Warbler,183,172,316,319,249,245,133,147
../../CUB_200_2011/images\174.Palm_Warbler/Palm_Warbler_0116_170319.jpg,500,313,174.Palm_Warbler,109,94,363,249,236,171,254,155
../../CUB_200_2011/images\174.Palm_Warbler/Palm_Warbler_0004_168786.jpg,500,375,174.Palm_Warbler,128,71,399,293,263,182,271,222
../../CUB_200_2011/images\174.Palm_Warbler/Palm_Warbler_0067_169318.jpg,500,412,174.Palm_Warbler,156,95,455,354,305,224,299,259
../../CUB_200_2011/images\174.Palm_Warbler/Palm_Warbler_0044_169319.jpg,500,391,174.Palm_Warbler,94,64,377,264,235,164,283,200
../../CUB_200_2011/images\174.Palm_Warbler/Palm_Warbler_0012_170857.jpg,396,500,174.Palm_Warbler,14,127,319,465,166,296,305,338
../../CUB_200_2011/images\174.Palm_Warbler/Palm_Warbler_0034_170352.jpg,500,335,174.Palm_Warbler,174,107,362,259,268,183,188,152
../../CUB_200_2011/images\174.Palm_Warbler/Palm_Warbler_0096_170867.jpg,500,357,174.Palm_Warbler,183,61,468,316,325,188,285,255
../../CUB_200_2011/images\174.Palm_Warbler/Palm_Warbler_0102_168829.jpg,500,333,174.Palm_Warbler,209,126,442,262,325,194,233,136
../../CUB_200_2011/images\174.Palm_Warbler/Palm_Warbler_0047_169354.jpg,441,500,174.Palm_Warbler,114,215,264,334,189,274,150,119
../../CUB_200_2011/images\174.Palm_Warbler/Palm_Warbler_0039_170894.jpg,500,313,174.Palm_Warbler,163,74,330,263,246,168,167,189
../../CUB_200_2011/images\174.Palm_Warbler/Palm_Warbler_0020_168857.jpg,500,333,174.Palm_Warbler,140,103,420,303,280,203,280,200
../../CUB_200_2011/images\174.Palm_Warbler/Palm_Warbler_0049_169885.jpg,500,333,174.Palm_Warbler,192,83,365,274,278,178,173,191
../../CUB_200_2011/images\174.Palm_Warbler/Palm_Warbler_0105_170429.jpg,500,375,174.Palm_Warbler,224,125,417,315,320,220,193,190
../../CUB_200_2011/images\174.Palm_Warbler/Palm_Warbler_0005_169918.jpg,500,333,174.Palm_Warbler,143,105,383,260,263,182,240,155
../../CUB_200_2011/images\174.Palm_Warbler/Palm_Warbler_0040_169922.jpg,500,377,174.Palm_Warbler,7,28,399,333,203,180,392,305
../../CUB_200_2011/images\174.Palm_Warbler/Palm_Warbler_0013_169411.jpg,500,337,174.Palm_Warbler,150,52,410,276,280,164,260,224
../../CUB_200_2011/images\174.Palm_Warbler/Palm_Warbler_0108_169426.jpg,500,375,174.Palm_Warbler,19,117,228,348,123,232,209,231
../../CUB_200_2011/images\174.Palm_Warbler/Palm_Warbler_0006_169429.jpg,500,500,174.Palm_Warbler,118,137,466,411,292,274,348,274
../../CUB_200_2011/images\174.Palm_Warbler/Palm_Warbler_0061_169954.jpg,500,368,174.Palm_Warbler,155,88,345,280,250,184,190,192
../../CUB_200_2011/images\174.Palm_Warbler/Palm_Warbler_0003_170474.jpg,400,500,174.Palm_Warbler,56,122,265,285,160,203,209,163
../../CUB_200_2011/images\174.Palm_Warbler/Palm_Warbler_0010_169452.jpg,500,484,174.Palm_Warbler,44,162,349,370,196,266,305,208
../../CUB_200_2011/images\174.Palm_Warbler/Palm_Warbler_0134_168943.jpg,345,500,174.Palm_Warbler,71,54,285,454,178,254,214,400
../../CUB_200_2011/images\175.Pine_Warbler/Pine_Warbler_0007_171523.jpg,500,299,175.Pine_Warbler,27,112,288,281,157,196,261,169
../../CUB_200_2011/images\175.Pine_Warbler/Pine_Warbler_0021_171525.jpg,500,434,175.Pine_Warbler,190,170,356,290,273,230,166,120
../../CUB_200_2011/images\175.Pine_Warbler/Pine_Warbler_0129_171035.jpg,500,333,175.Pine_Warbler,22,41,354,329,188,185,332,288
../../CUB_200_2011/images\175.Pine_Warbler/Pine_Warbler_0005_171548.jpg,500,400,175.Pine_Warbler,57,85,386,309,221,197,329,224
../../CUB_200_2011/images\175.Pine_Warbler/Pine_Warbler_0074_172061.jpg,500,409,175.Pine_Warbler,134,115,483,359,308,237,349,244
../../CUB_200_2011/images\175.Pine_Warbler/Pine_Warbler_0119_171551.jpg,500,338,175.Pine_Warbler,133,114,415,256,274,185,282,142
../../CUB_200_2011/images\175.Pine_Warbler/Pine_Warbler_0111_171040.jpg,500,333,175.Pine_Warbler,168,58,455,285,311,171,287,227
../../CUB_200_2011/images\175.Pine_Warbler/Pine_Warbler_0032_172080.jpg,500,373,175.Pine_Warbler,80,90,299,278,189,184,219,188
../../CUB_200_2011/images\175.Pine_Warbler/Pine_Warbler_0095_171588.jpg,500,385,175.Pine_Warbler,157,76,285,227,221,151,128,151
../../CUB_200_2011/images\175.Pine_Warbler/Pine_Warbler_0076_172104.jpg,500,340,175.Pine_Warbler,80,133,278,295,179,214,198,162
../../CUB_200_2011/images\175.Pine_Warbler/Pine_Warbler_0065_172119.jpg,500,314,175.Pine_Warbler,221,47,465,244,343,145,244,197
../../CUB_200_2011/images\175.Pine_Warbler/Pine_Warbler_0035_98396.jpg,500,333,175.Pine_Warbler,212,89,367,303,289,196,155,214
../../CUB_200_2011/images\175.Pine_Warbler/Pine_Warbler_0108_170597.jpg,500,377,175.Pine_Warbler,61,109,444,352,252,230,383,243
../../CUB_200_2011/images\175.Pine_Warbler/Pine_Warbler_0044_171104.jpg,500,377,175.Pine_Warbler,172,114,385,233,278,173,213,119
../../CUB_200_2011/images\175.Pine_Warbler/Pine_Warbler_0106_171107.jpg,500,357,175.Pine_Warbler,94,84,395,318,244,201,301,234
../../CUB_200_2011/images\175.Pine_Warbler/Pine_Warbler_0025_171110.jpg,500,495,175.Pine_Warbler,13,95,394,455,203,275,381,360
../../CUB_200_2011/images\175.Pine_Warbler/Pine_Warbler_0091_171627.jpg,500,400,175.Pine_Warbler,69,81,437,288,253,184,368,207
../../CUB_200_2011/images\175.Pine_Warbler/Pine_Warbler_0083_171117.jpg,500,357,175.Pine_Warbler,209,107,408,241,308,174,199,134
../../CUB_200_2011/images\175.Pine_Warbler/Pine_Warbler_0060_171635.jpg,500,307,175.Pine_Warbler,211,75,376,197,293,136,165,122
../../CUB_200_2011/images\175.Pine_Warbler/Pine_Warbler_0003_171639.jpg,357,500,175.Pine_Warbler,35,72,341,398,188,235,306,326
../../CUB_200_2011/images\175.Pine_Warbler/Pine_Warbler_0133_171641.jpg,500,400,175.Pine_Warbler,140,223,497,399,318,311,357,176
../../CUB_200_2011/images\175.Pine_Warbler/Pine_Warbler_0037_171649.jpg,500,375,175.Pine_Warbler,102,13,384,347,243,180,282,334
../../CUB_200_2011/images\175.Pine_Warbler/Pine_Warbler_0033_171657.jpg,500,381,175.Pine_Warbler,67,66,322,302,194,184,255,236
../../CUB_200_2011/images\175.Pine_Warbler/Pine_Warbler_0102_171147.jpg,500,380,175.Pine_Warbler,80,73,381,319,230,196,301,246
../../CUB_200_2011/images\175.Pine_Warbler/Pine_Warbler_0045_171150.jpg,500,372,175.Pine_Warbler,162,54,429,325,295,189,267,271
../../CUB_200_2011/images\175.Pine_Warbler/Pine_Warbler_0118_171152.jpg,333,500,175.Pine_Warbler,15,146,261,373,138,259,246,227
../../CUB_200_2011/images\175.Pine_Warbler/Pine_Warbler_0104_171668.jpg,500,321,175.Pine_Warbler,237,51,404,180,320,115,167,129
../../CUB_200_2011/images\175.Pine_Warbler/Pine_Warbler_0078_171374.jpg,333,500,175.Pine_Warbler,112,146,305,378,208,262,193,232
../../CUB_200_2011/images\175.Pine_Warbler/Pine_Warbler_0097_171671.jpg,500,286,175.Pine_Warbler,39,72,279,203,159,137,240,131
../../CUB_200_2011/images\175.Pine_Warbler/Pine_Warbler_0017_171678.jpg,500,337,175.Pine_Warbler,65,86,388,312,226,199,323,226
../../CUB_200_2011/images\175.Pine_Warbler/Pine_Warbler_0022_172197.jpg,426,457,175.Pine_Warbler,42,84,385,388,213,236,343,304
../../CUB_200_2011/images\175.Pine_Warbler/Pine_Warbler_0002_171176.jpg,500,348,175.Pine_Warbler,237,148,498,320,367,234,261,172
../../CUB_200_2011/images\175.Pine_Warbler/Pine_Warbler_0056_172064.jpg,500,333,175.Pine_Warbler,196,97,416,266,306,181,220,169
../../CUB_200_2011/images\175.Pine_Warbler/Pine_Warbler_0004_171215.jpg,484,500,175.Pine_Warbler,32,34,471,485,251,259,439,451
../../CUB_200_2011/images\175.Pine_Warbler/Pine_Warbler_0050_159442.jpg,500,375,175.Pine_Warbler,181,86,326,221,253,153,145,135
../../CUB_200_2011/images\175.Pine_Warbler/Pine_Warbler_0127_171742.jpg,500,382,175.Pine_Warbler,103,111,436,345,269,228,333,234
../../CUB_200_2011/images\175.Pine_Warbler/Pine_Warbler_0010_171239.jpg,500,333,175.Pine_Warbler,57,66,370,298,213,182,313,232
../../CUB_200_2011/images\175.Pine_Warbler/Pine_Warbler_0141_171263.jpg,500,363,175.Pine_Warbler,93,36,456,292,274,164,363,256
../../CUB_200_2011/images\175.Pine_Warbler/Pine_Warbler_0122_171274.jpg,500,333,175.Pine_Warbler,109,121,377,295,243,208,268,174
../../CUB_200_2011/images\175.Pine_Warbler/Pine_Warbler_0126_171282.jpg,500,350,175.Pine_Warbler,39,100,295,286,167,193,256,186
../../CUB_200_2011/images\175.Pine_Warbler/Pine_Warbler_0054_171287.jpg,455,325,175.Pine_Warbler,148,40,424,291,286,165,276,251
../../CUB_200_2011/images\175.Pine_Warbler/Pine_Warbler_0120_172340.jpg,451,500,175.Pine_Warbler,12,133,374,372,193,252,362,239
../../CUB_200_2011/images\175.Pine_Warbler/Pine_Warbler_0008_171330.jpg,500,358,175.Pine_Warbler,20,122,349,357,184,239,329,235
../../CUB_200_2011/images\175.Pine_Warbler/Pine_Warbler_0009_171869.jpg,500,455,175.Pine_Warbler,152,162,403,283,277,222,251,121
../../CUB_200_2011/images\175.Pine_Warbler/Pine_Warbler_0052_171380.jpg,500,364,175.Pine_Warbler,121,84,433,289,277,186,312,205
../../CUB_200_2011/images\175.Pine_Warbler/Pine_Warbler_0136_171382.jpg,500,330,175.Pine_Warbler,87,54,463,282,275,168,376,228
../../CUB_200_2011/images\175.Pine_Warbler/Pine_Warbler_0084_172409.jpg,500,375,175.Pine_Warbler,59,95,492,372,275,233,433,277
../../CUB_200_2011/images\175.Pine_Warbler/Pine_Warbler_0038_171386.jpg,500,313,175.Pine_Warbler,55,11,373,303,214,157,318,292
../../CUB_200_2011/images\175.Pine_Warbler/Pine_Warbler_0103_171922.jpg,357,500,175.Pine_Warbler,13,81,331,330,172,205,318,249
../../CUB_200_2011/images\175.Pine_Warbler/Pine_Warbler_0075_171933.jpg,420,280,175.Pine_Warbler,29,34,403,270,216,152,374,236
../../CUB_200_2011/images\175.Pine_Warbler/Pine_Warbler_0132_171936.jpg,500,407,175.Pine_Warbler,97,130,327,257,212,193,230,127
../../CUB_200_2011/images\175.Pine_Warbler/Pine_Warbler_0113_172456.jpg,428,500,175.Pine_Warbler,129,221,391,401,260,311,262,180
../../CUB_200_2011/images\175.Pine_Warbler/Pine_Warbler_0046_171452.jpg,500,377,175.Pine_Warbler,112,106,335,290,223,198,223,184
../../CUB_200_2011/images\175.Pine_Warbler/Pine_Warbler_0080_171975.jpg,320,281,175.Pine_Warbler,11,121,282,245,146,183,271,124
../../CUB_200_2011/images\175.Pine_Warbler/Pine_Warbler_0020_171989.jpg,500,334,175.Pine_Warbler,23,25,377,192,200,108,354,167
../../CUB_200_2011/images\175.Pine_Warbler/Pine_Warbler_0088_170980.jpg,500,405,175.Pine_Warbler,120,128,462,324,291,226,342,196
../../CUB_200_2011/images\175.Pine_Warbler/Pine_Warbler_0085_170981.jpg,500,466,175.Pine_Warbler,83,140,399,349,241,244,316,209
../../CUB_200_2011/images\175.Pine_Warbler/Pine_Warbler_0105_170983.jpg,500,306,175.Pine_Warbler,115,53,469,259,292,156,354,206
../../CUB_200_2011/images\175.Pine_Warbler/Pine_Warbler_0041_171477.jpg,500,500,175.Pine_Warbler,103,59,382,449,242,254,279,390
../../CUB_200_2011/images\175.Pine_Warbler/Pine_Warbler_0101_171501.jpg,500,342,175.Pine_Warbler,144,65,469,340,306,202,325,275
../../CUB_200_2011/images\176.Prairie_Warbler/Prairie_Warbler_0113_172544.jpg,500,400,176.Prairie_Warbler,142,100,331,326,236,213,189,226
../../CUB_200_2011/images\176.Prairie_Warbler/Prairie_Warbler_0040_173056.jpg,500,349,176.Prairie_Warbler,115,68,307,303,211,185,192,235
../../CUB_200_2011/images\176.Prairie_Warbler/Prairie_Warbler_0010_172547.jpg,500,400,176.Prairie_Warbler,137,78,424,362,280,220,287,284
../../CUB_200_2011/images\176.Prairie_Warbler/Prairie_Warbler_0034_172549.jpg,334,500,176.Prairie_Warbler,148,125,305,292,226,208,157,167
../../CUB_200_2011/images\176.Prairie_Warbler/Prairie_Warbler_0037_172550.jpg,500,357,176.Prairie_Warbler,166,119,422,310,294,214,256,191
../../CUB_200_2011/images\176.Prairie_Warbler/Prairie_Warbler_0108_172559.jpg,500,357,176.Prairie_Warbler,140,104,348,282,244,193,208,178
../../CUB_200_2011/images\176.Prairie_Warbler/Prairie_Warbler_0107_173080.jpg,500,375,176.Prairie_Warbler,123,67,499,321,311,194,376,254
../../CUB_200_2011/images\176.Prairie_Warbler/Prairie_Warbler_0007_173081.jpg,500,357,176.Prairie_Warbler,96,123,317,263,206,193,221,140
../../CUB_200_2011/images\176.Prairie_Warbler/Prairie_Warbler_0058_172573.jpg,500,334,176.Prairie_Warbler,152,111,461,280,306,195,309,169
../../CUB_200_2011/images\176.Prairie_Warbler/Prairie_Warbler_0096_172577.jpg,500,339,176.Prairie_Warbler,18,24,459,320,238,172,441,296
../../CUB_200_2011/images\176.Prairie_Warbler/Prairie_Warbler_0048_173095.jpg,500,333,176.Prairie_Warbler,195,111,380,274,287,192,185,163
../../CUB_200_2011/images\176.Prairie_Warbler/Prairie_Warbler_0051_172585.jpg,500,374,176.Prairie_Warbler,140,125,455,270,297,197,315,145
../../CUB_200_2011/images\176.Prairie_Warbler/Prairie_Warbler_0091_172597.jpg,500,336,176.Prairie_Warbler,61,111,350,283,205,197,289,172
../../CUB_200_2011/images\176.Prairie_Warbler/Prairie_Warbler_0054_172602.jpg,500,354,176.Prairie_Warbler,191,57,422,350,306,203,231,293
../../CUB_200_2011/images\176.Prairie_Warbler/Prairie_Warbler_0123_172603.jpg,500,333,176.Prairie_Warbler,142,111,487,313,314,212,345,202
../../CUB_200_2011/images\176.Prairie_Warbler/Prairie_Warbler_0130_172609.jpg,500,332,176.Prairie_Warbler,127,3,330,266,228,134,203,263
../../CUB_200_2011/images\176.Prairie_Warbler/Prairie_Warbler_0137_172610.jpg,500,364,176.Prairie_Warbler,159,104,468,324,313,214,309,220
../../CUB_200_2011/images\176.Prairie_Warbler/Prairie_Warbler_0028_173123.jpg,363,500,176.Prairie_Warbler,110,45,341,447,225,246,231,402
../../CUB_200_2011/images\176.Prairie_Warbler/Prairie_Warbler_0104_172615.jpg,500,332,176.Prairie_Warbler,104,73,448,292,276,182,344,219
../../CUB_200_2011/images\176.Prairie_Warbler/Prairie_Warbler_0029_172618.jpg,333,500,176.Prairie_Warbler,121,118,259,408,190,263,138,290
../../CUB_200_2011/images\176.Prairie_Warbler/Prairie_Warbler_0002_172622.jpg,500,328,176.Prairie_Warbler,46,89,310,294,178,191,264,205
../../CUB_200_2011/images\176.Prairie_Warbler/Prairie_Warbler_0071_173140.jpg,500,325,176.Prairie_Warbler,248,146,397,317,322,231,149,171
../../CUB_200_2011/images\176.Prairie_Warbler/Prairie_Warbler_0063_172682.jpg,500,333,176.Prairie_Warbler,271,120,429,308,350,214,158,188
../../CUB_200_2011/images\176.Prairie_Warbler/Prairie_Warbler_0115_172689.jpg,432,376,176.Prairie_Warbler,92,18,390,342,241,180,298,324
../../CUB_200_2011/images\176.Prairie_Warbler/Prairie_Warbler_0138_172695.jpg,500,333,176.Prairie_Warbler,151,69,332,263,241,166,181,194
../../CUB_200_2011/images\176.Prairie_Warbler/Prairie_Warbler_0047_173210.jpg,500,333,176.Prairie_Warbler,207,161,374,263,290,212,167,102
../../CUB_200_2011/images\176.Prairie_Warbler/Prairie_Warbler_0132_172705.jpg,500,403,176.Prairie_Warbler,45,198,397,363,221,280,352,165
../../CUB_200_2011/images\176.Prairie_Warbler/Prairie_Warbler_0075_172709.jpg,500,400,176.Prairie_Warbler,109,95,275,310,192,202,166,215
../../CUB_200_2011/images\176.Prairie_Warbler/Prairie_Warbler_0080_172724.jpg,500,342,176.Prairie_Warbler,106,108,333,256,219,182,227,148
../../CUB_200_2011/images\176.Prairie_Warbler/Prairie_Warbler_0078_172729.jpg,500,333,176.Prairie_Warbler,134,124,423,266,278,195,289,142
../../CUB_200_2011/images\176.Prairie_Warbler/Prairie_Warbler_0079_172735.jpg,500,333,176.Prairie_Warbler,209,155,448,283,328,219,239,128
../../CUB_200_2011/images\176.Prairie_Warbler/Prairie_Warbler_0011_172744.jpg,500,400,176.Prairie_Warbler,72,75,384,322,228,198,312,247
../../CUB_200_2011/images\176.Prairie_Warbler/Prairie_Warbler_0135_172745.jpg,500,410,176.Prairie_Warbler,151,56,308,394,229,225,157,338
../../CUB_200_2011/images\176.Prairie_Warbler/Prairie_Warbler_0118_173261.jpg,500,333,176.Prairie_Warbler,151,95,309,216,230,155,158,121
../../CUB_200_2011/images\176.Prairie_Warbler/Prairie_Warbler_0062_172755.jpg,500,458,176.Prairie_Warbler,46,108,432,399,239,253,386,291
../../CUB_200_2011/images\176.Prairie_Warbler/Prairie_Warbler_0133_173279.jpg,500,375,176.Prairie_Warbler,163,79,358,247,260,163,195,168
../../CUB_200_2011/images\176.Prairie_Warbler/Prairie_Warbler_0136_172768.jpg,500,403,176.Prairie_Warbler,20,92,419,284,219,188,399,192
../../CUB_200_2011/images\176.Prairie_Warbler/Prairie_Warbler_0073_172771.jpg,500,333,176.Prairie_Warbler,28,26,410,320,219,173,382,294
../../CUB_200_2011/images\176.Prairie_Warbler/Prairie_Warbler_0106_173071.jpg,500,397,176.Prairie_Warbler,43,168,236,299,139,233,193,131
../../CUB_200_2011/images\176.Prairie_Warbler/Prairie_Warbler_0053_173290.jpg,500,357,176.Prairie_Warbler,126,71,492,324,309,197,366,253
../../CUB_200_2011/images\176.Prairie_Warbler/Prairie_Warbler_0082_172783.jpg,335,500,176.Prairie_Warbler,56,12,210,424,133,218,154,412
../../CUB_200_2011/images\176.Prairie_Warbler/Prairie_Warbler_0120_173097.jpg,500,333,176.Prairie_Warbler,82,69,376,305,229,187,294,236
../../CUB_200_2011/images\176.Prairie_Warbler/Prairie_Warbler_0031_172818.jpg,500,346,176.Prairie_Warbler,1,28,455,341,228,184,454,313
../../CUB_200_2011/images\176.Prairie_Warbler/Prairie_Warbler_0066_173350.jpg,500,333,176.Prairie_Warbler,164,107,350,284,257,195,186,177
../../CUB_200_2011/images\176.Prairie_Warbler/Prairie_Warbler_0094_91950.jpg,357,500,176.Prairie_Warbler,16,82,315,397,165,239,299,315
../../CUB_200_2011/images\176.Prairie_Warbler/Prairie_Warbler_0020_173359.jpg,500,333,176.Prairie_Warbler,73,43,438,298,255,170,365,255
../../CUB_200_2011/images\176.Prairie_Warbler/Prairie_Warbler_0050_173281.jpg,500,409,176.Prairie_Warbler,161,156,306,262,233,209,145,106
../../CUB_200_2011/images\176.Prairie_Warbler/Prairie_Warbler_0052_173400.jpg,500,409,176.Prairie_Warbler,66,54,435,314,250,184,369,260
../../CUB_200_2011/images\176.Prairie_Warbler/Prairie_Warbler_0021_172902.jpg,500,400,176.Prairie_Warbler,115,93,434,322,274,207,319,229
../../CUB_200_2011/images\176.Prairie_Warbler/Prairie_Warbler_0109_172909.jpg,500,357,176.Prairie_Warbler,183,117,485,320,334,218,302,203
../../CUB_200_2011/images\176.Prairie_Warbler/Prairie_Warbler_0127_172913.jpg,500,344,176.Prairie_Warbler,99,49,303,270,201,159,204,221
../../CUB_200_2011/images\176.Prairie_Warbler/Prairie_Warbler_0126_172931.jpg,500,333,176.Prairie_Warbler,150,90,303,241,226,165,153,151
../../CUB_200_2011/images\176.Prairie_Warbler/Prairie_Warbler_0112_173383.jpg,500,333,176.Prairie_Warbler,132,73,304,235,218,154,172,162
../../CUB_200_2011/images\176.Prairie_Warbler/Prairie_Warbler_0027_172465.jpg,500,388,176.Prairie_Warbler,216,111,445,320,330,215,229,209
../../CUB_200_2011/images\176.Prairie_Warbler/Prairie_Warbler_0105_172982.jpg,500,410,176.Prairie_Warbler,95,61,428,384,261,222,333,323
../../CUB_200_2011/images\176.Prairie_Warbler/Prairie_Warbler_0025_165306.jpg,500,362,176.Prairie_Warbler,204,123,338,296,271,209,134,173
../../CUB_200_2011/images\176.Prairie_Warbler/Prairie_Warbler_0009_173022.jpg,500,354,176.Prairie_Warbler,202,135,393,268,297,201,191,133
../../CUB_200_2011/images\176.Prairie_Warbler/Prairie_Warbler_0086_172534.jpg,500,333,176.Prairie_Warbler,49,43,476,314,262,178,427,271
../../CUB_200_2011/images\176.Prairie_Warbler/Prairie_Warbler_0125_172536.jpg,335,500,176.Prairie_Warbler,88,55,324,351,206,203,236,296
../../CUB_200_2011/images\176.Prairie_Warbler/Prairie_Warbler_0014_172542.jpg,500,333,176.Prairie_Warbler,172,72,471,276,321,174,299,204
../../CUB_200_2011/images\177.Prothonotary_Warbler/Prothonotary_Warbler_0112_174594.jpg,500,376,177.Prothonotary_Warbler,132,41,348,330,240,185,216,289
../../CUB_200_2011/images\177.Prothonotary_Warbler/Prothonotary_Warbler_0102_174595.jpg,500,355,177.Prothonotary_Warbler,121,111,459,295,290,203,338,184
../../CUB_200_2011/images\177.Prothonotary_Warbler/Prothonotary_Warbler_0073_174607.jpg,500,357,177.Prothonotary_Warbler,94,65,470,260,282,162,376,195
../../CUB_200_2011/images\177.Prothonotary_Warbler/Prothonotary_Warbler_0105_174097.jpg,500,375,177.Prothonotary_Warbler,88,47,478,338,283,192,390,291
../../CUB_200_2011/images\177.Prothonotary_Warbler/Prothonotary_Warbler_0046_174104.jpg,420,280,177.Prothonotary_Warbler,91,41,400,248,245,144,309,207
../../CUB_200_2011/images\177.Prothonotary_Warbler/Prothonotary_Warbler_0064_174106.jpg,500,375,177.Prothonotary_Warbler,55,156,473,343,264,249,418,187
../../CUB_200_2011/images\177.Prothonotary_Warbler/Prothonotary_Warbler_0117_174622.jpg,500,333,177.Prothonotary_Warbler,168,116,273,221,220,168,105,105
../../CUB_200_2011/images\177.Prothonotary_Warbler/Prothonotary_Warbler_0063_173830.jpg,500,375,177.Prothonotary_Warbler,164,92,467,277,315,184,303,185
../../CUB_200_2011/images\177.Prothonotary_Warbler/Prothonotary_Warbler_0088_173606.jpg,500,400,177.Prothonotary_Warbler,25,129,344,347,184,238,319,218
../../CUB_200_2011/images\177.Prothonotary_Warbler/Prothonotary_Warbler_0094_173607.jpg,500,381,177.Prothonotary_Warbler,74,75,419,271,246,173,345,196
../../CUB_200_2011/images\177.Prothonotary_Warbler/Prothonotary_Warbler_0109_174121.jpg,389,500,177.Prothonotary_Warbler,31,80,172,186,101,133,141,106
../../CUB_200_2011/images\177.Prothonotary_Warbler/Prothonotary_Warbler_0020_174122.jpg,500,375,177.Prothonotary_Warbler,83,52,473,335,278,193,390,283
../../CUB_200_2011/images\177.Prothonotary_Warbler/Prothonotary_Warbler_0033_174123.jpg,492,500,177.Prothonotary_Warbler,58,140,453,408,255,274,395,268
../../CUB_200_2011/images\177.Prothonotary_Warbler/Prothonotary_Warbler_0089_174636.jpg,500,469,177.Prothonotary_Warbler,101,248,316,393,208,320,215,145
../../CUB_200_2011/images\177.Prothonotary_Warbler/Prothonotary_Warbler_0108_174125.jpg,500,375,177.Prothonotary_Warbler,160,84,493,316,326,200,333,232
../../CUB_200_2011/images\177.Prothonotary_Warbler/Prothonotary_Warbler_0121_174643.jpg,500,292,177.Prothonotary_Warbler,68,104,280,215,174,159,212,111
../../CUB_200_2011/images\177.Prothonotary_Warbler/Prothonotary_Warbler_0022_174138.jpg,500,333,177.Prothonotary_Warbler,108,132,301,286,204,209,193,154
../../CUB_200_2011/images\177.Prothonotary_Warbler/Prothonotary_Warbler_0127_174149.jpg,500,421,177.Prothonotary_Warbler,77,96,453,420,265,258,376,324
../../CUB_200_2011/images\177.Prothonotary_Warbler/Prothonotary_Warbler_0090_174183.jpg,387,500,177.Prothonotary_Warbler,65,138,283,480,174,309,218,342
../../CUB_200_2011/images\177.Prothonotary_Warbler/Prothonotary_Warbler_0018_174196.jpg,500,365,177.Prothonotary_Warbler,138,104,318,218,228,161,180,114
../../CUB_200_2011/images\177.Prothonotary_Warbler/Prothonotary_Warbler_0124_173686.jpg,500,332,177.Prothonotary_Warbler,144,95,378,270,261,182,234,175
../../CUB_200_2011/images\177.Prothonotary_Warbler/Prothonotary_Warbler_0071_173690.jpg,500,357,177.Prothonotary_Warbler,130,102,437,336,283,219,307,234
../../CUB_200_2011/images\177.Prothonotary_Warbler/Prothonotary_Warbler_0069_174210.jpg,452,336,177.Prothonotary_Warbler,42,97,354,261,198,179,312,164
../../CUB_200_2011/images\177.Prothonotary_Warbler/Prothonotary_Warbler_0049_174213.jpg,500,386,177.Prothonotary_Warbler,13,61,381,313,197,187,368,252
../../CUB_200_2011/images\177.Prothonotary_Warbler/Prothonotary_Warbler_0106_174221.jpg,500,375,177.Prothonotary_Warbler,181,142,449,313,315,227,268,171
../../CUB_200_2011/images\177.Prothonotary_Warbler/Prothonotary_Warbler_0023_173788.jpg,447,500,177.Prothonotary_Warbler,196,127,299,441,247,284,103,314
../../CUB_200_2011/images\177.Prothonotary_Warbler/Prothonotary_Warbler_0076_174118.jpg,500,333,177.Prothonotary_Warbler,182,64,429,250,305,157,247,186
../../CUB_200_2011/images\177.Prothonotary_Warbler/Prothonotary_Warbler_0066_174318.jpg,500,375,177.Prothonotary_Warbler,255,113,355,256,305,184,100,143
../../CUB_200_2011/images\177.Prothonotary_Warbler/Prothonotary_Warbler_0057_173865.jpg,500,334,177.Prothonotary_Warbler,134,69,325,239,229,154,191,170
../../CUB_200_2011/images\177.Prothonotary_Warbler/Prothonotary_Warbler_0021_173816.jpg,500,357,177.Prothonotary_Warbler,184,92,435,255,309,173,251,163
../../CUB_200_2011/images\177.Prothonotary_Warbler/Prothonotary_Warbler_0038_173867.jpg,500,326,177.Prothonotary_Warbler,45,138,349,293,197,215,304,155
../../CUB_200_2011/images\177.Prothonotary_Warbler/Prothonotary_Warbler_0047_174340.jpg,500,386,177.Prothonotary_Warbler,54,80,458,343,256,211,404,263
../../CUB_200_2011/images\177.Prothonotary_Warbler/Prothonotary_Warbler_0085_173829.jpg,500,404,177.Prothonotary_Warbler,82,90,464,373,273,231,382,283
../../CUB_200_2011/images\177.Prothonotary_Warbler/Prothonotary_Warbler_0019_173838.jpg,500,248,177.Prothonotary_Warbler,175,59,459,199,317,129,284,140
../../CUB_200_2011/images\177.Prothonotary_Warbler/Prothonotary_Warbler_0110_173857.jpg,500,332,177.Prothonotary_Warbler,210,89,459,227,334,158,249,138
../../CUB_200_2011/images\177.Prothonotary_Warbler/Prothonotary_Warbler_0096_174372.jpg,500,333,177.Prothonotary_Warbler,247,91,426,231,336,161,179,140
../../CUB_200_2011/images\177.Prothonotary_Warbler/Prothonotary_Warbler_0079_173899.jpg,500,385,177.Prothonotary_Warbler,132,104,333,229,232,166,201,125
../../CUB_200_2011/images\177.Prothonotary_Warbler/Prothonotary_Warbler_0062_174412.jpg,500,333,177.Prothonotary_Warbler,123,126,343,269,233,197,220,143
../../CUB_200_2011/images\177.Prothonotary_Warbler/Prothonotary_Warbler_0098_173913.jpg,400,500,177.Prothonotary_Warbler,63,118,324,272,193,195,261,154
../../CUB_200_2011/images\177.Prothonotary_Warbler/Prothonotary_Warbler_0070_174650.jpg,500,332,177.Prothonotary_Warbler,194,95,305,233,249,164,111,138
../../CUB_200_2011/images\177.Prothonotary_Warbler/Prothonotary_Warbler_0107_173921.jpg,500,333,177.Prothonotary_Warbler,98,79,343,213,220,146,245,134
../../CUB_200_2011/images\177.Prothonotary_Warbler/Prothonotary_Warbler_0083_173929.jpg,500,355,177.Prothonotary_Warbler,132,80,244,252,188,166,112,172
../../CUB_200_2011/images\177.Prothonotary_Warbler/Prothonotary_Warbler_0037_173418.jpg,500,335,177.Prothonotary_Warbler,115,79,342,269,228,174,227,190
../../CUB_200_2011/images\177.Prothonotary_Warbler/Prothonotary_Warbler_0055_173419.jpg,481,500,177.Prothonotary_Warbler,140,119,409,476,274,297,269,357
../../CUB_200_2011/images\177.Prothonotary_Warbler/Prothonotary_Warbler_0065_173422.jpg,411,500,177.Prothonotary_Warbler,77,78,343,459,210,268,266,381
../../CUB_200_2011/images\177.Prothonotary_Warbler/Prothonotary_Warbler_0008_173425.jpg,500,367,177.Prothonotary_Warbler,80,98,300,263,190,180,220,165
../../CUB_200_2011/images\177.Prothonotary_Warbler/Prothonotary_Warbler_0084_173939.jpg,500,400,177.Prothonotary_Warbler,194,143,372,258,283,200,178,115
../../CUB_200_2011/images\177.Prothonotary_Warbler/Prothonotary_Warbler_0059_173434.jpg,500,333,177.Prothonotary_Warbler,165,118,375,258,270,188,210,140
../../CUB_200_2011/images\177.Prothonotary_Warbler/Prothonotary_Warbler_0058_173440.jpg,500,348,177.Prothonotary_Warbler,49,94,450,274,249,184,401,180
../../CUB_200_2011/images\177.Prothonotary_Warbler/Prothonotary_Warbler_0074_173443.jpg,441,500,177.Prothonotary_Warbler,126,29,417,476,271,252,291,447
../../CUB_200_2011/images\177.Prothonotary_Warbler/Prothonotary_Warbler_0116_173444.jpg,500,369,177.Prothonotary_Warbler,37,20,493,354,265,187,456,334
../../CUB_200_2011/images\177.Prothonotary_Warbler/Prothonotary_Warbler_0040_173447.jpg,500,359,177.Prothonotary_Warbler,86,54,280,240,183,147,194,186
../../CUB_200_2011/images\177.Prothonotary_Warbler/Prothonotary_Warbler_0082_173970.jpg,500,375,177.Prothonotary_Warbler,283,76,459,319,371,197,176,243
../../CUB_200_2011/images\177.Prothonotary_Warbler/Prothonotary_Warbler_0004_173475.jpg,500,333,177.Prothonotary_Warbler,60,43,372,306,216,174,312,263
../../CUB_200_2011/images\177.Prothonotary_Warbler/Prothonotary_Warbler_0081_173510.jpg,500,309,177.Prothonotary_Warbler,25,50,399,272,212,161,374,222
../../CUB_200_2011/images\177.Prothonotary_Warbler/Prothonotary_Warbler_0100_174539.jpg,500,360,177.Prothonotary_Warbler,46,23,347,270,196,146,301,247
../../CUB_200_2011/images\177.Prothonotary_Warbler/Prothonotary_Warbler_0097_174554.jpg,500,333,177.Prothonotary_Warbler,149,110,399,280,274,195,250,170
../../CUB_200_2011/images\177.Prothonotary_Warbler/Prothonotary_Warbler_0054_174556.jpg,500,400,177.Prothonotary_Warbler,141,70,462,304,301,187,321,234
../../CUB_200_2011/images\177.Prothonotary_Warbler/Prothonotary_Warbler_0045_173536.jpg,500,393,177.Prothonotary_Warbler,83,134,283,286,183,210,200,152
../../CUB_200_2011/images\177.Prothonotary_Warbler/Prothonotary_Warbler_0031_174578.jpg,500,333,177.Prothonotary_Warbler,183,65,397,278,290,171,214,213
../../CUB_200_2011/images\178.Swainson_Warbler/Swainson_Warbler_0049_794880.jpg,200,133,178.Swainson_Warbler,36,18,173,132,104,75,137,114
../../CUB_200_2011/images\178.Swainson_Warbler/Swainson_Warbler_0025_794881.jpg,500,384,178.Swainson_Warbler,16,23,473,352,244,187,457,329
../../CUB_200_2011/images\178.Swainson_Warbler/Swainson_Warbler_0038_794882.jpg,292,476,178.Swainson_Warbler,36,30,279,402,157,216,243,372
../../CUB_200_2011/images\178.Swainson_Warbler/Swainson_Warbler_0029_794883.jpg,456,372,178.Swainson_Warbler,0,54,424,371,212,212,424,317
../../CUB_200_2011/images\178.Swainson_Warbler/Swainson_Warbler_0010_174724.jpg,500,500,178.Swainson_Warbler,148,166,376,356,262,261,228,190
../../CUB_200_2011/images\178.Swainson_Warbler/Swainson_Warbler_0024_794885.jpg,500,400,178.Swainson_Warbler,167,126,292,254,229,190,125,128
../../CUB_200_2011/images\178.Swainson_Warbler/Swainson_Warbler_0008_794886.jpg,418,500,178.Swainson_Warbler,144,233,265,406,204,319,121,173
../../CUB_200_2011/images\178.Swainson_Warbler/Swainson_Warbler_0048_794887.jpg,333,500,178.Swainson_Warbler,19,77,318,498,168,287,299,421
../../CUB_200_2011/images\178.Swainson_Warbler/Swainson_Warbler_0032_174728.jpg,500,435,178.Swainson_Warbler,130,101,371,335,250,218,241,234
../../CUB_200_2011/images\178.Swainson_Warbler/Swainson_Warbler_0034_794890.jpg,314,325,178.Swainson_Warbler,16,3,311,298,163,150,295,295
../../CUB_200_2011/images\178.Swainson_Warbler/Swainson_Warbler_0015_794891.jpg,500,375,178.Swainson_Warbler,22,18,488,373,255,195,466,355
../../CUB_200_2011/images\178.Swainson_Warbler/Swainson_Warbler_0013_794892.jpg,375,500,178.Swainson_Warbler,15,22,356,491,185,256,341,469
../../CUB_200_2011/images\178.Swainson_Warbler/Swainson_Warbler_0041_794893.jpg,466,307,178.Swainson_Warbler,12,14,436,274,224,144,424,260
../../CUB_200_2011/images\178.Swainson_Warbler/Swainson_Warbler_0044_794894.jpg,500,333,178.Swainson_Warbler,105,70,354,251,229,160,249,181
../../CUB_200_2011/images\178.Swainson_Warbler/Swainson_Warbler_0042_794895.jpg,333,500,178.Swainson_Warbler,40,88,225,353,132,220,185,265
../../CUB_200_2011/images\178.Swainson_Warbler/Swainson_Warbler_0028_794896.jpg,500,333,178.Swainson_Warbler,82,78,358,248,220,163,276,170
../../CUB_200_2011/images\178.Swainson_Warbler/Swainson_Warbler_0021_794898.jpg,500,350,178.Swainson_Warbler,30,41,375,238,202,139,345,197
../../CUB_200_2011/images\178.Swainson_Warbler/Swainson_Warbler_0012_174739.jpg,500,333,178.Swainson_Warbler,101,56,254,302,177,179,153,246
../../CUB_200_2011/images\178.Swainson_Warbler/Swainson_Warbler_0051_794900.jpg,500,385,178.Swainson_Warbler,41,70,434,330,237,200,393,260
../../CUB_200_2011/images\178.Swainson_Warbler/Swainson_Warbler_0035_174741.jpg,500,333,178.Swainson_Warbler,35,124,362,247,198,185,327,123
../../CUB_200_2011/images\178.Swainson_Warbler/Swainson_Warbler_0007_174745.jpg,500,392,178.Swainson_Warbler,183,112,374,311,278,211,191,199
../../CUB_200_2011/images\178.Swainson_Warbler/Swainson_Warbler_0026_794884.jpg,500,362,178.Swainson_Warbler,109,109,457,290,283,199,348,181
../../CUB_200_2011/images\178.Swainson_Warbler/Swainson_Warbler_0009_174746.jpg,500,383,178.Swainson_Warbler,149,121,293,274,221,197,144,153
../../CUB_200_2011/images\178.Swainson_Warbler/Swainson_Warbler_0043_794865.jpg,400,231,178.Swainson_Warbler,51,13,356,185,203,99,305,172
../../CUB_200_2011/images\178.Swainson_Warbler/Swainson_Warbler_0036_174699.jpg,500,333,178.Swainson_Warbler,90,79,286,259,188,169,196,180
../../CUB_200_2011/images\178.Swainson_Warbler/Swainson_Warbler_0005_794888.jpg,500,489,178.Swainson_Warbler,42,109,385,386,213,247,343,277
../../CUB_200_2011/images\178.Swainson_Warbler/Swainson_Warbler_0033_794856.jpg,500,332,178.Swainson_Warbler,202,36,383,247,292,141,181,211
../../CUB_200_2011/images\178.Swainson_Warbler/Swainson_Warbler_0018_174715.jpg,500,386,178.Swainson_Warbler,108,90,337,283,222,186,229,193
../../CUB_200_2011/images\178.Swainson_Warbler/Swainson_Warbler_0053_174678.jpg,404,356,178.Swainson_Warbler,36,84,331,338,183,211,295,254
../../CUB_200_2011/images\178.Swainson_Warbler/Swainson_Warbler_0011_174680.jpg,500,398,178.Swainson_Warbler,254,128,425,281,339,204,171,153
../../CUB_200_2011/images\178.Swainson_Warbler/Swainson_Warbler_0002_174683.jpg,500,474,178.Swainson_Warbler,39,23,478,390,258,206,439,367
../../CUB_200_2011/images\178.Swainson_Warbler/Swainson_Warbler_0017_174685.jpg,500,335,178.Swainson_Warbler,217,114,379,228,298,171,162,114
../../CUB_200_2011/images\178.Swainson_Warbler/Swainson_Warbler_0054_174689.jpg,500,415,178.Swainson_Warbler,172,171,332,271,252,221,160,100
../../CUB_200_2011/images\178.Swainson_Warbler/Swainson_Warbler_0037_174691.jpg,451,500,178.Swainson_Warbler,148,111,426,476,287,293,278,365
../../CUB_200_2011/images\178.Swainson_Warbler/Swainson_Warbler_0019_174692.jpg,500,430,178.Swainson_Warbler,161,114,403,353,282,233,242,239
../../CUB_200_2011/images\178.Swainson_Warbler/Swainson_Warbler_0031_174696.jpg,500,333,178.Swainson_Warbler,165,102,359,230,262,166,194,128
../../CUB_200_2011/images\178.Swainson_Warbler/Swainson_Warbler_0006_794857.jpg,500,333,178.Swainson_Warbler,138,56,386,285,262,170,248,229
../../CUB_200_2011/images\178.Swainson_Warbler/Swainson_Warbler_0014_794858.jpg,345,169,178.Swainson_Warbler,23,13,321,165,172,89,298,152
../../CUB_200_2011/images\178.Swainson_Warbler/Swainson_Warbler_0039_794859.jpg,500,369,178.Swainson_Warbler,26,98,342,328,184,213,316,230
../../CUB_200_2011/images\178.Swainson_Warbler/Swainson_Warbler_0040_794860.jpg,500,379,178.Swainson_Warbler,161,120,406,288,283,204,245,168
../../CUB_200_2011/images\178.Swainson_Warbler/Swainson_Warbler_0050_794861.jpg,400,300,178.Swainson_Warbler,8,81,359,255,183,168,351,174
../../CUB_200_2011/images\178.Swainson_Warbler/Swainson_Warbler_0020_794863.jpg,500,441,178.Swainson_Warbler,161,140,324,363,242,251,163,223
../../CUB_200_2011/images\178.Swainson_Warbler/Swainson_Warbler_0030_794864.jpg,500,421,178.Swainson_Warbler,127,174,337,351,232,262,210,177
../../CUB_200_2011/images\178.Swainson_Warbler/Swainson_Warbler_0016_174705.jpg,500,333,178.Swainson_Warbler,165,14,346,308,255,161,181,294
../../CUB_200_2011/images\178.Swainson_Warbler/Swainson_Warbler_0003_794866.jpg,500,366,178.Swainson_Warbler,217,82,348,244,282,163,131,162
../../CUB_200_2011/images\178.Swainson_Warbler/Swainson_Warbler_0055_794899.jpg,365,500,178.Swainson_Warbler,24,85,293,394,158,239,269,309
../../CUB_200_2011/images\178.Swainson_Warbler/Swainson_Warbler_0022_794868.jpg,500,333,178.Swainson_Warbler,105,57,433,321,269,189,328,264
../../CUB_200_2011/images\178.Swainson_Warbler/Swainson_Warbler_0001_794869.jpg,500,333,178.Swainson_Warbler,81,75,341,265,211,170,260,190
../../CUB_200_2011/images\178.Swainson_Warbler/Swainson_Warbler_0047_794870.jpg,500,333,178.Swainson_Warbler,35,85,326,280,180,182,291,195
../../CUB_200_2011/images\178.Swainson_Warbler/Swainson_Warbler_0056_794871.jpg,357,500,178.Swainson_Warbler,118,133,310,405,214,269,192,272
../../CUB_200_2011/images\178.Swainson_Warbler/Swainson_Warbler_0046_794872.jpg,350,237,178.Swainson_Warbler,20,25,332,209,176,117,312,184
../../CUB_200_2011/images\178.Swainson_Warbler/Swainson_Warbler_0004_794874.jpg,400,300,178.Swainson_Warbler,75,60,360,267,217,163,285,207
../../CUB_200_2011/images\178.Swainson_Warbler/Swainson_Warbler_0052_794875.jpg,333,500,178.Swainson_Warbler,99,128,261,354,180,241,162,226
../../CUB_200_2011/images\178.Swainson_Warbler/Swainson_Warbler_0045_794876.jpg,500,375,178.Swainson_Warbler,2,90,422,371,212,230,420,281
../../CUB_200_2011/images\178.Swainson_Warbler/Swainson_Warbler_0027_794877.jpg,400,300,178.Swainson_Warbler,40,10,356,290,198,150,316,280
../../CUB_200_2011/images\178.Swainson_Warbler/Swainson_Warbler_0023_174717.jpg,500,399,178.Swainson_Warbler,100,104,277,317,188,210,177,213
../../CUB_200_2011/images\179.Tennessee_Warbler/Tennessee_Warbler_0074_175058.jpg,500,375,179.Tennessee_Warbler,136,110,383,260,259,185,247,150
../../CUB_200_2011/images\179.Tennessee_Warbler/Tennessee_Warbler_0050_174851.jpg,500,332,179.Tennessee_Warbler,265,144,378,276,321,210,113,132
../../CUB_200_2011/images\179.Tennessee_Warbler/Tennessee_Warbler_0034_174854.jpg,342,500,179.Tennessee_Warbler,59,127,304,405,181,266,245,278
../../CUB_200_2011/images\179.Tennessee_Warbler/Tennessee_Warbler_0026_175118.jpg,500,333,179.Tennessee_Warbler,190,51,321,278,255,164,131,227
../../CUB_200_2011/images\179.Tennessee_Warbler/Tennessee_Warbler_0014_175126.jpg,500,375,179.Tennessee_Warbler,82,102,384,254,233,178,302,152
../../CUB_200_2011/images\179.Tennessee_Warbler/Tennessee_Warbler_0039_174883.jpg,500,338,179.Tennessee_Warbler,107,90,294,227,200,158,187,137
../../CUB_200_2011/images\179.Tennessee_Warbler/Tennessee_Warbler_0002_174884.jpg,500,355,179.Tennessee_Warbler,41,38,358,345,199,191,317,307
../../CUB_200_2011/images\179.Tennessee_Warbler/Tennessee_Warbler_0084_174891.jpg,500,370,179.Tennessee_Warbler,138,139,378,270,258,204,240,131
../../CUB_200_2011/images\179.Tennessee_Warbler/Tennessee_Warbler_0030_172338.jpg,400,500,179.Tennessee_Warbler,151,118,268,407,209,262,117,289
../../CUB_200_2011/images\179.Tennessee_Warbler/Tennessee_Warbler_0003_175154.jpg,361,500,179.Tennessee_Warbler,178,148,327,412,252,280,149,264
../../CUB_200_2011/images\179.Tennessee_Warbler/Tennessee_Warbler_0041_174900.jpg,500,401,179.Tennessee_Warbler,169,123,392,259,280,191,223,136
../../CUB_200_2011/images\179.Tennessee_Warbler/Tennessee_Warbler_0095_174903.jpg,500,333,179.Tennessee_Warbler,32,94,303,270,167,182,271,176
../../CUB_200_2011/images\179.Tennessee_Warbler/Tennessee_Warbler_0088_175163.jpg,500,401,179.Tennessee_Warbler,172,146,291,277,231,211,119,131
../../CUB_200_2011/images\179.Tennessee_Warbler/Tennessee_Warbler_0100_175168.jpg,322,403,179.Tennessee_Warbler,26,67,312,223,169,145,286,156
../../CUB_200_2011/images\179.Tennessee_Warbler/Tennessee_Warbler_0045_174913.jpg,500,353,179.Tennessee_Warbler,143,101,376,319,259,210,233,218
../../CUB_200_2011/images\179.Tennessee_Warbler/Tennessee_Warbler_0054_174914.jpg,500,357,179.Tennessee_Warbler,94,138,368,264,231,201,274,126
../../CUB_200_2011/images\179.Tennessee_Warbler/Tennessee_Warbler_0040_174933.jpg,375,500,179.Tennessee_Warbler,120,226,337,341,228,283,217,115
../../CUB_200_2011/images\179.Tennessee_Warbler/Tennessee_Warbler_0009_174937.jpg,500,400,179.Tennessee_Warbler,191,154,480,335,335,244,289,181
../../CUB_200_2011/images\179.Tennessee_Warbler/Tennessee_Warbler_0062_174949.jpg,500,373,179.Tennessee_Warbler,52,102,295,217,173,159,243,115
../../CUB_200_2011/images\179.Tennessee_Warbler/Tennessee_Warbler_0063_168561.jpg,442,291,179.Tennessee_Warbler,102,43,411,219,256,131,309,176
../../CUB_200_2011/images\179.Tennessee_Warbler/Tennessee_Warbler_0085_156530.jpg,500,424,179.Tennessee_Warbler,97,110,351,257,224,183,254,147
../../CUB_200_2011/images\179.Tennessee_Warbler/Tennessee_Warbler_0087_174968.jpg,500,334,179.Tennessee_Warbler,136,130,333,240,234,185,197,110
../../CUB_200_2011/images\179.Tennessee_Warbler/Tennessee_Warbler_0025_174973.jpg,500,335,179.Tennessee_Warbler,85,103,363,334,224,218,278,231
../../CUB_200_2011/images\179.Tennessee_Warbler/Tennessee_Warbler_0023_174977.jpg,500,333,179.Tennessee_Warbler,153,68,415,285,284,176,262,217
../../CUB_200_2011/images\179.Tennessee_Warbler/Tennessee_Warbler_0024_174980.jpg,361,500,179.Tennessee_Warbler,161,120,343,295,252,207,182,175
../../CUB_200_2011/images\179.Tennessee_Warbler/Tennessee_Warbler_0071_175084.jpg,500,325,179.Tennessee_Warbler,150,81,401,247,275,164,251,166
../../CUB_200_2011/images\179.Tennessee_Warbler/Tennessee_Warbler_0096_174993.jpg,500,409,179.Tennessee_Warbler,157,113,327,302,242,207,170,189
../../CUB_200_2011/images\179.Tennessee_Warbler/Tennessee_Warbler_0004_174997.jpg,360,240,179.Tennessee_Warbler,40,5,345,239,192,122,305,234
../../CUB_200_2011/images\179.Tennessee_Warbler/Tennessee_Warbler_0067_174999.jpg,472,500,179.Tennessee_Warbler,122,127,377,344,249,235,255,217
../../CUB_200_2011/images\179.Tennessee_Warbler/Tennessee_Warbler_0043_175003.jpg,500,361,179.Tennessee_Warbler,33,108,348,242,190,175,315,134
../../CUB_200_2011/images\179.Tennessee_Warbler/Tennessee_Warbler_0049_175006.jpg,500,335,179.Tennessee_Warbler,182,76,367,241,274,158,185,165
../../CUB_200_2011/images\179.Tennessee_Warbler/Tennessee_Warbler_0065_174757.jpg,500,333,179.Tennessee_Warbler,128,99,443,287,285,193,315,188
../../CUB_200_2011/images\179.Tennessee_Warbler/Tennessee_Warbler_0051_175015.jpg,500,315,179.Tennessee_Warbler,39,59,472,278,255,168,433,219
../../CUB_200_2011/images\179.Tennessee_Warbler/Tennessee_Warbler_0038_174760.jpg,500,375,179.Tennessee_Warbler,162,84,426,241,294,162,264,157
../../CUB_200_2011/images\179.Tennessee_Warbler/Tennessee_Warbler_0021_174761.jpg,500,443,179.Tennessee_Warbler,169,95,345,378,257,236,176,283
../../CUB_200_2011/images\179.Tennessee_Warbler/Tennessee_Warbler_0075_174763.jpg,500,406,179.Tennessee_Warbler,39,149,394,358,216,253,355,209
../../CUB_200_2011/images\179.Tennessee_Warbler/Tennessee_Warbler_0089_174764.jpg,500,326,179.Tennessee_Warbler,264,46,454,177,359,111,190,131
../../CUB_200_2011/images\179.Tennessee_Warbler/Tennessee_Warbler_0070_174962.jpg,500,270,179.Tennessee_Warbler,100,31,420,214,260,122,320,183
../../CUB_200_2011/images\179.Tennessee_Warbler/Tennessee_Warbler_0081_174771.jpg,500,332,179.Tennessee_Warbler,46,88,309,302,177,195,263,214
../../CUB_200_2011/images\179.Tennessee_Warbler/Tennessee_Warbler_0033_174772.jpg,500,379,179.Tennessee_Warbler,104,105,349,263,226,184,245,158
../../CUB_200_2011/images\179.Tennessee_Warbler/Tennessee_Warbler_0061_174775.jpg,333,500,179.Tennessee_Warbler,61,144,300,347,180,245,239,203
../../CUB_200_2011/images\179.Tennessee_Warbler/Tennessee_Warbler_0042_175092.jpg,500,375,179.Tennessee_Warbler,179,84,355,240,267,162,176,156
../../CUB_200_2011/images\179.Tennessee_Warbler/Tennessee_Warbler_0019_174786.jpg,500,360,179.Tennessee_Warbler,148,99,491,280,319,189,343,181
../../CUB_200_2011/images\179.Tennessee_Warbler/Tennessee_Warbler_0091_175050.jpg,500,333,179.Tennessee_Warbler,150,93,391,282,270,187,241,189
../../CUB_200_2011/images\179.Tennessee_Warbler/Tennessee_Warbler_0007_174796.jpg,466,500,179.Tennessee_Warbler,65,46,355,331,210,188,290,285
../../CUB_200_2011/images\179.Tennessee_Warbler/Tennessee_Warbler_0080_167714.jpg,500,324,179.Tennessee_Warbler,82,118,291,234,186,176,209,116
../../CUB_200_2011/images\179.Tennessee_Warbler/Tennessee_Warbler_0046_174798.jpg,500,395,179.Tennessee_Warbler,54,40,443,323,248,181,389,283
../../CUB_200_2011/images\179.Tennessee_Warbler/Tennessee_Warbler_0022_174799.jpg,500,333,179.Tennessee_Warbler,78,119,324,272,201,195,246,153
../../CUB_200_2011/images\179.Tennessee_Warbler/Tennessee_Warbler_0098_174800.jpg,500,375,179.Tennessee_Warbler,37,59,397,340,217,199,360,281
../../CUB_200_2011/images\179.Tennessee_Warbler/Tennessee_Warbler_0031_174802.jpg,500,449,179.Tennessee_Warbler,137,124,477,369,307,246,340,245
../../CUB_200_2011/images\179.Tennessee_Warbler/Tennessee_Warbler_0027_174805.jpg,387,500,179.Tennessee_Warbler,86,186,263,382,174,284,177,196
../../CUB_200_2011/images\179.Tennessee_Warbler/Tennessee_Warbler_0076_174807.jpg,500,357,179.Tennessee_Warbler,50,54,220,177,135,115,170,123
../../CUB_200_2011/images\179.Tennessee_Warbler/Tennessee_Warbler_0092_174810.jpg,500,333,179.Tennessee_Warbler,202,51,397,267,299,159,195,216
../../CUB_200_2011/images\179.Tennessee_Warbler/Tennessee_Warbler_0013_163552.jpg,500,375,179.Tennessee_Warbler,75,108,305,241,190,174,230,133
../../CUB_200_2011/images\179.Tennessee_Warbler/Tennessee_Warbler_0048_175079.jpg,500,332,179.Tennessee_Warbler,138,106,296,222,217,164,158,116
../../CUB_200_2011/images\179.Tennessee_Warbler/Tennessee_Warbler_0044_174824.jpg,333,500,179.Tennessee_Warbler,42,139,282,322,162,230,240,183
../../CUB_200_2011/images\179.Tennessee_Warbler/Tennessee_Warbler_0052_175089.jpg,500,375,179.Tennessee_Warbler,199,169,390,287,294,228,191,118
../../CUB_200_2011/images\179.Tennessee_Warbler/Tennessee_Warbler_0060_174840.jpg,500,333,179.Tennessee_Warbler,112,107,302,258,207,182,190,151
../../CUB_200_2011/images\179.Tennessee_Warbler/Tennessee_Warbler_0015_174847.jpg,500,329,179.Tennessee_Warbler,129,93,362,259,245,176,233,166
../../CUB_200_2011/images\180.Wilson_Warbler/Wilson_Warbler_0007_175618.jpg,500,322,180.Wilson_Warbler,141,106,324,231,232,168,183,125
../../CUB_200_2011/images\180.Wilson_Warbler/Wilson_Warbler_0089_175619.jpg,500,345,180.Wilson_Warbler,61,73,495,289,278,181,434,216
../../CUB_200_2011/images\180.Wilson_Warbler/Wilson_Warbler_0045_175623.jpg,500,354,180.Wilson_Warbler,138,104,293,275,215,189,155,171
../../CUB_200_2011/images\180.Wilson_Warbler/Wilson_Warbler_0133_175626.jpg,500,490,180.Wilson_Warbler,146,149,422,330,284,239,276,181
../../CUB_200_2011/images\180.Wilson_Warbler/Wilson_Warbler_0127_175637.jpg,500,333,180.Wilson_Warbler,164,73,388,250,276,161,224,177
../../CUB_200_2011/images\180.Wilson_Warbler/Wilson_Warbler_0074_175645.jpg,333,500,180.Wilson_Warbler,54,73,263,245,158,159,209,172
../../CUB_200_2011/images\180.Wilson_Warbler/Wilson_Warbler_0066_117820.jpg,500,356,180.Wilson_Warbler,134,81,345,231,239,156,211,150
../../CUB_200_2011/images\180.Wilson_Warbler/Wilson_Warbler_0070_175169.jpg,451,500,180.Wilson_Warbler,142,85,356,380,249,232,214,295
../../CUB_200_2011/images\180.Wilson_Warbler/Wilson_Warbler_0019_175175.jpg,500,336,180.Wilson_Warbler,152,58,436,247,294,152,284,189
../../CUB_200_2011/images\180.Wilson_Warbler/Wilson_Warbler_0108_175179.jpg,500,434,180.Wilson_Warbler,63,69,412,384,237,226,349,315
../../CUB_200_2011/images\180.Wilson_Warbler/Wilson_Warbler_0069_175181.jpg,500,498,180.Wilson_Warbler,99,121,465,363,282,242,366,242
../../CUB_200_2011/images\180.Wilson_Warbler/Wilson_Warbler_0055_175183.jpg,500,351,180.Wilson_Warbler,182,87,385,243,283,165,203,156
../../CUB_200_2011/images\180.Wilson_Warbler/Wilson_Warbler_0136_175186.jpg,500,381,180.Wilson_Warbler,35,152,222,322,128,237,187,170
../../CUB_200_2011/images\180.Wilson_Warbler/Wilson_Warbler_0100_175726.jpg,334,500,180.Wilson_Warbler,61,76,305,401,183,238,244,325
../../CUB_200_2011/images\180.Wilson_Warbler/Wilson_Warbler_0075_175234.jpg,500,400,180.Wilson_Warbler,38,63,496,373,267,218,458,310
../../CUB_200_2011/images\180.Wilson_Warbler/Wilson_Warbler_0010_175750.jpg,500,431,180.Wilson_Warbler,57,146,352,334,204,240,295,188
../../CUB_200_2011/images\180.Wilson_Warbler/Wilson_Warbler_0059_175249.jpg,500,385,180.Wilson_Warbler,49,60,425,300,237,180,376,240
../../CUB_200_2011/images\180.Wilson_Warbler/Wilson_Warbler_0083_175253.jpg,500,362,180.Wilson_Warbler,115,98,457,300,286,199,342,202
../../CUB_200_2011/images\180.Wilson_Warbler/Wilson_Warbler_0129_175256.jpg,500,353,180.Wilson_Warbler,75,85,301,241,188,163,226,156
../../CUB_200_2011/images\180.Wilson_Warbler/Wilson_Warbler_0102_175769.jpg,500,334,180.Wilson_Warbler,75,85,445,322,260,203,370,237
../../CUB_200_2011/images\180.Wilson_Warbler/Wilson_Warbler_0080_175770.jpg,500,375,180.Wilson_Warbler,111,94,427,315,269,204,316,221
../../CUB_200_2011/images\180.Wilson_Warbler/Wilson_Warbler_0033_175259.jpg,500,333,180.Wilson_Warbler,273,104,395,254,334,179,122,150
../../CUB_200_2011/images\180.Wilson_Warbler/Wilson_Warbler_0067_175261.jpg,500,375,180.Wilson_Warbler,37,91,424,303,230,197,387,212
../../CUB_200_2011/images\180.Wilson_Warbler/Wilson_Warbler_0117_175262.jpg,500,400,180.Wilson_Warbler,47,125,220,318,133,221,173,193
../../CUB_200_2011/images\180.Wilson_Warbler/Wilson_Warbler_0118_175779.jpg,500,419,180.Wilson_Warbler,38,73,390,372,214,222,352,299
../../CUB_200_2011/images\180.Wilson_Warbler/Wilson_Warbler_0131_175268.jpg,500,400,180.Wilson_Warbler,71,100,272,286,171,193,201,186
../../CUB_200_2011/images\180.Wilson_Warbler/Wilson_Warbler_0056_175269.jpg,500,381,180.Wilson_Warbler,118,87,484,337,301,212,366,250
../../CUB_200_2011/images\180.Wilson_Warbler/Wilson_Warbler_0024_175278.jpg,500,333,180.Wilson_Warbler,178,54,337,285,257,169,159,231
../../CUB_200_2011/images\180.Wilson_Warbler/Wilson_Warbler_0054_175285.jpg,500,375,180.Wilson_Warbler,65,87,386,322,225,204,321,235
../../CUB_200_2011/images\180.Wilson_Warbler/Wilson_Warbler_0027_175290.jpg,333,500,180.Wilson_Warbler,100,238,290,415,195,326,190,177
../../CUB_200_2011/images\180.Wilson_Warbler/Wilson_Warbler_0114_175295.jpg,500,322,180.Wilson_Warbler,195,71,320,241,257,156,125,170
../../CUB_200_2011/images\180.Wilson_Warbler/Wilson_Warbler_0047_175304.jpg,500,332,180.Wilson_Warbler,103,72,260,314,181,193,157,242
../../CUB_200_2011/images\180.Wilson_Warbler/Wilson_Warbler_0107_175320.jpg,500,334,180.Wilson_Warbler,111,82,286,239,198,160,175,157
../../CUB_200_2011/images\180.Wilson_Warbler/Wilson_Warbler_0012_175328.jpg,500,334,180.Wilson_Warbler,70,73,321,272,195,172,251,199
../../CUB_200_2011/images\180.Wilson_Warbler/Wilson_Warbler_0040_175347.jpg,400,500,180.Wilson_Warbler,148,126,261,320,204,223,113,194
../../CUB_200_2011/images\180.Wilson_Warbler/Wilson_Warbler_0064_175361.jpg,500,334,180.Wilson_Warbler,47,17,463,333,255,175,416,316
../../CUB_200_2011/images\180.Wilson_Warbler/Wilson_Warbler_0073_175876.jpg,500,400,180.Wilson_Warbler,272,204,445,357,358,280,173,153
../../CUB_200_2011/images\180.Wilson_Warbler/Wilson_Warbler_0126_175368.jpg,500,500,180.Wilson_Warbler,5,144,416,445,210,294,411,301
../../CUB_200_2011/images\180.Wilson_Warbler/Wilson_Warbler_0134_175374.jpg,500,333,180.Wilson_Warbler,143,68,401,248,272,158,258,180
../../CUB_200_2011/images\180.Wilson_Warbler/Wilson_Warbler_0018_175389.jpg,500,333,180.Wilson_Warbler,210,86,471,225,340,155,261,139
../../CUB_200_2011/images\180.Wilson_Warbler/Wilson_Warbler_0065_175924.jpg,500,333,180.Wilson_Warbler,154,108,284,263,219,185,130,155
../../CUB_200_2011/images\180.Wilson_Warbler/Wilson_Warbler_0029_175417.jpg,500,375,180.Wilson_Warbler,54,104,364,314,209,209,310,210
../../CUB_200_2011/images\180.Wilson_Warbler/Wilson_Warbler_0060_175420.jpg,500,359,180.Wilson_Warbler,48,81,451,315,249,198,403,234
../../CUB_200_2011/images\180.Wilson_Warbler/Wilson_Warbler_0122_175937.jpg,500,307,180.Wilson_Warbler,223,71,457,292,340,181,234,221
../../CUB_200_2011/images\180.Wilson_Warbler/Wilson_Warbler_0034_175443.jpg,500,400,180.Wilson_Warbler,247,130,462,298,354,214,215,168
../../CUB_200_2011/images\180.Wilson_Warbler/Wilson_Warbler_0072_175958.jpg,500,500,180.Wilson_Warbler,114,155,321,351,217,253,207,196
../../CUB_200_2011/images\180.Wilson_Warbler/Wilson_Warbler_0038_175449.jpg,500,367,180.Wilson_Warbler,35,84,388,317,211,200,353,233
../../CUB_200_2011/images\180.Wilson_Warbler/Wilson_Warbler_0041_175464.jpg,500,357,180.Wilson_Warbler,27,79,348,266,187,172,321,187
../../CUB_200_2011/images\180.Wilson_Warbler/Wilson_Warbler_0092_175676.jpg,500,346,180.Wilson_Warbler,70,111,314,266,192,188,244,155
../../CUB_200_2011/images\180.Wilson_Warbler/Wilson_Warbler_0043_175491.jpg,500,324,180.Wilson_Warbler,158,91,305,244,231,167,147,153
../../CUB_200_2011/images\180.Wilson_Warbler/Wilson_Warbler_0020_175505.jpg,500,399,180.Wilson_Warbler,139,146,285,332,212,239,146,186
../../CUB_200_2011/images\180.Wilson_Warbler/Wilson_Warbler_0016_175532.jpg,500,336,180.Wilson_Warbler,189,56,436,286,312,171,247,230
../../CUB_200_2011/images\180.Wilson_Warbler/Wilson_Warbler_0025_175859.jpg,500,399,180.Wilson_Warbler,144,114,393,301,268,207,249,187
../../CUB_200_2011/images\180.Wilson_Warbler/Wilson_Warbler_0099_175559.jpg,500,332,180.Wilson_Warbler,123,137,326,237,224,187,203,100
../../CUB_200_2011/images\180.Wilson_Warbler/Wilson_Warbler_0002_175571.jpg,500,333,180.Wilson_Warbler,170,81,399,253,284,167,229,172
../../CUB_200_2011/images\180.Wilson_Warbler/Wilson_Warbler_0050_175573.jpg,500,334,180.Wilson_Warbler,78,83,417,262,247,172,339,179
../../CUB_200_2011/images\180.Wilson_Warbler/Wilson_Warbler_0076_175780.jpg,500,376,180.Wilson_Warbler,121,132,439,291,280,211,318,159
../../CUB_200_2011/images\180.Wilson_Warbler/Wilson_Warbler_0109_175578.jpg,500,334,180.Wilson_Warbler,46,88,383,333,214,210,337,245
../../CUB_200_2011/images\180.Wilson_Warbler/Wilson_Warbler_0095_175595.jpg,500,393,180.Wilson_Warbler,61,89,332,330,196,209,271,241
../../CUB_200_2011/images\180.Wilson_Warbler/Wilson_Warbler_0132_175600.jpg,500,445,180.Wilson_Warbler,105,91,330,405,217,248,225,314
../../CUB_200_2011/images\181.Worm_eating_Warbler/Worm_Eating_Warbler_0054_176130.jpg,500,365,181.Worm_eating_Warbler,174,108,452,272,313,190,278,164
../../CUB_200_2011/images\181.Worm_eating_Warbler/Worm_Eating_Warbler_0075_176045.jpg,500,376,181.Worm_eating_Warbler,74,106,376,295,225,200,302,189
../../CUB_200_2011/images\181.Worm_eating_Warbler/Worm_Eating_Warbler_0082_176144.jpg,500,375,181.Worm_eating_Warbler,121,71,417,317,269,194,296,246
../../CUB_200_2011/images\181.Worm_eating_Warbler/Worm_Eating_Warbler_0050_176150.jpg,500,483,181.Worm_eating_Warbler,19,53,427,396,223,224,408,343
../../CUB_200_2011/images\181.Worm_eating_Warbler/Worm_Eating_Warbler_0057_176006.jpg,500,333,181.Worm_eating_Warbler,73,57,359,237,216,147,286,180
../../CUB_200_2011/images\181.Worm_eating_Warbler/Worm_Eating_Warbler_0066_92460.jpg,500,333,181.Worm_eating_Warbler,183,81,422,255,302,168,239,174
../../CUB_200_2011/images\181.Worm_eating_Warbler/Worm_Eating_Warbler_0097_176010.jpg,500,333,181.Worm_eating_Warbler,132,88,482,289,307,188,350,201
../../CUB_200_2011/images\181.Worm_eating_Warbler/Worm_Eating_Warbler_0046_176053.jpg,500,333,181.Worm_eating_Warbler,121,111,424,252,272,181,303,141
../../CUB_200_2011/images\181.Worm_eating_Warbler/Worm_Eating_Warbler_0069_176055.jpg,500,386,181.Worm_eating_Warbler,190,64,325,295,257,179,135,231
../../CUB_200_2011/images\181.Worm_eating_Warbler/Worm_Eating_Warbler_0022_176111.jpg,397,285,181.Worm_eating_Warbler,110,59,330,215,220,137,220,156
../../CUB_200_2011/images\181.Worm_eating_Warbler/Worm_Eating_Warbler_0060_175969.jpg,443,500,181.Worm_eating_Warbler,58,175,294,415,176,295,236,240
../../CUB_200_2011/images\181.Worm_eating_Warbler/Worm_Eating_Warbler_0081_175971.jpg,500,388,181.Worm_eating_Warbler,20,12,419,331,219,171,399,319
../../CUB_200_2011/images\181.Worm_eating_Warbler/Worm_Eating_Warbler_0005_175977.jpg,500,357,181.Worm_eating_Warbler,161,87,466,273,313,180,305,186
../../CUB_200_2011/images\181.Worm_eating_Warbler/Worm_Eating_Warbler_0087_175978.jpg,500,389,181.Worm_eating_Warbler,132,95,477,325,304,210,345,230
../../CUB_200_2011/images\181.Worm_eating_Warbler/Worm_Eating_Warbler_0012_795515.jpg,261,253,181.Worm_eating_Warbler,10,13,238,246,124,129,228,233
../../CUB_200_2011/images\181.Worm_eating_Warbler/Worm_Eating_Warbler_0045_795518.jpg,500,393,181.Worm_eating_Warbler,89,85,478,293,283,189,389,208
../../CUB_200_2011/images\181.Worm_eating_Warbler/Worm_Eating_Warbler_0067_795520.jpg,500,394,181.Worm_eating_Warbler,47,114,366,315,206,214,319,201
../../CUB_200_2011/images\181.Worm_eating_Warbler/Worm_Eating_Warbler_0094_795522.jpg,500,333,181.Worm_eating_Warbler,29,92,346,268,187,180,317,176
../../CUB_200_2011/images\181.Worm_eating_Warbler/Worm_Eating_Warbler_0090_795523.jpg,320,500,181.Worm_eating_Warbler,64,12,305,411,184,211,241,399
../../CUB_200_2011/images\181.Worm_eating_Warbler/Worm_Eating_Warbler_0092_795524.jpg,400,320,181.Worm_eating_Warbler,27,21,343,275,185,148,316,254
../../CUB_200_2011/images\181.Worm_eating_Warbler/Worm_Eating_Warbler_0016_795528.jpg,500,334,181.Worm_eating_Warbler,230,123,467,270,348,196,237,147
../../CUB_200_2011/images\181.Worm_eating_Warbler/Worm_Eating_Warbler_0078_795532.jpg,500,272,181.Worm_eating_Warbler,35,32,483,234,259,133,448,202
../../CUB_200_2011/images\181.Worm_eating_Warbler/Worm_Eating_Warbler_0002_795533.jpg,400,301,181.Worm_eating_Warbler,161,79,324,266,242,172,163,187
../../CUB_200_2011/images\181.Worm_eating_Warbler/Worm_Eating_Warbler_0013_795534.jpg,500,333,181.Worm_eating_Warbler,177,103,411,263,294,183,234,160
../../CUB_200_2011/images\181.Worm_eating_Warbler/Worm_Eating_Warbler_0061_795537.jpg,500,312,181.Worm_eating_Warbler,108,87,442,241,275,164,334,154
../../CUB_200_2011/images\181.Worm_eating_Warbler/Worm_Eating_Warbler_0085_795540.jpg,300,201,181.Worm_eating_Warbler,24,18,225,163,124,90,201,145
../../CUB_200_2011/images\181.Worm_eating_Warbler/Worm_Eating_Warbler_0021_795545.jpg,500,334,181.Worm_eating_Warbler,123,79,488,293,305,186,365,214
../../CUB_200_2011/images\181.Worm_eating_Warbler/Worm_Eating_Warbler_0018_795546.jpg,500,371,181.Worm_eating_Warbler,100,116,486,359,293,237,386,243
../../CUB_200_2011/images\181.Worm_eating_Warbler/Worm_Eating_Warbler_0056_795547.jpg,500,300,181.Worm_eating_Warbler,43,5,377,240,210,122,334,235
../../CUB_200_2011/images\181.Worm_eating_Warbler/Worm_Eating_Warbler_0004_795550.jpg,350,250,181.Worm_eating_Warbler,97,35,328,203,212,119,231,168
../../CUB_200_2011/images\181.Worm_eating_Warbler/Worm_Eating_Warbler_0065_795551.jpg,250,295,181.Worm_eating_Warbler,17,9,223,242,120,125,206,233
../../CUB_200_2011/images\181.Worm_eating_Warbler/Worm_Eating_Warbler_0063_795553.jpg,500,359,181.Worm_eating_Warbler,7,45,471,349,239,197,464,304
../../CUB_200_2011/images\181.Worm_eating_Warbler/Worm_Eating_Warbler_0019_795554.jpg,248,231,181.Worm_eating_Warbler,41,39,224,193,132,116,183,154
../../CUB_200_2011/images\181.Worm_eating_Warbler/Worm_Eating_Warbler_0055_795555.jpg,500,353,181.Worm_eating_Warbler,67,132,234,252,150,192,167,120
../../CUB_200_2011/images\181.Worm_eating_Warbler/Worm_Eating_Warbler_0079_176036.jpg,500,397,181.Worm_eating_Warbler,94,72,342,328,218,200,248,256
../../CUB_200_2011/images\181.Worm_eating_Warbler/Worm_Eating_Warbler_0006_176037.jpg,500,386,181.Worm_eating_Warbler,18,84,398,297,208,190,380,213
../../CUB_200_2011/images\181.Worm_eating_Warbler/Worm_Eating_Warbler_0072_795559.jpg,500,387,181.Worm_eating_Warbler,84,131,350,293,217,212,266,162
../../CUB_200_2011/images\181.Worm_eating_Warbler/Worm_Eating_Warbler_0034_795560.jpg,500,400,181.Worm_eating_Warbler,34,129,465,307,249,218,431,178
../../CUB_200_2011/images\181.Worm_eating_Warbler/Worm_Eating_Warbler_0014_176042.jpg,500,400,181.Worm_eating_Warbler,128,131,470,298,299,214,342,167
../../CUB_200_2011/images\181.Worm_eating_Warbler/Worm_Eating_Warbler_0098_795565.jpg,500,355,181.Worm_eating_Warbler,35,107,368,307,201,207,333,200
../../CUB_200_2011/images\181.Worm_eating_Warbler/Worm_Eating_Warbler_0011_795566.jpg,500,354,181.Worm_eating_Warbler,85,52,315,320,200,186,230,268
../../CUB_200_2011/images\181.Worm_eating_Warbler/Worm_Eating_Warbler_0062_795568.jpg,320,214,181.Worm_eating_Warbler,74,51,261,188,167,119,187,137
../../CUB_200_2011/images\181.Worm_eating_Warbler/Worm_Eating_Warbler_0015_795570.jpg,500,375,181.Worm_eating_Warbler,162,96,326,264,244,180,164,168
../../CUB_200_2011/images\181.Worm_eating_Warbler/Worm_Eating_Warbler_0042_795571.jpg,500,346,181.Worm_eating_Warbler,119,104,479,299,299,201,360,195
../../CUB_200_2011/images\181.Worm_eating_Warbler/Worm_Eating_Warbler_0036_795573.jpg,230,171,181.Worm_eating_Warbler,27,46,221,148,124,97,194,102
../../CUB_200_2011/images\181.Worm_eating_Warbler/Worm_Eating_Warbler_0035_795575.jpg,500,332,181.Worm_eating_Warbler,169,115,433,222,301,168,264,107
../../CUB_200_2011/images\181.Worm_eating_Warbler/Worm_Eating_Warbler_0027_176062.jpg,500,265,181.Worm_eating_Warbler,119,46,405,205,262,125,286,159
../../CUB_200_2011/images\181.Worm_eating_Warbler/Worm_Eating_Warbler_0051_176068.jpg,500,295,181.Worm_eating_Warbler,51,72,291,196,171,134,240,124
../../CUB_200_2011/images\181.Worm_eating_Warbler/Worm_Eating_Warbler_0102_176069.jpg,500,330,181.Worm_eating_Warbler,112,53,335,295,223,174,223,242
../../CUB_200_2011/images\181.Worm_eating_Warbler/Worm_Eating_Warbler_0086_176073.jpg,500,357,181.Worm_eating_Warbler,34,78,390,306,212,192,356,228
../../CUB_200_2011/images\181.Worm_eating_Warbler/Worm_Eating_Warbler_0031_176075.jpg,500,500,181.Worm_eating_Warbler,127,148,410,337,268,242,283,189
../../CUB_200_2011/images\181.Worm_eating_Warbler/Worm_Eating_Warbler_0053_176079.jpg,500,333,181.Worm_eating_Warbler,21,94,365,284,193,189,344,190
../../CUB_200_2011/images\181.Worm_eating_Warbler/Worm_Eating_Warbler_0076_176086.jpg,500,340,181.Worm_eating_Warbler,117,126,301,248,209,187,184,122
../../CUB_200_2011/images\181.Worm_eating_Warbler/Worm_Eating_Warbler_0074_176093.jpg,500,406,181.Worm_eating_Warbler,47,147,279,293,163,220,232,146
../../CUB_200_2011/images\181.Worm_eating_Warbler/Worm_Eating_Warbler_0101_795557.jpg,500,333,181.Worm_eating_Warbler,174,14,470,224,322,119,296,210
../../CUB_200_2011/images\181.Worm_eating_Warbler/Worm_Eating_Warbler_0026_176096.jpg,500,333,181.Worm_eating_Warbler,21,74,371,298,196,186,350,224
../../CUB_200_2011/images\181.Worm_eating_Warbler/Worm_Eating_Warbler_0023_176118.jpg,500,333,181.Worm_eating_Warbler,108,63,384,250,246,156,276,187
../../CUB_200_2011/images\181.Worm_eating_Warbler/Worm_Eating_Warbler_0049_795561.jpg,140,170,181.Worm_eating_Warbler,15,33,139,145,77,89,124,112
../../CUB_200_2011/images\181.Worm_eating_Warbler/Worm_Eating_Warbler_0039_176120.jpg,500,333,181.Worm_eating_Warbler,29,111,315,284,172,197,286,173
../../CUB_200_2011/images\182.Yellow_Warbler/Yellow_Warbler_0038_176388.jpg,500,358,182.Yellow_Warbler,169,104,444,273,306,188,275,169
../../CUB_200_2011/images\182.Yellow_Warbler/Yellow_Warbler_0028_176391.jpg,500,375,182.Yellow_Warbler,118,68,391,300,254,184,273,232
../../CUB_200_2011/images\182.Yellow_Warbler/Yellow_Warbler_0071_176655.jpg,500,331,182.Yellow_Warbler,92,96,364,279,228,187,272,183
../../CUB_200_2011/images\182.Yellow_Warbler/Yellow_Warbler_0121_176402.jpg,500,382,182.Yellow_Warbler,186,109,419,295,302,202,233,186
../../CUB_200_2011/images\182.Yellow_Warbler/Yellow_Warbler_0061_176559.jpg,500,375,182.Yellow_Warbler,72,99,305,215,188,157,233,116
../../CUB_200_2011/images\182.Yellow_Warbler/Yellow_Warbler_0080_176542.jpg,500,400,182.Yellow_Warbler,87,71,233,376,160,223,146,305
../../CUB_200_2011/images\182.Yellow_Warbler/Yellow_Warbler_0118_176409.jpg,411,500,182.Yellow_Warbler,66,138,222,409,144,273,156,271
../../CUB_200_2011/images\182.Yellow_Warbler/Yellow_Warbler_0014_176414.jpg,333,500,182.Yellow_Warbler,45,93,247,348,146,220,202,255
../../CUB_200_2011/images\182.Yellow_Warbler/Yellow_Warbler_0018_176674.jpg,500,356,182.Yellow_Warbler,40,32,438,283,239,157,398,251
../../CUB_200_2011/images\182.Yellow_Warbler/Yellow_Warbler_0057_176675.jpg,500,400,182.Yellow_Warbler,221,143,372,271,296,207,151,128
../../CUB_200_2011/images\182.Yellow_Warbler/Yellow_Warbler_0011_176676.jpg,500,400,182.Yellow_Warbler,81,85,216,214,148,149,135,129
../../CUB_200_2011/images\182.Yellow_Warbler/Yellow_Warbler_0003_176429.jpg,339,500,182.Yellow_Warbler,91,132,304,388,197,260,213,256
../../CUB_200_2011/images\182.Yellow_Warbler/Yellow_Warbler_0013_176437.jpg,500,333,182.Yellow_Warbler,134,83,387,249,260,166,253,166
../../CUB_200_2011/images\182.Yellow_Warbler/Yellow_Warbler_0122_176182.jpg,399,500,182.Yellow_Warbler,79,19,374,481,226,250,295,462
../../CUB_200_2011/images\182.Yellow_Warbler/Yellow_Warbler_0039_176444.jpg,500,375,182.Yellow_Warbler,42,76,413,331,227,203,371,255
../../CUB_200_2011/images\182.Yellow_Warbler/Yellow_Warbler_0025_176189.jpg,500,399,182.Yellow_Warbler,45,52,481,283,263,167,436,231
../../CUB_200_2011/images\182.Yellow_Warbler/Yellow_Warbler_0016_176452.jpg,500,433,182.Yellow_Warbler,166,152,442,298,304,225,276,146
../../CUB_200_2011/images\182.Yellow_Warbler/Yellow_Warbler_0047_176456.jpg,500,309,182.Yellow_Warbler,170,75,295,232,232,153,125,157
../../CUB_200_2011/images\182.Yellow_Warbler/Yellow_Warbler_0114_176201.jpg,500,333,182.Yellow_Warbler,49,82,386,316,217,199,337,234
../../CUB_200_2011/images\182.Yellow_Warbler/Yellow_Warbler_0095_176202.jpg,500,357,182.Yellow_Warbler,121,64,432,260,276,162,311,196
../../CUB_200_2011/images\182.Yellow_Warbler/Yellow_Warbler_0034_176204.jpg,500,333,182.Yellow_Warbler,48,72,423,294,235,183,375,222
../../CUB_200_2011/images\182.Yellow_Warbler/Yellow_Warbler_0046_176212.jpg,500,326,182.Yellow_Warbler,41,41,490,275,265,158,449,234
../../CUB_200_2011/images\182.Yellow_Warbler/Yellow_Warbler_0123_176471.jpg,400,500,182.Yellow_Warbler,54,82,246,379,150,230,192,297
../../CUB_200_2011/images\182.Yellow_Warbler/Yellow_Warbler_0073_176218.jpg,500,333,182.Yellow_Warbler,77,80,307,266,192,173,230,186
../../CUB_200_2011/images\182.Yellow_Warbler/Yellow_Warbler_0100_176733.jpg,500,333,182.Yellow_Warbler,70,103,301,213,185,158,231,110
../../CUB_200_2011/images\182.Yellow_Warbler/Yellow_Warbler_0119_176485.jpg,500,375,182.Yellow_Warbler,207,50,335,352,271,201,128,302
../../CUB_200_2011/images\182.Yellow_Warbler/Yellow_Warbler_0093_176490.jpg,500,500,182.Yellow_Warbler,95,264,221,433,158,348,126,169
../../CUB_200_2011/images\182.Yellow_Warbler/Yellow_Warbler_0040_176954.jpg,500,333,182.Yellow_Warbler,34,80,358,288,196,184,324,208
../../CUB_200_2011/images\182.Yellow_Warbler/Yellow_Warbler_0030_176236.jpg,386,500,182.Yellow_Warbler,37,110,241,405,139,257,204,295
../../CUB_200_2011/images\182.Yellow_Warbler/Yellow_Warbler_0007_176616.jpg,500,386,182.Yellow_Warbler,221,107,372,293,296,200,151,186
../../CUB_200_2011/images\182.Yellow_Warbler/Yellow_Warbler_0043_176247.jpg,500,407,182.Yellow_Warbler,125,156,422,285,273,220,297,129
../../CUB_200_2011/images\182.Yellow_Warbler/Yellow_Warbler_0049_176526.jpg,490,500,182.Yellow_Warbler,151,141,365,342,258,241,214,201
../../CUB_200_2011/images\182.Yellow_Warbler/Yellow_Warbler_0004_176947.jpg,500,375,182.Yellow_Warbler,246,149,359,269,302,209,113,120
../../CUB_200_2011/images\182.Yellow_Warbler/Yellow_Warbler_0031_176282.jpg,500,375,182.Yellow_Warbler,194,134,345,248,269,191,151,114
../../CUB_200_2011/images\182.Yellow_Warbler/Yellow_Warbler_0097_176538.jpg,500,357,182.Yellow_Warbler,55,45,303,279,179,162,248,234
../../CUB_200_2011/images\182.Yellow_Warbler/Yellow_Warbler_0063_176800.jpg,500,333,182.Yellow_Warbler,139,114,299,270,219,192,160,156
../../CUB_200_2011/images\182.Yellow_Warbler/Yellow_Warbler_0083_176292.jpg,500,333,182.Yellow_Warbler,253,127,460,232,356,179,207,105
../../CUB_200_2011/images\182.Yellow_Warbler/Yellow_Warbler_0112_176301.jpg,445,500,182.Yellow_Warbler,89,72,338,377,213,224,249,305
../../CUB_200_2011/images\182.Yellow_Warbler/Yellow_Warbler_0104_176541.jpg,500,333,182.Yellow_Warbler,183,113,376,280,279,196,193,167
../../CUB_200_2011/images\182.Yellow_Warbler/Yellow_Warbler_0102_176821.jpg,500,333,182.Yellow_Warbler,58,43,405,286,231,164,347,243
../../CUB_200_2011/images\182.Yellow_Warbler/Yellow_Warbler_0056_176320.jpg,500,335,182.Yellow_Warbler,163,110,396,257,279,183,233,147
../../CUB_200_2011/images\182.Yellow_Warbler/Yellow_Warbler_0042_176460.jpg,500,342,182.Yellow_Warbler,278,54,463,233,370,143,185,179
../../CUB_200_2011/images\182.Yellow_Warbler/Yellow_Warbler_0096_176586.jpg,500,481,182.Yellow_Warbler,167,216,342,329,254,272,175,113
../../CUB_200_2011/images\182.Yellow_Warbler/Yellow_Warbler_0088_176336.jpg,500,392,182.Yellow_Warbler,52,110,208,242,130,176,156,132
../../CUB_200_2011/images\182.Yellow_Warbler/Yellow_Warbler_0026_176337.jpg,360,458,182.Yellow_Warbler,73,112,251,345,162,228,178,233
../../CUB_200_2011/images\182.Yellow_Warbler/Yellow_Warbler_0029_176855.jpg,313,500,182.Yellow_Warbler,107,107,222,244,164,175,115,137
../../CUB_200_2011/images\182.Yellow_Warbler/Yellow_Warbler_0067_176856.jpg,500,414,182.Yellow_Warbler,21,94,348,308,184,201,327,214
../../CUB_200_2011/images\182.Yellow_Warbler/Yellow_Warbler_0069_176346.jpg,313,500,182.Yellow_Warbler,94,154,293,397,193,275,199,243
../../CUB_200_2011/images\182.Yellow_Warbler/Yellow_Warbler_0087_176591.jpg,500,496,182.Yellow_Warbler,171,143,279,258,225,200,108,115
../../CUB_200_2011/images\182.Yellow_Warbler/Yellow_Warbler_0021_176421.jpg,500,418,182.Yellow_Warbler,209,129,379,292,294,210,170,163
../../CUB_200_2011/images\182.Yellow_Warbler/Yellow_Warbler_0101_176864.jpg,500,333,182.Yellow_Warbler,99,93,447,246,273,169,348,153
../../CUB_200_2011/images\182.Yellow_Warbler/Yellow_Warbler_0105_176849.jpg,500,361,182.Yellow_Warbler,158,100,322,234,240,167,164,134
../../CUB_200_2011/images\182.Yellow_Warbler/Yellow_Warbler_0035_176360.jpg,500,439,182.Yellow_Warbler,162,153,385,297,273,225,223,144
../../CUB_200_2011/images\182.Yellow_Warbler/Yellow_Warbler_0020_176364.jpg,500,385,182.Yellow_Warbler,61,123,244,322,152,222,183,199
../../CUB_200_2011/images\182.Yellow_Warbler/Yellow_Warbler_0094_176365.jpg,500,375,182.Yellow_Warbler,221,75,393,319,307,197,172,244
../../CUB_200_2011/images\182.Yellow_Warbler/Yellow_Warbler_0090_176366.jpg,500,339,182.Yellow_Warbler,164,102,308,205,236,153,144,103
../../CUB_200_2011/images\182.Yellow_Warbler/Yellow_Warbler_0044_176367.jpg,500,400,182.Yellow_Warbler,94,76,298,278,196,177,204,202
../../CUB_200_2011/images\182.Yellow_Warbler/Yellow_Warbler_0017_176888.jpg,500,375,182.Yellow_Warbler,126,36,312,311,219,173,186,275
../../CUB_200_2011/images\182.Yellow_Warbler/Yellow_Warbler_0058_176891.jpg,336,500,182.Yellow_Warbler,77,45,244,384,160,214,167,339
../../CUB_200_2011/images\182.Yellow_Warbler/Yellow_Warbler_0106_176383.jpg,375,500,182.Yellow_Warbler,55,50,223,345,139,197,168,295
../../CUB_200_2011/images\183.Northern_Waterthrush/Northern_Waterthrush_0077_177152.jpg,500,333,183.Northern_Waterthrush,120,60,315,175,217,117,195,115
../../CUB_200_2011/images\183.Northern_Waterthrush/Northern_Waterthrush_0103_177162.jpg,500,333,183.Northern_Waterthrush,69,76,388,304,228,190,319,228
../../CUB_200_2011/images\183.Northern_Waterthrush/Northern_Waterthrush_0089_177167.jpg,500,327,183.Northern_Waterthrush,203,95,354,210,278,152,151,115
../../CUB_200_2011/images\183.Northern_Waterthrush/Northern_Waterthrush_0046_176984.jpg,500,389,183.Northern_Waterthrush,47,19,484,377,265,198,437,358
../../CUB_200_2011/images\183.Northern_Waterthrush/Northern_Waterthrush_0038_177027.jpg,500,333,183.Northern_Waterthrush,161,54,327,206,244,130,166,152
../../CUB_200_2011/images\183.Northern_Waterthrush/Northern_Waterthrush_0061_177172.jpg,500,374,183.Northern_Waterthrush,181,116,418,330,299,223,237,214
../../CUB_200_2011/images\183.Northern_Waterthrush/Northern_Waterthrush_0049_177173.jpg,500,375,183.Northern_Waterthrush,26,102,388,299,207,200,362,197
../../CUB_200_2011/images\183.Northern_Waterthrush/Northern_Waterthrush_0021_177187.jpg,500,495,183.Northern_Waterthrush,154,168,329,322,241,245,175,154
../../CUB_200_2011/images\183.Northern_Waterthrush/Northern_Waterthrush_0041_177199.jpg,500,333,183.Northern_Waterthrush,54,86,268,239,161,162,214,153
../../CUB_200_2011/images\183.Northern_Waterthrush/Northern_Waterthrush_0015_177075.jpg,400,500,183.Northern_Waterthrush,4,36,358,401,181,218,354,365
../../CUB_200_2011/images\183.Northern_Waterthrush/Northern_Waterthrush_0060_177213.jpg,500,332,183.Northern_Waterthrush,45,80,276,203,160,141,231,123
../../CUB_200_2011/images\183.Northern_Waterthrush/Northern_Waterthrush_0033_177214.jpg,500,400,183.Northern_Waterthrush,191,155,387,292,289,223,196,137
../../CUB_200_2011/images\183.Northern_Waterthrush/Northern_Waterthrush_0044_176961.jpg,500,446,183.Northern_Waterthrush,64,144,450,309,257,226,386,165
../../CUB_200_2011/images\183.Northern_Waterthrush/Northern_Waterthrush_0105_176970.jpg,500,400,183.Northern_Waterthrush,15,121,334,358,174,239,319,237
../../CUB_200_2011/images\183.Northern_Waterthrush/Northern_Waterthrush_0081_176972.jpg,500,390,183.Northern_Waterthrush,103,40,427,355,265,197,324,315
../../CUB_200_2011/images\183.Northern_Waterthrush/Northern_Waterthrush_0075_176978.jpg,500,400,183.Northern_Waterthrush,108,168,312,301,210,234,204,133
../../CUB_200_2011/images\183.Northern_Waterthrush/Northern_Waterthrush_0084_177239.jpg,500,333,183.Northern_Waterthrush,140,70,363,288,251,179,223,218
../../CUB_200_2011/images\183.Northern_Waterthrush/Northern_Waterthrush_0076_176986.jpg,345,500,183.Northern_Waterthrush,115,244,285,372,200,308,170,128
../../CUB_200_2011/images\183.Northern_Waterthrush/Northern_Waterthrush_0082_177243.jpg,448,319,183.Northern_Waterthrush,72,67,297,227,184,147,225,160
../../CUB_200_2011/images\183.Northern_Waterthrush/Northern_Waterthrush_0006_176988.jpg,500,371,183.Northern_Waterthrush,60,130,336,322,198,226,276,192
../../CUB_200_2011/images\183.Northern_Waterthrush/Northern_Waterthrush_0023_177002.jpg,500,333,183.Northern_Waterthrush,18,63,303,277,160,170,285,214
../../CUB_200_2011/images\183.Northern_Waterthrush/Northern_Waterthrush_0022_177003.jpg,500,375,183.Northern_Waterthrush,48,68,383,338,215,203,335,270
../../CUB_200_2011/images\183.Northern_Waterthrush/Northern_Waterthrush_0096_177007.jpg,500,337,183.Northern_Waterthrush,105,88,403,287,254,187,298,199
../../CUB_200_2011/images\183.Northern_Waterthrush/Northern_Waterthrush_0079_177008.jpg,500,339,183.Northern_Waterthrush,146,81,429,276,287,178,283,195
../../CUB_200_2011/images\183.Northern_Waterthrush/Northern_Waterthrush_0042_177272.jpg,500,333,183.Northern_Waterthrush,118,85,291,245,204,165,173,160
../../CUB_200_2011/images\183.Northern_Waterthrush/Northern_Waterthrush_0068_177273.jpg,500,357,183.Northern_Waterthrush,38,39,394,304,216,171,356,265
../../CUB_200_2011/images\183.Northern_Waterthrush/Northern_Waterthrush_0036_177274.jpg,500,412,183.Northern_Waterthrush,142,152,493,355,317,253,351,203
../../CUB_200_2011/images\183.Northern_Waterthrush/Northern_Waterthrush_0005_177023.jpg,500,336,183.Northern_Waterthrush,178,103,409,247,293,175,231,144
../../CUB_200_2011/images\183.Northern_Waterthrush/Northern_Waterthrush_0090_177283.jpg,318,223,183.Northern_Waterthrush,69,58,222,170,145,114,153,112
../../CUB_200_2011/images\183.Northern_Waterthrush/Northern_Waterthrush_0027_177286.jpg,500,333,183.Northern_Waterthrush,114,70,320,214,217,142,206,144
../../CUB_200_2011/images\183.Northern_Waterthrush/Northern_Waterthrush_0057_177291.jpg,500,333,183.Northern_Waterthrush,175,88,300,229,237,158,125,141
../../CUB_200_2011/images\183.Northern_Waterthrush/Northern_Waterthrush_0024_177293.jpg,500,333,183.Northern_Waterthrush,133,83,422,265,277,174,289,182
../../CUB_200_2011/images\183.Northern_Waterthrush/Northern_Waterthrush_0097_177045.jpg,500,281,183.Northern_Waterthrush,239,65,396,169,317,117,157,104
../../CUB_200_2011/images\183.Northern_Waterthrush/Northern_Waterthrush_0047_177304.jpg,500,369,183.Northern_Waterthrush,127,148,460,334,293,241,333,186
../../CUB_200_2011/images\183.Northern_Waterthrush/Northern_Waterthrush_0014_177305.jpg,500,333,183.Northern_Waterthrush,191,113,355,282,273,197,164,169
../../CUB_200_2011/images\183.Northern_Waterthrush/Northern_Waterthrush_0011_177311.jpg,500,357,183.Northern_Waterthrush,89,96,394,304,241,200,305,208
../../CUB_200_2011/images\183.Northern_Waterthrush/Northern_Waterthrush_0108_177059.jpg,500,333,183.Northern_Waterthrush,10,54,335,254,172,154,325,200
../../CUB_200_2011/images\183.Northern_Waterthrush/Northern_Waterthrush_0073_177063.jpg,500,400,183.Northern_Waterthrush,102,113,394,262,248,187,292,149
../../CUB_200_2011/images\183.Northern_Waterthrush/Northern_Waterthrush_0043_177070.jpg,500,333,183.Northern_Waterthrush,140,91,334,234,237,162,194,143
../../CUB_200_2011/images\183.Northern_Waterthrush/Northern_Waterthrush_0070_177096.jpg,500,406,183.Northern_Waterthrush,192,166,475,385,333,275,283,219
../../CUB_200_2011/images\183.Northern_Waterthrush/Northern_Waterthrush_0110_177074.jpg,375,500,183.Northern_Waterthrush,7,234,349,456,178,345,342,222
../../CUB_200_2011/images\183.Northern_Waterthrush/Northern_Waterthrush_0050_177331.jpg,500,349,183.Northern_Waterthrush,81,99,251,211,166,155,170,112
../../CUB_200_2011/images\183.Northern_Waterthrush/Northern_Waterthrush_0009_177078.jpg,500,332,183.Northern_Waterthrush,158,90,415,229,286,159,257,139
../../CUB_200_2011/images\183.Northern_Waterthrush/Northern_Waterthrush_0080_177080.jpg,500,461,183.Northern_Waterthrush,34,215,385,447,209,331,351,232
../../CUB_200_2011/images\183.Northern_Waterthrush/Northern_Waterthrush_0013_177343.jpg,500,361,183.Northern_Waterthrush,102,103,385,324,243,213,283,221
../../CUB_200_2011/images\183.Northern_Waterthrush/Northern_Waterthrush_0016_177345.jpg,500,459,183.Northern_Waterthrush,150,96,327,226,238,161,177,130
../../CUB_200_2011/images\183.Northern_Waterthrush/Northern_Waterthrush_0063_177346.jpg,500,338,183.Northern_Waterthrush,150,90,477,313,313,201,327,223
../../CUB_200_2011/images\183.Northern_Waterthrush/Northern_Waterthrush_0086_177358.jpg,500,461,183.Northern_Waterthrush,165,150,361,350,263,250,196,200
../../CUB_200_2011/images\183.Northern_Waterthrush/Northern_Waterthrush_0062_177364.jpg,500,346,183.Northern_Waterthrush,176,92,470,271,323,181,294,179
../../CUB_200_2011/images\183.Northern_Waterthrush/Northern_Waterthrush_0066_177110.jpg,500,367,183.Northern_Waterthrush,23,48,355,348,189,198,332,300
../../CUB_200_2011/images\183.Northern_Waterthrush/Northern_Waterthrush_0055_177114.jpg,500,356,183.Northern_Waterthrush,129,110,481,278,305,194,352,168
../../CUB_200_2011/images\183.Northern_Waterthrush/Northern_Waterthrush_0098_177116.jpg,500,373,183.Northern_Waterthrush,154,102,492,361,323,231,338,259
../../CUB_200_2011/images\183.Northern_Waterthrush/Northern_Waterthrush_0051_177120.jpg,500,434,183.Northern_Waterthrush,49,136,362,358,205,247,313,222
../../CUB_200_2011/images\183.Northern_Waterthrush/Northern_Waterthrush_0072_177121.jpg,500,418,183.Northern_Waterthrush,163,65,353,255,258,160,190,190
../../CUB_200_2011/images\183.Northern_Waterthrush/Northern_Waterthrush_0048_177129.jpg,500,500,183.Northern_Waterthrush,94,73,375,238,234,155,281,165
../../CUB_200_2011/images\183.Northern_Waterthrush/Northern_Waterthrush_0104_177137.jpg,500,393,183.Northern_Waterthrush,39,163,311,334,175,248,272,171
../../CUB_200_2011/images\183.Northern_Waterthrush/Northern_Waterthrush_0093_177141.jpg,500,333,183.Northern_Waterthrush,195,86,328,222,261,154,133,136
../../CUB_200_2011/images\183.Northern_Waterthrush/Northern_Waterthrush_0058_177143.jpg,500,454,183.Northern_Waterthrush,64,134,382,329,223,231,318,195
../../CUB_200_2011/images\183.Northern_Waterthrush/Northern_Waterthrush_0087_177148.jpg,500,375,183.Northern_Waterthrush,77,79,445,329,261,204,368,250
../../CUB_200_2011/images\183.Northern_Waterthrush/Northern_Waterthrush_0020_177149.jpg,500,408,183.Northern_Waterthrush,151,105,389,316,270,210,238,211
../../CUB_200_2011/images\184.Louisiana_Waterthrush/Louisiana_Waterthrush_0027_177539.jpg,500,333,184.Louisiana_Waterthrush,111,34,242,167,176,100,131,133
../../CUB_200_2011/images\184.Louisiana_Waterthrush/Louisiana_Waterthrush_0023_795269.jpg,500,375,184.Louisiana_Waterthrush,105,91,499,330,302,210,394,239
../../CUB_200_2011/images\184.Louisiana_Waterthrush/Louisiana_Waterthrush_0078_177444.jpg,500,398,184.Louisiana_Waterthrush,46,98,434,334,240,216,388,236
../../CUB_200_2011/images\184.Louisiana_Waterthrush/Louisiana_Waterthrush_0018_177557.jpg,500,333,184.Louisiana_Waterthrush,97,75,461,296,279,185,364,221
../../CUB_200_2011/images\184.Louisiana_Waterthrush/Louisiana_Waterthrush_0059_177449.jpg,500,333,184.Louisiana_Waterthrush,129,98,430,270,279,184,301,172
../../CUB_200_2011/images\184.Louisiana_Waterthrush/Louisiana_Waterthrush_0047_177523.jpg,500,483,184.Louisiana_Waterthrush,83,102,290,247,186,174,207,145
../../CUB_200_2011/images\184.Louisiana_Waterthrush/Louisiana_Waterthrush_0004_177455.jpg,500,351,184.Louisiana_Waterthrush,279,55,455,206,367,130,176,151
../../CUB_200_2011/images\184.Louisiana_Waterthrush/Louisiana_Waterthrush_0035_177457.jpg,500,333,184.Louisiana_Waterthrush,95,57,499,331,297,194,404,274
../../CUB_200_2011/images\184.Louisiana_Waterthrush/Louisiana_Waterthrush_0068_177462.jpg,500,351,184.Louisiana_Waterthrush,245,170,437,295,341,232,192,125
../../CUB_200_2011/images\184.Louisiana_Waterthrush/Louisiana_Waterthrush_0015_177515.jpg,500,439,184.Louisiana_Waterthrush,187,148,415,328,301,238,228,180
../../CUB_200_2011/images\184.Louisiana_Waterthrush/Louisiana_Waterthrush_0003_177479.jpg,500,432,184.Louisiana_Waterthrush,108,144,394,301,251,222,286,157
../../CUB_200_2011/images\184.Louisiana_Waterthrush/Louisiana_Waterthrush_0054_176977.jpg,500,339,184.Louisiana_Waterthrush,155,73,425,317,290,195,270,244
../../CUB_200_2011/images\184.Louisiana_Waterthrush/Louisiana_Waterthrush_0042_177551.jpg,500,400,184.Louisiana_Waterthrush,39,85,423,262,231,173,384,177
../../CUB_200_2011/images\184.Louisiana_Waterthrush/Louisiana_Waterthrush_0026_177503.jpg,500,375,184.Louisiana_Waterthrush,149,96,418,290,283,193,269,194
../../CUB_200_2011/images\184.Louisiana_Waterthrush/Louisiana_Waterthrush_0014_795238.jpg,500,258,184.Louisiana_Waterthrush,57,49,327,222,192,135,270,173
../../CUB_200_2011/images\184.Louisiana_Waterthrush/Louisiana_Waterthrush_0016_795240.jpg,396,288,184.Louisiana_Waterthrush,128,43,369,253,248,148,241,210
../../CUB_200_2011/images\184.Louisiana_Waterthrush/Louisiana_Waterthrush_0053_795241.jpg,300,225,184.Louisiana_Waterthrush,72,15,273,179,172,97,201,164
../../CUB_200_2011/images\184.Louisiana_Waterthrush/Louisiana_Waterthrush_0034_795242.jpg,400,267,184.Louisiana_Waterthrush,39,72,236,224,137,148,197,152
../../CUB_200_2011/images\184.Louisiana_Waterthrush/Louisiana_Waterthrush_0049_795244.jpg,306,375,184.Louisiana_Waterthrush,20,63,271,308,145,185,251,245
../../CUB_200_2011/images\184.Louisiana_Waterthrush/Louisiana_Waterthrush_0056_795245.jpg,390,500,184.Louisiana_Waterthrush,60,203,315,367,187,285,255,164
../../CUB_200_2011/images\184.Louisiana_Waterthrush/Louisiana_Waterthrush_0091_795246.jpg,400,301,184.Louisiana_Waterthrush,181,49,341,274,261,161,160,225
../../CUB_200_2011/images\184.Louisiana_Waterthrush/Louisiana_Waterthrush_0077_795247.jpg,437,298,184.Louisiana_Waterthrush,38,41,387,228,212,134,349,187
../../CUB_200_2011/images\184.Louisiana_Waterthrush/Louisiana_Waterthrush_0030_795248.jpg,500,342,184.Louisiana_Waterthrush,69,50,467,320,268,185,398,270
../../CUB_200_2011/images\184.Louisiana_Waterthrush/Louisiana_Waterthrush_0021_795250.jpg,358,281,184.Louisiana_Waterthrush,76,22,284,231,180,126,208,209
../../CUB_200_2011/images\184.Louisiana_Waterthrush/Louisiana_Waterthrush_0040_795251.jpg,288,274,184.Louisiana_Waterthrush,11,47,264,250,137,148,253,203
../../CUB_200_2011/images\184.Louisiana_Waterthrush/Louisiana_Waterthrush_0079_795252.jpg,400,311,184.Louisiana_Waterthrush,102,24,318,253,210,138,216,229
../../CUB_200_2011/images\184.Louisiana_Waterthrush/Louisiana_Waterthrush_0044_177526.jpg,500,333,184.Louisiana_Waterthrush,195,54,318,249,256,151,123,195
../../CUB_200_2011/images\184.Louisiana_Waterthrush/Louisiana_Waterthrush_0010_795255.jpg,468,275,184.Louisiana_Waterthrush,69,39,406,266,237,152,337,227
../../CUB_200_2011/images\184.Louisiana_Waterthrush/Louisiana_Waterthrush_0076_795257.jpg,420,280,184.Louisiana_Waterthrush,80,17,358,248,219,132,278,231
../../CUB_200_2011/images\184.Louisiana_Waterthrush/Louisiana_Waterthrush_0007_795258.jpg,350,350,184.Louisiana_Waterthrush,64,102,234,273,149,187,170,171
../../CUB_200_2011/images\184.Louisiana_Waterthrush/Louisiana_Waterthrush_0066_795259.jpg,350,350,184.Louisiana_Waterthrush,51,30,284,325,167,177,233,295
../../CUB_200_2011/images\184.Louisiana_Waterthrush/Louisiana_Waterthrush_0087_795261.jpg,500,334,184.Louisiana_Waterthrush,34,88,353,234,193,161,319,146
../../CUB_200_2011/images\184.Louisiana_Waterthrush/Louisiana_Waterthrush_0029_795262.jpg,311,288,184.Louisiana_Waterthrush,18,13,296,258,157,135,278,245
../../CUB_200_2011/images\184.Louisiana_Waterthrush/Louisiana_Waterthrush_0086_795263.jpg,500,358,184.Louisiana_Waterthrush,32,115,328,257,180,186,296,142
../../CUB_200_2011/images\184.Louisiana_Waterthrush/Louisiana_Waterthrush_0094_795264.jpg,500,389,184.Louisiana_Waterthrush,121,79,330,210,225,144,209,131
../../CUB_200_2011/images\184.Louisiana_Waterthrush/Louisiana_Waterthrush_0020_795265.jpg,396,287,184.Louisiana_Waterthrush,126,81,367,243,246,162,241,162
../../CUB_200_2011/images\184.Louisiana_Waterthrush/Louisiana_Waterthrush_0062_177285.jpg,500,422,184.Louisiana_Waterthrush,33,102,427,325,230,213,394,223
../../CUB_200_2011/images\184.Louisiana_Waterthrush/Louisiana_Waterthrush_0057_795270.jpg,500,333,184.Louisiana_Waterthrush,246,62,440,269,343,165,194,207
../../CUB_200_2011/images\184.Louisiana_Waterthrush/Louisiana_Waterthrush_0001_795271.jpg,500,344,184.Louisiana_Waterthrush,176,87,486,330,331,208,310,243
../../CUB_200_2011/images\184.Louisiana_Waterthrush/Louisiana_Waterthrush_0045_795274.jpg,500,330,184.Louisiana_Waterthrush,42,46,330,310,186,178,288,264
../../CUB_200_2011/images\184.Louisiana_Waterthrush/Louisiana_Waterthrush_0048_795277.jpg,447,300,184.Louisiana_Waterthrush,195,108,385,242,290,175,190,134
../../CUB_200_2011/images\184.Louisiana_Waterthrush/Louisiana_Waterthrush_0041_795279.jpg,400,311,184.Louisiana_Waterthrush,64,44,307,245,185,144,243,201
../../CUB_200_2011/images\184.Louisiana_Waterthrush/Louisiana_Waterthrush_0055_795280.jpg,400,293,184.Louisiana_Waterthrush,33,30,364,259,198,144,331,229
../../CUB_200_2011/images\184.Louisiana_Waterthrush/Louisiana_Waterthrush_0033_795281.jpg,500,351,184.Louisiana_Waterthrush,106,82,462,340,284,211,356,258
../../CUB_200_2011/images\184.Louisiana_Waterthrush/Louisiana_Waterthrush_0081_795283.jpg,480,360,184.Louisiana_Waterthrush,110,25,388,336,249,180,278,311
../../CUB_200_2011/images\184.Louisiana_Waterthrush/Louisiana_Waterthrush_0088_795284.jpg,230,163,184.Louisiana_Waterthrush,59,34,205,149,132,91,146,115
../../CUB_200_2011/images\184.Louisiana_Waterthrush/Louisiana_Waterthrush_0002_795285.jpg,500,333,184.Louisiana_Waterthrush,35,124,355,305,195,214,320,181
../../CUB_200_2011/images\184.Louisiana_Waterthrush/Louisiana_Waterthrush_0073_177558.jpg,500,375,184.Louisiana_Waterthrush,256,92,465,274,360,183,209,182
../../CUB_200_2011/images\184.Louisiana_Waterthrush/Louisiana_Waterthrush_0031_177509.jpg,500,419,184.Louisiana_Waterthrush,159,120,371,222,265,171,212,102
../../CUB_200_2011/images\184.Louisiana_Waterthrush/Louisiana_Waterthrush_0019_177062.jpg,500,374,184.Louisiana_Waterthrush,104,105,413,330,258,217,309,225
../../CUB_200_2011/images\184.Louisiana_Waterthrush/Louisiana_Waterthrush_0060_177583.jpg,500,500,184.Louisiana_Waterthrush,108,173,385,357,246,265,277,184
../../CUB_200_2011/images\184.Louisiana_Waterthrush/Louisiana_Waterthrush_0052_177519.jpg,500,375,184.Louisiana_Waterthrush,129,123,397,310,263,216,268,187
../../CUB_200_2011/images\184.Louisiana_Waterthrush/Louisiana_Waterthrush_0082_177596.jpg,500,309,184.Louisiana_Waterthrush,111,64,455,278,283,171,344,214
../../CUB_200_2011/images\184.Louisiana_Waterthrush/Louisiana_Waterthrush_0046_177604.jpg,500,375,184.Louisiana_Waterthrush,142,103,390,360,266,231,248,257
../../CUB_200_2011/images\184.Louisiana_Waterthrush/Louisiana_Waterthrush_0080_177379.jpg,500,353,184.Louisiana_Waterthrush,56,61,308,303,182,182,252,242
../../CUB_200_2011/images\184.Louisiana_Waterthrush/Louisiana_Waterthrush_0064_177380.jpg,500,357,184.Louisiana_Waterthrush,4,84,354,304,179,194,350,220
../../CUB_200_2011/images\184.Louisiana_Waterthrush/Louisiana_Waterthrush_0032_177385.jpg,500,357,184.Louisiana_Waterthrush,34,115,447,329,240,222,413,214
../../CUB_200_2011/images\184.Louisiana_Waterthrush/Louisiana_Waterthrush_0058_177388.jpg,500,315,184.Louisiana_Waterthrush,75,58,446,272,260,165,371,214
../../CUB_200_2011/images\184.Louisiana_Waterthrush/Louisiana_Waterthrush_0022_177397.jpg,500,333,184.Louisiana_Waterthrush,85,85,338,261,211,173,253,176
../../CUB_200_2011/images\184.Louisiana_Waterthrush/Louisiana_Waterthrush_0025_177403.jpg,400,500,184.Louisiana_Waterthrush,66,235,233,365,149,300,167,130
../../CUB_200_2011/images\185.Bohemian_Waxwing/Bohemian_Waxwing_0010_796672.jpg,442,500,185.Bohemian_Waxwing,97,164,323,462,210,313,226,298
../../CUB_200_2011/images\185.Bohemian_Waxwing/Bohemian_Waxwing_0075_796678.jpg,500,334,185.Bohemian_Waxwing,25,55,342,267,183,161,317,212
../../CUB_200_2011/images\185.Bohemian_Waxwing/Bohemian_Waxwing_0001_796680.jpg,500,309,185.Bohemian_Waxwing,49,68,340,253,194,160,291,185
../../CUB_200_2011/images\185.Bohemian_Waxwing/Bohemian_Waxwing_0068_796682.jpg,500,428,185.Bohemian_Waxwing,79,81,425,375,252,228,346,294
../../CUB_200_2011/images\185.Bohemian_Waxwing/Bohemian_Waxwing_0062_796683.jpg,400,500,185.Bohemian_Waxwing,40,85,269,487,154,286,229,402
../../CUB_200_2011/images\185.Bohemian_Waxwing/Bohemian_Waxwing_0104_177676.jpg,500,385,185.Bohemian_Waxwing,14,40,369,374,191,207,355,334
../../CUB_200_2011/images\185.Bohemian_Waxwing/Bohemian_Waxwing_0079_796687.jpg,395,462,185.Bohemian_Waxwing,6,11,371,447,188,229,365,436
../../CUB_200_2011/images\185.Bohemian_Waxwing/Bohemian_Waxwing_0019_177684.jpg,500,333,185.Bohemian_Waxwing,104,80,400,229,252,154,296,149
../../CUB_200_2011/images\185.Bohemian_Waxwing/Bohemian_Waxwing_0097_177944.jpg,500,479,185.Bohemian_Waxwing,116,76,435,376,275,226,319,300
../../CUB_200_2011/images\185.Bohemian_Waxwing/Bohemian_Waxwing_0094_177955.jpg,500,333,185.Bohemian_Waxwing,183,72,377,332,280,202,194,260
../../CUB_200_2011/images\185.Bohemian_Waxwing/Bohemian_Waxwing_0039_177702.jpg,500,386,185.Bohemian_Waxwing,136,40,357,324,246,182,221,284
../../CUB_200_2011/images\185.Bohemian_Waxwing/Bohemian_Waxwing_0095_177709.jpg,500,382,185.Bohemian_Waxwing,91,23,333,358,212,190,242,335
../../CUB_200_2011/images\185.Bohemian_Waxwing/Bohemian_Waxwing_0096_177969.jpg,500,339,185.Bohemian_Waxwing,72,75,292,325,182,200,220,250
../../CUB_200_2011/images\185.Bohemian_Waxwing/Bohemian_Waxwing_0009_177972.jpg,500,500,185.Bohemian_Waxwing,13,140,380,473,196,306,367,333
../../CUB_200_2011/images\185.Bohemian_Waxwing/Bohemian_Waxwing_0037_796638.jpg,500,348,185.Bohemian_Waxwing,63,8,396,294,229,151,333,286
../../CUB_200_2011/images\185.Bohemian_Waxwing/Bohemian_Waxwing_0084_796639.jpg,500,400,185.Bohemian_Waxwing,309,217,472,373,390,295,163,156
../../CUB_200_2011/images\185.Bohemian_Waxwing/Bohemian_Waxwing_0115_177724.jpg,500,332,185.Bohemian_Waxwing,69,83,379,269,224,176,310,186
../../CUB_200_2011/images\185.Bohemian_Waxwing/Bohemian_Waxwing_0002_177986.jpg,500,375,185.Bohemian_Waxwing,30,15,396,245,213,130,366,230
../../CUB_200_2011/images\185.Bohemian_Waxwing/Bohemian_Waxwing_0099_177747.jpg,334,500,185.Bohemian_Waxwing,34,129,293,435,163,282,259,306
../../CUB_200_2011/images\185.Bohemian_Waxwing/Bohemian_Waxwing_0098_178009.jpg,496,500,185.Bohemian_Waxwing,129,7,372,472,250,239,243,465
../../CUB_200_2011/images\185.Bohemian_Waxwing/Bohemian_Waxwing_0101_796653.jpg,480,500,185.Bohemian_Waxwing,113,40,385,499,249,269,272,459
../../CUB_200_2011/images\185.Bohemian_Waxwing/Bohemian_Waxwing_0024_177661.jpg,334,500,185.Bohemian_Waxwing,36,126,212,430,124,278,176,304
../../CUB_200_2011/images\185.Bohemian_Waxwing/Bohemian_Waxwing_0078_796649.jpg,500,495,185.Bohemian_Waxwing,20,60,396,370,208,215,376,310
../../CUB_200_2011/images\185.Bohemian_Waxwing/Bohemian_Waxwing_0057_177784.jpg,290,242,185.Bohemian_Waxwing,0,21,283,226,141,123,283,205
../../CUB_200_2011/images\185.Bohemian_Waxwing/Bohemian_Waxwing_0102_796692.jpg,375,500,185.Bohemian_Waxwing,6,46,366,322,186,184,360,276
../../CUB_200_2011/images\185.Bohemian_Waxwing/Bohemian_Waxwing_0022_177642.jpg,500,333,185.Bohemian_Waxwing,91,70,260,255,175,162,169,185
../../CUB_200_2011/images\185.Bohemian_Waxwing/Bohemian_Waxwing_0119_177942.jpg,455,500,185.Bohemian_Waxwing,8,18,389,488,198,253,381,470
../../CUB_200_2011/images\185.Bohemian_Waxwing/Bohemian_Waxwing_0004_796652.jpg,500,433,185.Bohemian_Waxwing,78,27,365,363,221,195,287,336
../../CUB_200_2011/images\185.Bohemian_Waxwing/Bohemian_Waxwing_0092_796666.jpg,500,303,185.Bohemian_Waxwing,279,121,424,271,351,196,145,150
../../CUB_200_2011/images\185.Bohemian_Waxwing/Bohemian_Waxwing_0015_177816.jpg,500,333,185.Bohemian_Waxwing,170,103,342,314,256,208,172,211
../../CUB_200_2011/images\185.Bohemian_Waxwing/Bohemian_Waxwing_0082_796655.jpg,500,392,185.Bohemian_Waxwing,196,55,446,368,321,211,250,313
../../CUB_200_2011/images\185.Bohemian_Waxwing/Bohemian_Waxwing_0048_177821.jpg,500,333,185.Bohemian_Waxwing,121,100,305,281,213,190,184,181
../../CUB_200_2011/images\185.Bohemian_Waxwing/Bohemian_Waxwing_0113_177823.jpg,500,333,185.Bohemian_Waxwing,27,22,464,319,245,170,437,297
../../CUB_200_2011/images\185.Bohemian_Waxwing/Bohemian_Waxwing_0121_796658.jpg,152,200,185.Bohemian_Waxwing,6,28,144,169,75,98,138,141
../../CUB_200_2011/images\185.Bohemian_Waxwing/Bohemian_Waxwing_0026_177845.jpg,500,375,185.Bohemian_Waxwing,118,73,307,306,212,189,189,233
../../CUB_200_2011/images\185.Bohemian_Waxwing/Bohemian_Waxwing_0117_177858.jpg,415,500,185.Bohemian_Waxwing,20,124,341,480,180,302,321,356
../../CUB_200_2011/images\185.Bohemian_Waxwing/Bohemian_Waxwing_0046_177864.jpg,500,375,185.Bohemian_Waxwing,153,32,420,331,286,181,267,299
../../CUB_200_2011/images\185.Bohemian_Waxwing/Bohemian_Waxwing_0054_796623.jpg,500,336,185.Bohemian_Waxwing,65,34,452,292,258,163,387,258
../../CUB_200_2011/images\185.Bohemian_Waxwing/Bohemian_Waxwing_0021_796625.jpg,500,414,185.Bohemian_Waxwing,200,106,430,253,315,179,230,147
../../CUB_200_2011/images\185.Bohemian_Waxwing/Bohemian_Waxwing_0100_796627.jpg,500,347,185.Bohemian_Waxwing,44,81,361,306,202,193,317,225
../../CUB_200_2011/images\185.Bohemian_Waxwing/Bohemian_Waxwing_0050_796630.jpg,500,357,185.Bohemian_Waxwing,73,94,339,237,206,165,266,143
../../CUB_200_2011/images\185.Bohemian_Waxwing/Bohemian_Waxwing_0038_796632.jpg,500,333,185.Bohemian_Waxwing,192,36,385,264,288,150,193,228
../../CUB_200_2011/images\185.Bohemian_Waxwing/Bohemian_Waxwing_0031_796633.jpg,341,500,185.Bohemian_Waxwing,90,73,243,324,166,198,153,251
../../CUB_200_2011/images\185.Bohemian_Waxwing/Bohemian_Waxwing_0091_796634.jpg,301,320,185.Bohemian_Waxwing,53,48,249,238,151,143,196,190
../../CUB_200_2011/images\185.Bohemian_Waxwing/Bohemian_Waxwing_0081_796636.jpg,334,500,185.Bohemian_Waxwing,43,140,156,447,99,293,113,307
../../CUB_200_2011/images\185.Bohemian_Waxwing/Bohemian_Waxwing_0041_177630.jpg,445,500,185.Bohemian_Waxwing,62,115,395,308,228,211,333,193
../../CUB_200_2011/images\185.Bohemian_Waxwing/Bohemian_Waxwing_0042_177887.jpg,333,500,185.Bohemian_Waxwing,31,120,277,437,154,278,246,317
../../CUB_200_2011/images\185.Bohemian_Waxwing/Bohemian_Waxwing_0060_796642.jpg,240,300,185.Bohemian_Waxwing,84,14,192,250,138,132,108,236
../../CUB_200_2011/images\185.Bohemian_Waxwing/Bohemian_Waxwing_0030_177635.jpg,500,335,185.Bohemian_Waxwing,24,22,413,231,218,126,389,209
../../CUB_200_2011/images\185.Bohemian_Waxwing/Bohemian_Waxwing_0056_796645.jpg,450,334,185.Bohemian_Waxwing,1,18,423,323,212,170,422,305
../../CUB_200_2011/images\185.Bohemian_Waxwing/Bohemian_Waxwing_0034_796646.jpg,300,311,185.Bohemian_Waxwing,77,72,220,211,148,141,143,139
../../CUB_200_2011/images\185.Bohemian_Waxwing/Bohemian_Waxwing_0028_796647.jpg,500,334,185.Bohemian_Waxwing,164,21,293,287,228,154,129,266
../../CUB_200_2011/images\185.Bohemian_Waxwing/Bohemian_Waxwing_0006_796651.jpg,500,408,185.Bohemian_Waxwing,37,84,338,306,187,195,301,222
../../CUB_200_2011/images\185.Bohemian_Waxwing/Bohemian_Waxwing_0072_177901.jpg,500,421,185.Bohemian_Waxwing,151,102,356,391,253,246,205,289
../../CUB_200_2011/images\185.Bohemian_Waxwing/Bohemian_Waxwing_0122_796654.jpg,500,490,185.Bohemian_Waxwing,56,25,418,423,237,224,362,398
../../CUB_200_2011/images\185.Bohemian_Waxwing/Bohemian_Waxwing_0013_796660.jpg,495,355,185.Bohemian_Waxwing,16,39,461,326,238,182,445,287
../../CUB_200_2011/images\185.Bohemian_Waxwing/Bohemian_Waxwing_0036_796661.jpg,300,278,185.Bohemian_Waxwing,51,38,238,213,144,125,187,175
../../CUB_200_2011/images\185.Bohemian_Waxwing/Bohemian_Waxwing_0040_177914.jpg,500,400,185.Bohemian_Waxwing,72,85,371,343,221,214,299,258
../../CUB_200_2011/images\185.Bohemian_Waxwing/Bohemian_Waxwing_0029_177915.jpg,500,468,185.Bohemian_Waxwing,170,82,450,388,310,235,280,306
../../CUB_200_2011/images\185.Bohemian_Waxwing/Bohemian_Waxwing_0114_177621.jpg,500,315,185.Bohemian_Waxwing,43,40,474,262,258,151,431,222
../../CUB_200_2011/images\186.Cedar_Waxwing/Cedar_Waxwing_0034_179715.jpg,333,500,186.Cedar_Waxwing,66,144,210,427,138,285,144,283
../../CUB_200_2011/images\186.Cedar_Waxwing/Cedar_Waxwing_0028_179724.jpg,400,500,186.Cedar_Waxwing,80,156,252,377,166,266,172,221
../../CUB_200_2011/images\186.Cedar_Waxwing/Cedar_Waxwing_0060_178190.jpg,500,500,186.Cedar_Waxwing,25,52,444,493,234,272,419,441
../../CUB_200_2011/images\186.Cedar_Waxwing/Cedar_Waxwing_0077_178191.jpg,500,336,186.Cedar_Waxwing,57,46,281,282,169,164,224,236
../../CUB_200_2011/images\186.Cedar_Waxwing/Cedar_Waxwing_0030_178202.jpg,418,500,186.Cedar_Waxwing,54,84,252,228,153,156,198,144
../../CUB_200_2011/images\186.Cedar_Waxwing/Cedar_Waxwing_0066_178719.jpg,347,500,186.Cedar_Waxwing,104,204,223,437,163,320,119,233
../../CUB_200_2011/images\186.Cedar_Waxwing/Cedar_Waxwing_0049_178723.jpg,388,500,186.Cedar_Waxwing,174,90,350,352,262,221,176,262
../../CUB_200_2011/images\186.Cedar_Waxwing/Cedar_Waxwing_0076_178732.jpg,357,500,186.Cedar_Waxwing,70,117,300,415,185,266,230,298
../../CUB_200_2011/images\186.Cedar_Waxwing/Cedar_Waxwing_0033_178737.jpg,355,500,186.Cedar_Waxwing,122,91,257,298,189,194,135,207
../../CUB_200_2011/images\186.Cedar_Waxwing/Cedar_Waxwing_0024_178230.jpg,400,500,186.Cedar_Waxwing,43,98,262,490,152,294,219,392
../../CUB_200_2011/images\186.Cedar_Waxwing/Cedar_Waxwing_0083_178743.jpg,500,500,186.Cedar_Waxwing,105,61,457,457,281,259,352,396
../../CUB_200_2011/images\186.Cedar_Waxwing/Cedar_Waxwing_0118_178779.jpg,500,334,186.Cedar_Waxwing,87,89,231,312,159,200,144,223
../../CUB_200_2011/images\186.Cedar_Waxwing/Cedar_Waxwing_0062_178788.jpg,480,500,186.Cedar_Waxwing,130,141,301,419,215,280,171,278
../../CUB_200_2011/images\186.Cedar_Waxwing/Cedar_Waxwing_0061_179305.jpg,317,500,186.Cedar_Waxwing,78,132,220,446,149,289,142,314
../../CUB_200_2011/images\186.Cedar_Waxwing/Cedar_Waxwing_0058_178795.jpg,500,392,186.Cedar_Waxwing,112,88,416,341,264,214,304,253
../../CUB_200_2011/images\186.Cedar_Waxwing/Cedar_Waxwing_0015_178818.jpg,328,500,186.Cedar_Waxwing,39,54,244,472,141,263,205,418
../../CUB_200_2011/images\186.Cedar_Waxwing/Cedar_Waxwing_0130_178308.jpg,496,500,186.Cedar_Waxwing,153,136,440,454,296,295,287,318
../../CUB_200_2011/images\186.Cedar_Waxwing/Cedar_Waxwing_0057_178370.jpg,500,363,186.Cedar_Waxwing,84,83,367,224,225,153,283,141
../../CUB_200_2011/images\186.Cedar_Waxwing/Cedar_Waxwing_0013_178830.jpg,398,500,186.Cedar_Waxwing,95,83,340,407,217,245,245,324
../../CUB_200_2011/images\186.Cedar_Waxwing/Cedar_Waxwing_0043_178321.jpg,476,500,186.Cedar_Waxwing,169,104,383,420,276,262,214,316
../../CUB_200_2011/images\186.Cedar_Waxwing/Cedar_Waxwing_0069_179310.jpg,500,399,186.Cedar_Waxwing,165,53,361,363,263,208,196,310
../../CUB_200_2011/images\186.Cedar_Waxwing/Cedar_Waxwing_0124_178857.jpg,391,500,186.Cedar_Waxwing,107,103,281,444,194,273,174,341
../../CUB_200_2011/images\186.Cedar_Waxwing/Cedar_Waxwing_0026_178878.jpg,500,364,186.Cedar_Waxwing,304,107,410,273,357,190,106,166
../../CUB_200_2011/images\186.Cedar_Waxwing/Cedar_Waxwing_0042_179391.jpg,333,500,186.Cedar_Waxwing,104,57,254,372,179,214,150,315
../../CUB_200_2011/images\186.Cedar_Waxwing/Cedar_Waxwing_0006_179394.jpg,400,500,186.Cedar_Waxwing,98,49,373,467,235,258,275,418
../../CUB_200_2011/images\186.Cedar_Waxwing/Cedar_Waxwing_0074_178888.jpg,333,500,186.Cedar_Waxwing,85,114,257,405,171,259,172,291
../../CUB_200_2011/images\186.Cedar_Waxwing/Cedar_Waxwing_0010_178891.jpg,333,500,186.Cedar_Waxwing,116,176,250,308,183,242,134,132
../../CUB_200_2011/images\186.Cedar_Waxwing/Cedar_Waxwing_0053_178892.jpg,333,500,186.Cedar_Waxwing,44,136,247,469,145,302,203,333
../../CUB_200_2011/images\186.Cedar_Waxwing/Cedar_Waxwing_0051_178385.jpg,333,500,186.Cedar_Waxwing,40,14,308,484,174,249,268,470
../../CUB_200_2011/images\186.Cedar_Waxwing/Cedar_Waxwing_0125_178921.jpg,500,402,186.Cedar_Waxwing,204,113,318,319,261,216,114,206
../../CUB_200_2011/images\186.Cedar_Waxwing/Cedar_Waxwing_0031_178929.jpg,500,375,186.Cedar_Waxwing,160,123,306,263,233,193,146,140
../../CUB_200_2011/images\186.Cedar_Waxwing/Cedar_Waxwing_0048_178960.jpg,500,358,186.Cedar_Waxwing,111,31,273,301,192,166,162,270
../../CUB_200_2011/images\186.Cedar_Waxwing/Cedar_Waxwing_0098_178971.jpg,500,375,186.Cedar_Waxwing,201,52,382,360,291,206,181,308
../../CUB_200_2011/images\186.Cedar_Waxwing/Cedar_Waxwing_0019_178654.jpg,500,408,186.Cedar_Waxwing,58,85,350,353,204,219,292,268
../../CUB_200_2011/images\186.Cedar_Waxwing/Cedar_Waxwing_0072_178058.jpg,357,500,186.Cedar_Waxwing,142,137,351,481,246,309,209,344
../../CUB_200_2011/images\186.Cedar_Waxwing/Cedar_Waxwing_0070_179007.jpg,337,500,186.Cedar_Waxwing,125,113,233,380,179,246,108,267
../../CUB_200_2011/images\186.Cedar_Waxwing/Cedar_Waxwing_0059_178500.jpg,500,388,186.Cedar_Waxwing,205,87,353,280,279,183,148,193
../../CUB_200_2011/images\186.Cedar_Waxwing/Cedar_Waxwing_0065_179017.jpg,399,500,186.Cedar_Waxwing,105,58,314,442,209,250,209,384
../../CUB_200_2011/images\186.Cedar_Waxwing/Cedar_Waxwing_0103_179559.jpg,500,375,186.Cedar_Waxwing,161,73,276,226,218,149,115,153
../../CUB_200_2011/images\186.Cedar_Waxwing/Cedar_Waxwing_0029_179569.jpg,339,500,186.Cedar_Waxwing,32,55,284,480,158,267,252,425
../../CUB_200_2011/images\186.Cedar_Waxwing/Cedar_Waxwing_0002_179071.jpg,500,400,186.Cedar_Waxwing,261,161,459,316,360,238,198,155
../../CUB_200_2011/images\186.Cedar_Waxwing/Cedar_Waxwing_0094_178049.jpg,500,370,186.Cedar_Waxwing,70,52,364,359,217,205,294,307
../../CUB_200_2011/images\186.Cedar_Waxwing/Cedar_Waxwing_0003_178570.jpg,500,333,186.Cedar_Waxwing,134,43,392,317,263,180,258,274
../../CUB_200_2011/images\186.Cedar_Waxwing/Cedar_Waxwing_0107_179098.jpg,283,500,186.Cedar_Waxwing,34,100,227,412,130,256,193,312
../../CUB_200_2011/images\186.Cedar_Waxwing/Cedar_Waxwing_0004_179215.jpg,400,500,186.Cedar_Waxwing,7,61,272,457,139,259,265,396
../../CUB_200_2011/images\186.Cedar_Waxwing/Cedar_Waxwing_0075_179114.jpg,388,500,186.Cedar_Waxwing,208,190,353,413,280,301,145,223
../../CUB_200_2011/images\186.Cedar_Waxwing/Cedar_Waxwing_0092_179123.jpg,500,399,186.Cedar_Waxwing,283,68,429,349,356,208,146,281
../../CUB_200_2011/images\186.Cedar_Waxwing/Cedar_Waxwing_0113_178627.jpg,398,500,186.Cedar_Waxwing,92,103,369,412,230,257,277,309
../../CUB_200_2011/images\186.Cedar_Waxwing/Cedar_Waxwing_0016_178629.jpg,500,376,186.Cedar_Waxwing,152,58,335,328,243,193,183,270
../../CUB_200_2011/images\186.Cedar_Waxwing/Cedar_Waxwing_0011_179149.jpg,413,500,186.Cedar_Waxwing,59,51,392,473,225,262,333,422
../../CUB_200_2011/images\186.Cedar_Waxwing/Cedar_Waxwing_0100_178643.jpg,500,333,186.Cedar_Waxwing,9,13,378,285,193,149,369,272
../../CUB_200_2011/images\186.Cedar_Waxwing/Cedar_Waxwing_0093_178139.jpg,500,331,186.Cedar_Waxwing,182,37,306,280,244,158,124,243
../../CUB_200_2011/images\186.Cedar_Waxwing/Cedar_Waxwing_0054_178141.jpg,500,334,186.Cedar_Waxwing,199,111,326,332,262,221,127,221
../../CUB_200_2011/images\186.Cedar_Waxwing/Cedar_Waxwing_0001_179170.jpg,483,500,186.Cedar_Waxwing,143,92,366,363,254,227,223,271
../../CUB_200_2011/images\186.Cedar_Waxwing/Cedar_Waxwing_0041_179183.jpg,500,329,186.Cedar_Waxwing,106,50,367,257,236,153,261,207
../../CUB_200_2011/images\186.Cedar_Waxwing/Cedar_Waxwing_0095_178163.jpg,500,333,186.Cedar_Waxwing,48,43,303,315,175,179,255,272
../../CUB_200_2011/images\186.Cedar_Waxwing/Cedar_Waxwing_0096_178164.jpg,377,500,186.Cedar_Waxwing,135,100,302,391,218,245,167,291
../../CUB_200_2011/images\186.Cedar_Waxwing/Cedar_Waxwing_0008_178345.jpg,500,383,186.Cedar_Waxwing,216,104,404,315,310,209,188,211
../../CUB_200_2011/images\186.Cedar_Waxwing/Cedar_Waxwing_0101_179707.jpg,367,500,186.Cedar_Waxwing,110,67,293,451,201,259,183,384
../../CUB_200_2011/images\186.Cedar_Waxwing/Cedar_Waxwing_0037_179710.jpg,357,500,186.Cedar_Waxwing,62,223,176,450,119,336,114,227
../../CUB_200_2011/images\187.American_Three_toed_Woodpecker/American_Three_Toed_Woodpecker_0048_796163.jpg,500,412,187.American_Three_toed_Woodpecker,101,20,419,410,260,215,318,390
../../CUB_200_2011/images\187.American_Three_toed_Woodpecker/American_Three_Toed_Woodpecker_0034_796165.jpg,430,500,187.American_Three_toed_Woodpecker,101,90,315,483,208,286,214,393
../../CUB_200_2011/images\187.American_Three_toed_Woodpecker/American_Three_Toed_Woodpecker_0037_796166.jpg,350,350,187.American_Three_toed_Woodpecker,77,45,277,339,177,192,200,294
../../CUB_200_2011/images\187.American_Three_toed_Woodpecker/American_Three_Toed_Woodpecker_0011_179847.jpg,333,500,187.American_Three_toed_Woodpecker,24,82,151,306,87,194,127,224
../../CUB_200_2011/images\187.American_Three_toed_Woodpecker/American_Three_Toed_Woodpecker_0039_796168.jpg,300,367,187.American_Three_toed_Woodpecker,35,25,259,364,147,194,224,339
../../CUB_200_2011/images\187.American_Three_toed_Woodpecker/American_Three_Toed_Woodpecker_0033_796169.jpg,375,500,187.American_Three_toed_Woodpecker,128,62,326,469,227,265,198,407
../../CUB_200_2011/images\187.American_Three_toed_Woodpecker/American_Three_Toed_Woodpecker_0008_179850.jpg,500,451,187.American_Three_toed_Woodpecker,208,104,343,404,275,254,135,300
../../CUB_200_2011/images\187.American_Three_toed_Woodpecker/American_Three_Toed_Woodpecker_0031_796172.jpg,344,500,187.American_Three_toed_Woodpecker,95,71,304,446,199,258,209,375
../../CUB_200_2011/images\187.American_Three_toed_Woodpecker/American_Three_Toed_Woodpecker_0028_796175.jpg,280,399,187.American_Three_toed_Woodpecker,23,108,179,394,101,251,156,286
../../CUB_200_2011/images\187.American_Three_toed_Woodpecker/American_Three_Toed_Woodpecker_0040_796180.jpg,275,385,187.American_Three_toed_Woodpecker,92,102,226,376,159,239,134,274
../../CUB_200_2011/images\187.American_Three_toed_Woodpecker/American_Three_Toed_Woodpecker_0038_796182.jpg,375,500,187.American_Three_toed_Woodpecker,84,100,291,460,187,280,207,360
../../CUB_200_2011/images\187.American_Three_toed_Woodpecker/American_Three_Toed_Woodpecker_0047_796185.jpg,403,500,187.American_Three_toed_Woodpecker,119,40,335,487,227,263,216,447
../../CUB_200_2011/images\187.American_Three_toed_Woodpecker/American_Three_Toed_Woodpecker_0050_796186.jpg,375,500,187.American_Three_toed_Woodpecker,179,109,333,421,256,265,154,312
../../CUB_200_2011/images\187.American_Three_toed_Woodpecker/American_Three_Toed_Woodpecker_0043_796187.jpg,468,327,187.American_Three_toed_Woodpecker,160,15,369,312,264,163,209,297
../../CUB_200_2011/images\187.American_Three_toed_Woodpecker/American_Three_Toed_Woodpecker_0019_179870.jpg,333,500,187.American_Three_toed_Woodpecker,114,191,301,377,207,284,187,186
../../CUB_200_2011/images\187.American_Three_toed_Woodpecker/American_Three_Toed_Woodpecker_0049_796191.jpg,500,375,187.American_Three_toed_Woodpecker,168,36,362,369,265,202,194,333
../../CUB_200_2011/images\187.American_Three_toed_Woodpecker/American_Three_Toed_Woodpecker_0010_179874.jpg,357,500,187.American_Three_toed_Woodpecker,142,61,298,299,220,180,156,238
../../CUB_200_2011/images\187.American_Three_toed_Woodpecker/American_Three_Toed_Woodpecker_0024_179876.jpg,500,401,187.American_Three_toed_Woodpecker,159,63,353,357,256,210,194,294
../../CUB_200_2011/images\187.American_Three_toed_Woodpecker/American_Three_Toed_Woodpecker_0013_179833.jpg,363,500,187.American_Three_toed_Woodpecker,48,40,234,462,141,251,186,422
../../CUB_200_2011/images\187.American_Three_toed_Woodpecker/American_Three_Toed_Woodpecker_0014_179882.jpg,500,500,187.American_Three_toed_Woodpecker,180,98,322,458,251,278,142,360
../../CUB_200_2011/images\187.American_Three_toed_Woodpecker/American_Three_Toed_Woodpecker_0002_179885.jpg,400,500,187.American_Three_toed_Woodpecker,111,97,267,405,189,251,156,308
../../CUB_200_2011/images\187.American_Three_toed_Woodpecker/American_Three_Toed_Woodpecker_0015_179827.jpg,438,470,187.American_Three_toed_Woodpecker,78,114,211,330,144,222,133,216
../../CUB_200_2011/images\187.American_Three_toed_Woodpecker/American_Three_Toed_Woodpecker_0003_179891.jpg,328,500,187.American_Three_toed_Woodpecker,67,96,211,435,139,265,144,339
../../CUB_200_2011/images\187.American_Three_toed_Woodpecker/American_Three_Toed_Woodpecker_0020_179828.jpg,411,323,187.American_Three_toed_Woodpecker,52,10,369,321,210,165,317,311
../../CUB_200_2011/images\187.American_Three_toed_Woodpecker/American_Three_Toed_Woodpecker_0032_796170.jpg,420,500,187.American_Three_toed_Woodpecker,119,54,407,474,263,264,288,420
../../CUB_200_2011/images\187.American_Three_toed_Woodpecker/American_Three_Toed_Woodpecker_0005_179902.jpg,500,373,187.American_Three_toed_Woodpecker,180,81,284,291,232,186,104,210
../../CUB_200_2011/images\187.American_Three_toed_Woodpecker/American_Three_Toed_Woodpecker_0012_179905.jpg,416,500,187.American_Three_toed_Woodpecker,117,96,235,450,176,273,118,354
../../CUB_200_2011/images\187.American_Three_toed_Woodpecker/American_Three_Toed_Woodpecker_0004_179908.jpg,500,375,187.American_Three_toed_Woodpecker,189,39,379,374,284,206,190,335
../../CUB_200_2011/images\187.American_Three_toed_Woodpecker/American_Three_Toed_Woodpecker_0023_179909.jpg,500,332,187.American_Three_toed_Woodpecker,72,75,403,297,237,186,331,222
../../CUB_200_2011/images\187.American_Three_toed_Woodpecker/American_Three_Toed_Woodpecker_0001_179912.jpg,500,400,187.American_Three_toed_Woodpecker,140,20,338,381,239,200,198,361
../../CUB_200_2011/images\187.American_Three_toed_Woodpecker/American_Three_Toed_Woodpecker_0018_179831.jpg,500,333,187.American_Three_toed_Woodpecker,142,72,267,304,204,188,125,232
../../CUB_200_2011/images\187.American_Three_toed_Woodpecker/American_Three_Toed_Woodpecker_0017_179830.jpg,333,500,187.American_Three_toed_Woodpecker,144,112,290,440,217,276,146,328
../../CUB_200_2011/images\187.American_Three_toed_Woodpecker/American_Three_Toed_Woodpecker_0025_179918.jpg,345,432,187.American_Three_toed_Woodpecker,66,38,231,421,148,229,165,383
../../CUB_200_2011/images\187.American_Three_toed_Woodpecker/American_Three_Toed_Woodpecker_0009_179919.jpg,397,500,187.American_Three_toed_Woodpecker,66,35,328,467,197,251,262,432
../../CUB_200_2011/images\187.American_Three_toed_Woodpecker/American_Three_Toed_Woodpecker_0016_179927.jpg,500,335,187.American_Three_toed_Woodpecker,218,80,392,299,305,189,174,219
../../CUB_200_2011/images\187.American_Three_toed_Woodpecker/American_Three_Toed_Woodpecker_0007_179932.jpg,333,500,187.American_Three_toed_Woodpecker,85,94,280,494,182,294,195,400
../../CUB_200_2011/images\187.American_Three_toed_Woodpecker/American_Three_Toed_Woodpecker_0022_179933.jpg,390,500,187.American_Three_toed_Woodpecker,103,162,265,319,184,240,162,157
../../CUB_200_2011/images\187.American_Three_toed_Woodpecker/American_Three_Toed_Woodpecker_0006_179838.jpg,341,500,187.American_Three_toed_Woodpecker,107,134,267,398,187,266,160,264
../../CUB_200_2011/images\187.American_Three_toed_Woodpecker/American_Three_Toed_Woodpecker_0029_796143.jpg,375,500,187.American_Three_toed_Woodpecker,67,136,306,447,186,291,239,311
../../CUB_200_2011/images\187.American_Three_toed_Woodpecker/American_Three_Toed_Woodpecker_0030_796144.jpg,410,500,187.American_Three_toed_Woodpecker,49,34,322,481,185,257,273,447
../../CUB_200_2011/images\187.American_Three_toed_Woodpecker/American_Three_Toed_Woodpecker_0036_796146.jpg,300,314,187.American_Three_toed_Woodpecker,50,16,261,294,155,155,211,278
../../CUB_200_2011/images\187.American_Three_toed_Woodpecker/American_Three_Toed_Woodpecker_0027_796147.jpg,230,327,187.American_Three_toed_Woodpecker,57,50,192,322,124,186,135,272
../../CUB_200_2011/images\187.American_Three_toed_Woodpecker/American_Three_Toed_Woodpecker_0045_796148.jpg,374,500,187.American_Three_toed_Woodpecker,45,35,324,498,184,266,279,463
../../CUB_200_2011/images\187.American_Three_toed_Woodpecker/American_Three_Toed_Woodpecker_0042_796149.jpg,333,500,187.American_Three_toed_Woodpecker,121,106,283,491,202,298,162,385
../../CUB_200_2011/images\187.American_Three_toed_Woodpecker/American_Three_Toed_Woodpecker_0041_796150.jpg,393,500,187.American_Three_toed_Woodpecker,46,17,327,498,186,257,281,481
../../CUB_200_2011/images\187.American_Three_toed_Woodpecker/American_Three_Toed_Woodpecker_0044_796151.jpg,468,342,187.American_Three_toed_Woodpecker,143,8,285,340,214,174,142,332
../../CUB_200_2011/images\187.American_Three_toed_Woodpecker/American_Three_Toed_Woodpecker_0021_179832.jpg,500,139,187.American_Three_toed_Woodpecker,197,36,355,138,276,87,158,102
../../CUB_200_2011/images\187.American_Three_toed_Woodpecker/American_Three_Toed_Woodpecker_0046_796153.jpg,422,500,187.American_Three_toed_Woodpecker,10,83,311,492,160,287,301,409
../../CUB_200_2011/images\187.American_Three_toed_Woodpecker/American_Three_Toed_Woodpecker_0026_796157.jpg,376,500,187.American_Three_toed_Woodpecker,138,104,319,389,228,246,181,285
../../CUB_200_2011/images\187.American_Three_toed_Woodpecker/American_Three_Toed_Woodpecker_0035_796158.jpg,300,400,187.American_Three_toed_Woodpecker,31,90,244,387,137,238,213,297
../../CUB_200_2011/images\188.Pileated_Woodpecker/Pileated_Woodpecker_0075_180480.jpg,500,360,188.Pileated_Woodpecker,109,102,225,351,167,226,116,249
../../CUB_200_2011/images\188.Pileated_Woodpecker/Pileated_Woodpecker_0125_179971.jpg,465,500,188.Pileated_Woodpecker,127,95,295,416,211,255,168,321
../../CUB_200_2011/images\188.Pileated_Woodpecker/Pileated_Woodpecker_0119_180030.jpg,400,500,188.Pileated_Woodpecker,133,104,281,435,207,269,148,331
../../CUB_200_2011/images\188.Pileated_Woodpecker/Pileated_Woodpecker_0089_179969.jpg,500,375,188.Pileated_Woodpecker,127,35,436,373,281,204,309,338
../../CUB_200_2011/images\188.Pileated_Woodpecker/Pileated_Woodpecker_0012_179976.jpg,500,500,188.Pileated_Woodpecker,69,83,255,409,162,246,186,326
../../CUB_200_2011/images\188.Pileated_Woodpecker/Pileated_Woodpecker_0013_180746.jpg,500,432,188.Pileated_Woodpecker,126,107,381,343,253,225,255,236
../../CUB_200_2011/images\188.Pileated_Woodpecker/Pileated_Woodpecker_0078_180236.jpg,500,333,188.Pileated_Woodpecker,231,100,355,306,293,203,124,206
../../CUB_200_2011/images\188.Pileated_Woodpecker/Pileated_Woodpecker_0105_180246.jpg,500,375,188.Pileated_Woodpecker,142,98,277,334,209,216,135,236
../../CUB_200_2011/images\188.Pileated_Woodpecker/Pileated_Woodpecker_0081_180249.jpg,455,500,188.Pileated_Woodpecker,129,121,384,416,256,268,255,295
../../CUB_200_2011/images\188.Pileated_Woodpecker/Pileated_Woodpecker_0025_180253.jpg,500,333,188.Pileated_Woodpecker,160,183,316,318,238,250,156,135
../../CUB_200_2011/images\188.Pileated_Woodpecker/Pileated_Woodpecker_0028_180258.jpg,500,400,188.Pileated_Woodpecker,239,110,383,382,311,246,144,272
../../CUB_200_2011/images\188.Pileated_Woodpecker/Pileated_Woodpecker_0072_180006.jpg,366,500,188.Pileated_Woodpecker,111,44,326,436,218,240,215,392
../../CUB_200_2011/images\188.Pileated_Woodpecker/Pileated_Woodpecker_0011_180519.jpg,406,500,188.Pileated_Woodpecker,95,180,227,435,161,307,132,255
../../CUB_200_2011/images\188.Pileated_Woodpecker/Pileated_Woodpecker_0110_180521.jpg,400,500,188.Pileated_Woodpecker,47,99,226,454,136,276,179,355
../../CUB_200_2011/images\188.Pileated_Woodpecker/Pileated_Woodpecker_0082_180523.jpg,500,375,188.Pileated_Woodpecker,149,112,303,340,226,226,154,228
../../CUB_200_2011/images\188.Pileated_Woodpecker/Pileated_Woodpecker_0039_180012.jpg,336,500,188.Pileated_Woodpecker,95,144,275,380,185,262,180,236
../../CUB_200_2011/images\188.Pileated_Woodpecker/Pileated_Woodpecker_0002_180024.jpg,500,375,188.Pileated_Woodpecker,152,43,426,366,289,204,274,323
../../CUB_200_2011/images\188.Pileated_Woodpecker/Pileated_Woodpecker_0121_180026.jpg,436,500,188.Pileated_Woodpecker,116,150,240,367,178,258,124,217
../../CUB_200_2011/images\188.Pileated_Woodpecker/Pileated_Woodpecker_0077_180286.jpg,500,357,188.Pileated_Woodpecker,47,95,328,341,187,218,281,246
../../CUB_200_2011/images\188.Pileated_Woodpecker/Pileated_Woodpecker_0070_180034.jpg,357,500,188.Pileated_Woodpecker,65,120,208,482,136,301,143,362
../../CUB_200_2011/images\188.Pileated_Woodpecker/Pileated_Woodpecker_0067_179979.jpg,336,500,188.Pileated_Woodpecker,41,69,251,463,146,266,210,394
../../CUB_200_2011/images\188.Pileated_Woodpecker/Pileated_Woodpecker_0083_180038.jpg,333,500,188.Pileated_Woodpecker,108,121,217,405,162,263,109,284
../../CUB_200_2011/images\188.Pileated_Woodpecker/Pileated_Woodpecker_0038_180300.jpg,500,375,188.Pileated_Woodpecker,177,87,339,374,258,230,162,287
../../CUB_200_2011/images\188.Pileated_Woodpecker/Pileated_Woodpecker_0074_180306.jpg,400,500,188.Pileated_Woodpecker,60,191,211,484,135,337,151,293
../../CUB_200_2011/images\188.Pileated_Woodpecker/Pileated_Woodpecker_0004_180307.jpg,372,500,188.Pileated_Woodpecker,129,67,317,435,223,251,188,368
../../CUB_200_2011/images\188.Pileated_Woodpecker/Pileated_Woodpecker_0088_180054.jpg,399,500,188.Pileated_Woodpecker,172,147,307,367,239,257,135,220
../../CUB_200_2011/images\188.Pileated_Woodpecker/Pileated_Woodpecker_0065_180324.jpg,333,500,188.Pileated_Woodpecker,120,69,274,401,197,235,154,332
../../CUB_200_2011/images\188.Pileated_Woodpecker/Pileated_Woodpecker_0015_180072.jpg,350,500,188.Pileated_Woodpecker,60,226,197,441,128,333,137,215
../../CUB_200_2011/images\188.Pileated_Woodpecker/Pileated_Woodpecker_0123_180076.jpg,500,375,188.Pileated_Woodpecker,178,107,368,374,273,240,190,267
../../CUB_200_2011/images\188.Pileated_Woodpecker/Pileated_Woodpecker_0080_180589.jpg,500,375,188.Pileated_Woodpecker,43,146,317,262,180,204,274,116
../../CUB_200_2011/images\188.Pileated_Woodpecker/Pileated_Woodpecker_0091_180343.jpg,500,375,188.Pileated_Woodpecker,174,72,311,330,242,201,137,258
../../CUB_200_2011/images\188.Pileated_Woodpecker/Pileated_Woodpecker_0073_180345.jpg,500,365,188.Pileated_Woodpecker,238,104,342,275,290,189,104,171
../../CUB_200_2011/images\188.Pileated_Woodpecker/Pileated_Woodpecker_0032_180347.jpg,312,500,188.Pileated_Woodpecker,37,56,306,499,171,277,269,443
../../CUB_200_2011/images\188.Pileated_Woodpecker/Pileated_Woodpecker_0056_180094.jpg,500,355,188.Pileated_Woodpecker,169,62,334,304,251,183,165,242
../../CUB_200_2011/images\188.Pileated_Woodpecker/Pileated_Woodpecker_0009_180460.jpg,348,500,188.Pileated_Woodpecker,73,108,246,486,159,297,173,378
../../CUB_200_2011/images\188.Pileated_Woodpecker/Pileated_Woodpecker_0057_180612.jpg,333,500,188.Pileated_Woodpecker,51,87,198,369,124,228,147,282
../../CUB_200_2011/images\188.Pileated_Woodpecker/Pileated_Woodpecker_0093_180205.jpg,500,436,188.Pileated_Woodpecker,64,167,456,435,260,301,392,268
../../CUB_200_2011/images\188.Pileated_Woodpecker/Pileated_Woodpecker_0026_180078.jpg,500,314,188.Pileated_Woodpecker,52,68,423,249,237,158,371,181
../../CUB_200_2011/images\188.Pileated_Woodpecker/Pileated_Woodpecker_0079_180388.jpg,500,375,188.Pileated_Woodpecker,76,50,264,369,170,209,188,319
../../CUB_200_2011/images\188.Pileated_Woodpecker/Pileated_Woodpecker_0097_180392.jpg,500,500,188.Pileated_Woodpecker,84,65,291,456,187,260,207,391
../../CUB_200_2011/images\188.Pileated_Woodpecker/Pileated_Woodpecker_0118_180138.jpg,386,500,188.Pileated_Woodpecker,61,68,364,495,212,281,303,427
../../CUB_200_2011/images\188.Pileated_Woodpecker/Pileated_Woodpecker_0050_180398.jpg,481,500,188.Pileated_Woodpecker,71,60,302,474,186,267,231,414
../../CUB_200_2011/images\188.Pileated_Woodpecker/Pileated_Woodpecker_0008_180400.jpg,333,500,188.Pileated_Woodpecker,86,102,246,408,166,255,160,306
../../CUB_200_2011/images\188.Pileated_Woodpecker/Pileated_Woodpecker_0086_180096.jpg,500,347,188.Pileated_Woodpecker,102,63,265,340,183,201,163,277
../../CUB_200_2011/images\188.Pileated_Woodpecker/Pileated_Woodpecker_0034_180419.jpg,500,381,188.Pileated_Woodpecker,58,79,498,294,278,186,440,215
../../CUB_200_2011/images\188.Pileated_Woodpecker/Pileated_Woodpecker_0124_180168.jpg,500,333,188.Pileated_Woodpecker,138,32,332,330,235,181,194,298
../../CUB_200_2011/images\188.Pileated_Woodpecker/Pileated_Woodpecker_0098_180170.jpg,362,500,188.Pileated_Woodpecker,36,91,296,491,166,291,260,400
../../CUB_200_2011/images\188.Pileated_Woodpecker/Pileated_Woodpecker_0059_180177.jpg,491,500,188.Pileated_Woodpecker,105,81,393,499,249,290,288,418
../../CUB_200_2011/images\188.Pileated_Woodpecker/Pileated_Woodpecker_0033_180179.jpg,330,500,188.Pileated_Woodpecker,75,77,287,464,181,270,212,387
../../CUB_200_2011/images\188.Pileated_Woodpecker/Pileated_Woodpecker_0112_180439.jpg,500,375,188.Pileated_Woodpecker,118,76,309,355,213,215,191,279
../../CUB_200_2011/images\188.Pileated_Woodpecker/Pileated_Woodpecker_0060_180443.jpg,333,500,188.Pileated_Woodpecker,65,142,252,449,158,295,187,307
../../CUB_200_2011/images\188.Pileated_Woodpecker/Pileated_Woodpecker_0106_180446.jpg,500,333,188.Pileated_Woodpecker,187,76,351,318,269,197,164,242
../../CUB_200_2011/images\188.Pileated_Woodpecker/Pileated_Woodpecker_0114_180455.jpg,397,500,188.Pileated_Woodpecker,99,141,260,385,179,263,161,244
../../CUB_200_2011/images\188.Pileated_Woodpecker/Pileated_Woodpecker_0116_179948.jpg,500,477,188.Pileated_Woodpecker,162,70,464,441,313,255,302,371
../../CUB_200_2011/images\188.Pileated_Woodpecker/Pileated_Woodpecker_0041_180461.jpg,375,500,188.Pileated_Woodpecker,117,99,305,466,211,282,188,367
../../CUB_200_2011/images\188.Pileated_Woodpecker/Pileated_Woodpecker_0030_180208.jpg,500,444,188.Pileated_Woodpecker,103,56,404,381,253,218,301,325
../../CUB_200_2011/images\188.Pileated_Woodpecker/Pileated_Woodpecker_0027_179956.jpg,441,500,188.Pileated_Woodpecker,76,31,396,498,236,264,320,467
../../CUB_200_2011/images\188.Pileated_Woodpecker/Pileated_Woodpecker_0087_179959.jpg,382,500,188.Pileated_Woodpecker,125,79,323,467,224,273,198,388
../../CUB_200_2011/images\188.Pileated_Woodpecker/Pileated_Woodpecker_0053_179960.jpg,375,500,188.Pileated_Woodpecker,33,99,290,463,161,281,257,364
../../CUB_200_2011/images\188.Pileated_Woodpecker/Pileated_Woodpecker_0051_179965.jpg,400,500,188.Pileated_Woodpecker,51,82,291,450,171,266,240,368
../../CUB_200_2011/images\189.Red_bellied_Woodpecker/Red_Bellied_Woodpecker_0069_181248.jpg,500,432,189.Red_bellied_Woodpecker,128,83,396,431,262,257,268,348
../../CUB_200_2011/images\189.Red_bellied_Woodpecker/Red_Bellied_Woodpecker_0012_181765.jpg,400,500,189.Red_bellied_Woodpecker,146,214,321,451,233,332,175,237
../../CUB_200_2011/images\189.Red_bellied_Woodpecker/Red_Bellied_Woodpecker_0066_182253.jpg,500,333,189.Red_bellied_Woodpecker,85,59,336,262,210,160,251,203
../../CUB_200_2011/images\189.Red_bellied_Woodpecker/Red_Bellied_Woodpecker_0073_180994.jpg,450,500,189.Red_bellied_Woodpecker,93,62,339,471,216,266,246,409
../../CUB_200_2011/images\189.Red_bellied_Woodpecker/Red_Bellied_Woodpecker_0050_180751.jpg,500,500,189.Red_bellied_Woodpecker,22,120,413,478,217,299,391,358
../../CUB_200_2011/images\189.Red_bellied_Woodpecker/Red_Bellied_Woodpecker_0079_181010.jpg,500,418,189.Red_bellied_Woodpecker,10,40,456,400,233,220,446,360
../../CUB_200_2011/images\189.Red_bellied_Woodpecker/Red_Bellied_Woodpecker_0049_180755.jpg,343,500,189.Red_bellied_Woodpecker,58,60,231,490,144,275,173,430
../../CUB_200_2011/images\189.Red_bellied_Woodpecker/Red_Bellied_Woodpecker_0025_180756.jpg,361,500,189.Red_bellied_Woodpecker,42,101,265,427,153,264,223,326
../../CUB_200_2011/images\189.Red_bellied_Woodpecker/Red_Bellied_Woodpecker_0106_180757.jpg,500,431,189.Red_bellied_Woodpecker,92,58,291,390,191,224,199,332
../../CUB_200_2011/images\189.Red_bellied_Woodpecker/Red_Bellied_Woodpecker_0016_180760.jpg,500,400,189.Red_bellied_Woodpecker,182,69,348,315,265,192,166,246
../../CUB_200_2011/images\189.Red_bellied_Woodpecker/Red_Bellied_Woodpecker_0099_180766.jpg,333,500,189.Red_bellied_Woodpecker,59,23,261,489,160,256,202,466
../../CUB_200_2011/images\189.Red_bellied_Woodpecker/Red_Bellied_Woodpecker_0021_182303.jpg,317,500,189.Red_bellied_Woodpecker,96,198,270,449,183,323,174,251
../../CUB_200_2011/images\189.Red_bellied_Woodpecker/Red_Bellied_Woodpecker_0055_180768.jpg,500,393,189.Red_bellied_Woodpecker,195,153,401,358,298,255,206,205
../../CUB_200_2011/images\189.Red_bellied_Woodpecker/Red_Bellied_Woodpecker_0015_182320.jpg,333,500,189.Red_bellied_Woodpecker,3,73,236,376,119,224,233,303
../../CUB_200_2011/images\189.Red_bellied_Woodpecker/Red_Bellied_Woodpecker_0010_180772.jpg,500,332,189.Red_bellied_Woodpecker,124,66,357,319,240,192,233,253
../../CUB_200_2011/images\189.Red_bellied_Woodpecker/Red_Bellied_Woodpecker_0115_180775.jpg,500,234,189.Red_bellied_Woodpecker,145,55,385,186,265,120,240,131
../../CUB_200_2011/images\189.Red_bellied_Woodpecker/Red_Bellied_Woodpecker_0125_180780.jpg,500,481,189.Red_bellied_Woodpecker,236,155,369,439,302,297,133,284
../../CUB_200_2011/images\189.Red_bellied_Woodpecker/Red_Bellied_Woodpecker_0058_182317.jpg,333,500,189.Red_bellied_Woodpecker,36,113,294,454,165,283,258,341
../../CUB_200_2011/images\189.Red_bellied_Woodpecker/Red_Bellied_Woodpecker_0026_180783.jpg,357,500,189.Red_bellied_Woodpecker,138,56,295,499,216,277,157,443
../../CUB_200_2011/images\189.Red_bellied_Woodpecker/Red_Bellied_Woodpecker_0075_180788.jpg,500,400,189.Red_bellied_Woodpecker,80,44,283,388,181,216,203,344
../../CUB_200_2011/images\189.Red_bellied_Woodpecker/Red_Bellied_Woodpecker_0077_182334.jpg,356,500,189.Red_bellied_Woodpecker,25,43,277,499,151,271,252,456
../../CUB_200_2011/images\189.Red_bellied_Woodpecker/Red_Bellied_Woodpecker_0020_182335.jpg,375,500,189.Red_bellied_Woodpecker,79,82,263,493,171,287,184,411
../../CUB_200_2011/images\189.Red_bellied_Woodpecker/Red_Bellied_Woodpecker_0081_182336.jpg,400,500,189.Red_bellied_Woodpecker,127,81,305,476,216,278,178,395
../../CUB_200_2011/images\189.Red_bellied_Woodpecker/Red_Bellied_Woodpecker_0103_180803.jpg,357,500,189.Red_bellied_Woodpecker,20,124,335,403,177,263,315,279
../../CUB_200_2011/images\189.Red_bellied_Woodpecker/Red_Bellied_Woodpecker_0028_181830.jpg,500,374,189.Red_bellied_Woodpecker,227,50,416,371,321,210,189,321
../../CUB_200_2011/images\189.Red_bellied_Woodpecker/Red_Bellied_Woodpecker_0039_180814.jpg,373,480,189.Red_bellied_Woodpecker,158,235,352,416,255,325,194,181
../../CUB_200_2011/images\189.Red_bellied_Woodpecker/Red_Bellied_Woodpecker_0032_181587.jpg,500,360,189.Red_bellied_Woodpecker,182,77,290,256,236,166,108,179
../../CUB_200_2011/images\189.Red_bellied_Woodpecker/Red_Bellied_Woodpecker_0112_180827.jpg,393,500,189.Red_bellied_Woodpecker,175,107,314,439,244,273,139,332
../../CUB_200_2011/images\189.Red_bellied_Woodpecker/Red_Bellied_Woodpecker_0044_181122.jpg,500,404,189.Red_bellied_Woodpecker,65,56,359,395,212,225,294,339
../../CUB_200_2011/images\189.Red_bellied_Woodpecker/Red_Bellied_Woodpecker_0104_181616.jpg,500,375,189.Red_bellied_Woodpecker,157,146,270,302,213,224,113,156
../../CUB_200_2011/images\189.Red_bellied_Woodpecker/Red_Bellied_Woodpecker_0097_181363.jpg,500,425,189.Red_bellied_Woodpecker,107,84,383,345,245,214,276,261
../../CUB_200_2011/images\189.Red_bellied_Woodpecker/Red_Bellied_Woodpecker_0008_180858.jpg,400,500,189.Red_bellied_Woodpecker,143,44,306,448,224,246,163,404
../../CUB_200_2011/images\189.Red_bellied_Woodpecker/Red_Bellied_Woodpecker_0078_181887.jpg,500,375,189.Red_bellied_Woodpecker,111,25,357,355,234,190,246,330
../../CUB_200_2011/images\189.Red_bellied_Woodpecker/Red_Bellied_Woodpecker_0071_180866.jpg,500,375,189.Red_bellied_Woodpecker,238,182,462,309,350,245,224,127
../../CUB_200_2011/images\189.Red_bellied_Woodpecker/Red_Bellied_Woodpecker_0086_181891.jpg,500,333,189.Red_bellied_Woodpecker,145,30,408,323,276,176,263,293
../../CUB_200_2011/images\189.Red_bellied_Woodpecker/Red_Bellied_Woodpecker_0057_182154.jpg,500,375,189.Red_bellied_Woodpecker,163,63,296,346,229,204,133,283
../../CUB_200_2011/images\189.Red_bellied_Woodpecker/Red_Bellied_Woodpecker_0017_181131.jpg,500,332,189.Red_bellied_Woodpecker,26,126,246,290,136,208,220,164
../../CUB_200_2011/images\189.Red_bellied_Woodpecker/Red_Bellied_Woodpecker_0002_180879.jpg,354,500,189.Red_bellied_Woodpecker,87,27,335,492,211,259,248,465
../../CUB_200_2011/images\189.Red_bellied_Woodpecker/Red_Bellied_Woodpecker_0089_181907.jpg,500,333,189.Red_bellied_Woodpecker,150,83,409,284,279,183,259,201
../../CUB_200_2011/images\189.Red_bellied_Woodpecker/Red_Bellied_Woodpecker_0035_181913.jpg,500,500,189.Red_bellied_Woodpecker,85,75,462,476,273,275,377,401
../../CUB_200_2011/images\189.Red_bellied_Woodpecker/Red_Bellied_Woodpecker_0042_181062.jpg,500,476,189.Red_bellied_Woodpecker,240,166,401,441,320,303,161,275
../../CUB_200_2011/images\189.Red_bellied_Woodpecker/Red_Bellied_Woodpecker_0120_181420.jpg,500,375,189.Red_bellied_Woodpecker,136,44,312,373,224,208,176,329
../../CUB_200_2011/images\189.Red_bellied_Woodpecker/Red_Bellied_Woodpecker_0054_182031.jpg,393,500,189.Red_bellied_Woodpecker,78,119,239,434,158,276,161,315
../../CUB_200_2011/images\189.Red_bellied_Woodpecker/Red_Bellied_Woodpecker_0070_181182.jpg,466,500,189.Red_bellied_Woodpecker,117,136,358,426,237,281,241,290
../../CUB_200_2011/images\189.Red_bellied_Woodpecker/Red_Bellied_Woodpecker_0110_181188.jpg,399,500,189.Red_bellied_Woodpecker,59,87,336,437,197,262,277,350
../../CUB_200_2011/images\189.Red_bellied_Woodpecker/Red_Bellied_Woodpecker_0023_181958.jpg,500,375,189.Red_bellied_Woodpecker,98,88,319,374,208,231,221,286
../../CUB_200_2011/images\189.Red_bellied_Woodpecker/Red_Bellied_Woodpecker_0074_180936.jpg,500,364,189.Red_bellied_Woodpecker,61,65,499,330,280,197,438,265
../../CUB_200_2011/images\189.Red_bellied_Woodpecker/Red_Bellied_Woodpecker_0091_180938.jpg,500,453,189.Red_bellied_Woodpecker,127,44,394,449,260,246,267,405
../../CUB_200_2011/images\189.Red_bellied_Woodpecker/Red_Bellied_Woodpecker_0088_180941.jpg,500,375,189.Red_bellied_Woodpecker,27,60,466,334,246,197,439,274
../../CUB_200_2011/images\189.Red_bellied_Woodpecker/Red_Bellied_Woodpecker_0022_181969.jpg,500,357,189.Red_bellied_Woodpecker,245,72,354,344,299,208,109,272
../../CUB_200_2011/images\189.Red_bellied_Woodpecker/Red_Bellied_Woodpecker_0056_180946.jpg,500,396,189.Red_bellied_Woodpecker,104,97,454,383,279,240,350,286
../../CUB_200_2011/images\189.Red_bellied_Woodpecker/Red_Bellied_Woodpecker_0095_180948.jpg,400,500,189.Red_bellied_Woodpecker,11,98,264,458,137,278,253,360
../../CUB_200_2011/images\189.Red_bellied_Woodpecker/Red_Bellied_Woodpecker_0068_180949.jpg,421,500,189.Red_bellied_Woodpecker,49,32,302,461,175,246,253,429
../../CUB_200_2011/images\189.Red_bellied_Woodpecker/Red_Bellied_Woodpecker_0092_182235.jpg,251,500,189.Red_bellied_Woodpecker,25,44,218,439,121,241,193,395
../../CUB_200_2011/images\189.Red_bellied_Woodpecker/Red_Bellied_Woodpecker_0108_180956.jpg,500,333,189.Red_bellied_Woodpecker,219,34,393,304,306,169,174,270
../../CUB_200_2011/images\189.Red_bellied_Woodpecker/Red_Bellied_Woodpecker_0009_180961.jpg,500,459,189.Red_bellied_Woodpecker,248,68,378,321,313,194,130,253
../../CUB_200_2011/images\189.Red_bellied_Woodpecker/Red_Bellied_Woodpecker_0007_182242.jpg,375,500,189.Red_bellied_Woodpecker,186,34,366,423,276,228,180,389
../../CUB_200_2011/images\189.Red_bellied_Woodpecker/Red_Bellied_Woodpecker_0114_181092.jpg,330,500,189.Red_bellied_Woodpecker,44,74,286,435,165,254,242,361
../../CUB_200_2011/images\189.Red_bellied_Woodpecker/Red_Bellied_Woodpecker_0031_180975.jpg,413,500,189.Red_bellied_Woodpecker,7,118,352,487,179,302,345,369
../../CUB_200_2011/images\189.Red_bellied_Woodpecker/Red_Bellied_Woodpecker_0123_182116.jpg,388,500,189.Red_bellied_Woodpecker,68,200,228,418,148,309,160,218
../../CUB_200_2011/images\190.Red_cockaded_Woodpecker/Red_Cockaded_Woodpecker_0052_794752.jpg,500,396,190.Red_cockaded_Woodpecker,276,87,419,371,347,229,143,284
../../CUB_200_2011/images\190.Red_cockaded_Woodpecker/Red_Cockaded_Woodpecker_0008_794753.jpg,250,391,190.Red_cockaded_Woodpecker,60,45,188,378,124,211,128,333
../../CUB_200_2011/images\190.Red_cockaded_Woodpecker/Red_Cockaded_Woodpecker_0007_794755.jpg,178,179,190.Red_cockaded_Woodpecker,52,16,158,176,105,96,106,160
../../CUB_200_2011/images\190.Red_cockaded_Woodpecker/Red_Cockaded_Woodpecker_0028_182395.jpg,500,338,190.Red_cockaded_Woodpecker,228,69,328,276,278,172,100,207
../../CUB_200_2011/images\190.Red_cockaded_Woodpecker/Red_Cockaded_Woodpecker_0041_182408.jpg,391,500,190.Red_cockaded_Woodpecker,93,119,272,409,182,264,179,290
../../CUB_200_2011/images\190.Red_cockaded_Woodpecker/Red_Cockaded_Woodpecker_0009_182540.jpg,341,500,190.Red_cockaded_Woodpecker,91,147,290,464,190,305,199,317
../../CUB_200_2011/images\190.Red_cockaded_Woodpecker/Red_Cockaded_Woodpecker_0001_182541.jpg,500,375,190.Red_cockaded_Woodpecker,154,94,269,345,211,219,115,251
../../CUB_200_2011/images\190.Red_cockaded_Woodpecker/Red_Cockaded_Woodpecker_0020_182683.jpg,375,500,190.Red_cockaded_Woodpecker,169,175,277,449,223,312,108,274
../../CUB_200_2011/images\190.Red_cockaded_Woodpecker/Red_Cockaded_Woodpecker_0042_182373.jpg,333,500,190.Red_cockaded_Woodpecker,114,191,228,415,171,303,114,224
../../CUB_200_2011/images\190.Red_cockaded_Woodpecker/Red_Cockaded_Woodpecker_0035_182435.jpg,500,333,190.Red_cockaded_Woodpecker,240,101,350,277,295,189,110,176
../../CUB_200_2011/images\190.Red_cockaded_Woodpecker/Red_Cockaded_Woodpecker_0048_182599.jpg,334,500,190.Red_cockaded_Woodpecker,154,151,283,432,218,291,129,281
../../CUB_200_2011/images\190.Red_cockaded_Woodpecker/Red_Cockaded_Woodpecker_0010_182451.jpg,333,500,190.Red_cockaded_Woodpecker,111,74,290,434,200,254,179,360
../../CUB_200_2011/images\190.Red_cockaded_Woodpecker/Red_Cockaded_Woodpecker_0049_182452.jpg,375,500,190.Red_cockaded_Woodpecker,158,136,321,419,239,277,163,283
../../CUB_200_2011/images\190.Red_cockaded_Woodpecker/Red_Cockaded_Woodpecker_0061_794728.jpg,500,333,190.Red_cockaded_Woodpecker,130,30,274,286,202,158,144,256
../../CUB_200_2011/images\190.Red_cockaded_Woodpecker/Red_Cockaded_Woodpecker_0015_182459.jpg,500,366,190.Red_cockaded_Woodpecker,200,53,333,300,266,176,133,247
../../CUB_200_2011/images\190.Red_cockaded_Woodpecker/Red_Cockaded_Woodpecker_0036_182519.jpg,333,500,190.Red_cockaded_Woodpecker,72,26,319,498,195,262,247,472
../../CUB_200_2011/images\190.Red_cockaded_Woodpecker/Red_Cockaded_Woodpecker_0006_182592.jpg,500,363,190.Red_cockaded_Woodpecker,296,93,446,362,371,227,150,269
../../CUB_200_2011/images\190.Red_cockaded_Woodpecker/Red_Cockaded_Woodpecker_0040_182502.jpg,333,500,190.Red_cockaded_Woodpecker,130,131,242,427,186,279,112,296
../../CUB_200_2011/images\190.Red_cockaded_Woodpecker/Red_Cockaded_Woodpecker_0051_182347.jpg,383,500,190.Red_cockaded_Woodpecker,135,47,281,493,208,270,146,446
../../CUB_200_2011/images\190.Red_cockaded_Woodpecker/Red_Cockaded_Woodpecker_0004_182340.jpg,500,396,190.Red_cockaded_Woodpecker,172,97,314,342,243,219,142,245
../../CUB_200_2011/images\190.Red_cockaded_Woodpecker/Red_Cockaded_Woodpecker_0003_794695.jpg,300,463,190.Red_cockaded_Woodpecker,90,139,191,372,140,255,101,233
../../CUB_200_2011/images\190.Red_cockaded_Woodpecker/Red_Cockaded_Woodpecker_0002_794696.jpg,350,330,190.Red_cockaded_Woodpecker,117,69,219,259,168,164,102,190
../../CUB_200_2011/images\190.Red_cockaded_Woodpecker/Red_Cockaded_Woodpecker_0012_794697.jpg,387,500,190.Red_cockaded_Woodpecker,67,71,167,351,117,211,100,280
../../CUB_200_2011/images\190.Red_cockaded_Woodpecker/Red_Cockaded_Woodpecker_0021_182647.jpg,324,500,190.Red_cockaded_Woodpecker,127,194,252,437,189,315,125,243
../../CUB_200_2011/images\190.Red_cockaded_Woodpecker/Red_Cockaded_Woodpecker_0022_794700.jpg,500,335,190.Red_cockaded_Woodpecker,277,87,456,276,366,181,179,189
../../CUB_200_2011/images\190.Red_cockaded_Woodpecker/Red_Cockaded_Woodpecker_0023_794701.jpg,396,500,190.Red_cockaded_Woodpecker,96,45,298,481,197,263,202,436
../../CUB_200_2011/images\190.Red_cockaded_Woodpecker/Red_Cockaded_Woodpecker_0018_794705.jpg,230,317,190.Red_cockaded_Woodpecker,41,62,163,296,102,179,122,234
../../CUB_200_2011/images\190.Red_cockaded_Woodpecker/Red_Cockaded_Woodpecker_0054_794699.jpg,296,444,190.Red_cockaded_Woodpecker,164,102,269,383,216,242,105,281
../../CUB_200_2011/images\190.Red_cockaded_Woodpecker/Red_Cockaded_Woodpecker_0053_794707.jpg,259,500,190.Red_cockaded_Woodpecker,37,72,205,481,121,276,168,409
../../CUB_200_2011/images\190.Red_cockaded_Woodpecker/Red_Cockaded_Woodpecker_0024_794708.jpg,200,150,190.Red_cockaded_Woodpecker,25,9,135,147,80,78,110,138
../../CUB_200_2011/images\190.Red_cockaded_Woodpecker/Red_Cockaded_Woodpecker_0059_794709.jpg,300,449,190.Red_cockaded_Woodpecker,73,114,206,385,139,249,133,271
../../CUB_200_2011/images\190.Red_cockaded_Woodpecker/Red_Cockaded_Woodpecker_0025_794710.jpg,357,500,190.Red_cockaded_Woodpecker,135,112,236,401,185,256,101,289
../../CUB_200_2011/images\190.Red_cockaded_Woodpecker/Red_Cockaded_Woodpecker_0030_794711.jpg,160,234,190.Red_cockaded_Woodpecker,20,26,142,233,81,129,122,207
../../CUB_200_2011/images\190.Red_cockaded_Woodpecker/Red_Cockaded_Woodpecker_0017_794712.jpg,344,412,190.Red_cockaded_Woodpecker,103,27,237,343,170,185,134,316
../../CUB_200_2011/images\190.Red_cockaded_Woodpecker/Red_Cockaded_Woodpecker_0027_794713.jpg,190,184,190.Red_cockaded_Woodpecker,24,25,170,148,97,86,146,123
../../CUB_200_2011/images\190.Red_cockaded_Woodpecker/Red_Cockaded_Woodpecker_0016_182493.jpg,500,332,190.Red_cockaded_Woodpecker,183,63,406,269,294,166,223,206
../../CUB_200_2011/images\190.Red_cockaded_Woodpecker/Red_Cockaded_Woodpecker_0014_794718.jpg,317,500,190.Red_cockaded_Woodpecker,19,3,313,499,166,251,294,496
../../CUB_200_2011/images\190.Red_cockaded_Woodpecker/Red_Cockaded_Woodpecker_0038_794719.jpg,334,500,190.Red_cockaded_Woodpecker,54,112,277,442,165,277,223,330
../../CUB_200_2011/images\190.Red_cockaded_Woodpecker/Red_Cockaded_Woodpecker_0034_794720.jpg,350,350,190.Red_cockaded_Woodpecker,130,45,239,312,184,178,109,267
../../CUB_200_2011/images\190.Red_cockaded_Woodpecker/Red_Cockaded_Woodpecker_0047_794704.jpg,333,500,190.Red_cockaded_Woodpecker,106,72,275,461,190,266,169,389
../../CUB_200_2011/images\190.Red_cockaded_Woodpecker/Red_Cockaded_Woodpecker_0046_794722.jpg,333,500,190.Red_cockaded_Woodpecker,150,188,277,422,213,305,127,234
../../CUB_200_2011/images\190.Red_cockaded_Woodpecker/Red_Cockaded_Woodpecker_0062_182371.jpg,355,500,190.Red_cockaded_Woodpecker,91,66,243,402,167,234,152,336
../../CUB_200_2011/images\190.Red_cockaded_Woodpecker/Red_Cockaded_Woodpecker_0029_794724.jpg,500,435,190.Red_cockaded_Woodpecker,245,102,453,232,349,167,208,130
../../CUB_200_2011/images\190.Red_cockaded_Woodpecker/Red_Cockaded_Woodpecker_0057_794725.jpg,300,483,190.Red_cockaded_Woodpecker,49,14,254,481,151,247,205,467
../../CUB_200_2011/images\190.Red_cockaded_Woodpecker/Red_Cockaded_Woodpecker_0044_182374.jpg,500,368,190.Red_cockaded_Woodpecker,121,96,242,299,181,197,121,203
../../CUB_200_2011/images\190.Red_cockaded_Woodpecker/Red_Cockaded_Woodpecker_0033_794721.jpg,400,344,190.Red_cockaded_Woodpecker,41,73,393,332,217,202,352,259
../../CUB_200_2011/images\190.Red_cockaded_Woodpecker/Red_Cockaded_Woodpecker_0032_182376.jpg,500,378,190.Red_cockaded_Woodpecker,131,95,308,369,219,232,177,274
../../CUB_200_2011/images\190.Red_cockaded_Woodpecker/Red_Cockaded_Woodpecker_0060_182377.jpg,333,500,190.Red_cockaded_Woodpecker,47,74,200,458,123,266,153,384
../../CUB_200_2011/images\190.Red_cockaded_Woodpecker/Red_Cockaded_Woodpecker_0045_794727.jpg,239,300,190.Red_cockaded_Woodpecker,54,102,162,272,108,187,108,170
../../CUB_200_2011/images\190.Red_cockaded_Woodpecker/Red_Cockaded_Woodpecker_0037_794733.jpg,326,500,190.Red_cockaded_Woodpecker,100,131,239,392,169,261,139,261
../../CUB_200_2011/images\190.Red_cockaded_Woodpecker/Red_Cockaded_Woodpecker_0056_794734.jpg,333,500,190.Red_cockaded_Woodpecker,39,101,232,485,135,293,193,384
../../CUB_200_2011/images\190.Red_cockaded_Woodpecker/Red_Cockaded_Woodpecker_0039_794736.jpg,500,357,190.Red_cockaded_Woodpecker,115,98,218,332,166,215,103,234
../../CUB_200_2011/images\190.Red_cockaded_Woodpecker/Red_Cockaded_Woodpecker_0031_794737.jpg,167,257,190.Red_cockaded_Woodpecker,18,41,130,256,74,148,112,215
../../CUB_200_2011/images\190.Red_cockaded_Woodpecker/Red_Cockaded_Woodpecker_0058_794739.jpg,255,427,190.Red_cockaded_Woodpecker,110,132,222,388,166,260,112,256
../../CUB_200_2011/images\190.Red_cockaded_Woodpecker/Red_Cockaded_Woodpecker_0013_794740.jpg,200,293,190.Red_cockaded_Woodpecker,36,29,151,258,93,143,115,229
../../CUB_200_2011/images\190.Red_cockaded_Woodpecker/Red_Cockaded_Woodpecker_0050_794743.jpg,250,374,190.Red_cockaded_Woodpecker,119,127,224,347,171,237,105,220
../../CUB_200_2011/images\190.Red_cockaded_Woodpecker/Red_Cockaded_Woodpecker_0055_182520.jpg,500,340,190.Red_cockaded_Woodpecker,228,91,334,228,281,159,106,137
../../CUB_200_2011/images\190.Red_cockaded_Woodpecker/Red_Cockaded_Woodpecker_0063_794726.jpg,400,500,190.Red_cockaded_Woodpecker,143,165,285,480,214,322,142,315
../../CUB_200_2011/images\191.Red_headed_Woodpecker/Red_Headed_Woodpecker_0073_182784.jpg,500,400,191.Red_headed_Woodpecker,75,72,362,269,218,170,287,197
../../CUB_200_2011/images\191.Red_headed_Woodpecker/Red_Headed_Woodpecker_0024_183297.jpg,500,333,191.Red_headed_Woodpecker,95,49,262,313,178,181,167,264
../../CUB_200_2011/images\191.Red_headed_Woodpecker/Red_Headed_Woodpecker_0092_182787.jpg,500,486,191.Red_headed_Woodpecker,138,51,414,434,276,242,276,383
../../CUB_200_2011/images\191.Red_headed_Woodpecker/Red_Headed_Woodpecker_0041_182788.jpg,500,358,191.Red_headed_Woodpecker,167,59,396,348,281,203,229,289
../../CUB_200_2011/images\191.Red_headed_Woodpecker/Red_Headed_Woodpecker_0087_183271.jpg,333,500,191.Red_headed_Woodpecker,72,81,272,473,172,277,200,392
../../CUB_200_2011/images\191.Red_headed_Woodpecker/Red_Headed_Woodpecker_0101_182538.jpg,424,500,191.Red_headed_Woodpecker,121,106,304,385,212,245,183,279
../../CUB_200_2011/images\191.Red_headed_Woodpecker/Red_Headed_Woodpecker_0011_182803.jpg,500,312,191.Red_headed_Woodpecker,151,100,316,224,233,162,165,124
../../CUB_200_2011/images\191.Red_headed_Woodpecker/Red_Headed_Woodpecker_0034_182806.jpg,376,500,191.Red_headed_Woodpecker,87,138,315,387,201,262,228,249
../../CUB_200_2011/images\191.Red_headed_Woodpecker/Red_Headed_Woodpecker_0066_183322.jpg,435,500,191.Red_headed_Woodpecker,18,35,312,419,165,227,294,384
../../CUB_200_2011/images\191.Red_headed_Woodpecker/Red_Headed_Woodpecker_0081_182811.jpg,500,352,191.Red_headed_Woodpecker,5,78,331,268,168,173,326,190
../../CUB_200_2011/images\191.Red_headed_Woodpecker/Red_Headed_Woodpecker_0029_183337.jpg,500,334,191.Red_headed_Woodpecker,59,50,414,303,236,176,355,253
../../CUB_200_2011/images\191.Red_headed_Woodpecker/Red_Headed_Woodpecker_0058_183086.jpg,500,433,191.Red_headed_Woodpecker,204,150,326,304,265,227,122,154
../../CUB_200_2011/images\191.Red_headed_Woodpecker/Red_Headed_Woodpecker_0045_182832.jpg,354,500,191.Red_headed_Woodpecker,0,81,334,441,167,261,334,360
../../CUB_200_2011/images\191.Red_headed_Woodpecker/Red_Headed_Woodpecker_0042_182834.jpg,335,500,191.Red_headed_Woodpecker,132,192,254,365,193,278,122,173
../../CUB_200_2011/images\191.Red_headed_Woodpecker/Red_Headed_Woodpecker_0031_183096.jpg,500,400,191.Red_headed_Woodpecker,36,153,374,342,205,247,338,189
../../CUB_200_2011/images\191.Red_headed_Woodpecker/Red_Headed_Woodpecker_0086_182715.jpg,500,359,191.Red_headed_Woodpecker,187,99,301,320,244,209,114,221
../../CUB_200_2011/images\191.Red_headed_Woodpecker/Red_Headed_Woodpecker_0063_183358.jpg,500,334,191.Red_headed_Woodpecker,151,15,308,333,229,174,157,318
../../CUB_200_2011/images\191.Red_headed_Woodpecker/Red_Headed_Woodpecker_0065_182863.jpg,334,500,191.Red_headed_Woodpecker,25,107,308,461,166,284,283,354
../../CUB_200_2011/images\191.Red_headed_Woodpecker/Red_Headed_Woodpecker_0006_183383.jpg,500,375,191.Red_headed_Woodpecker,160,30,400,373,280,201,240,343
../../CUB_200_2011/images\191.Red_headed_Woodpecker/Red_Headed_Woodpecker_0109_183385.jpg,484,500,191.Red_headed_Woodpecker,201,67,433,495,317,281,232,428
../../CUB_200_2011/images\191.Red_headed_Woodpecker/Red_Headed_Woodpecker_0071_183132.jpg,500,393,191.Red_headed_Woodpecker,171,82,469,261,320,171,298,179
../../CUB_200_2011/images\191.Red_headed_Woodpecker/Red_Headed_Woodpecker_0012_183395.jpg,391,480,191.Red_headed_Woodpecker,64,69,204,402,134,235,140,333
../../CUB_200_2011/images\191.Red_headed_Woodpecker/Red_Headed_Woodpecker_0044_183141.jpg,500,378,191.Red_headed_Woodpecker,85,87,301,251,193,169,216,164
../../CUB_200_2011/images\191.Red_headed_Woodpecker/Red_Headed_Woodpecker_0091_183144.jpg,399,500,191.Red_headed_Woodpecker,100,99,284,457,192,278,184,358
../../CUB_200_2011/images\191.Red_headed_Woodpecker/Red_Headed_Woodpecker_0094_183401.jpg,500,413,191.Red_headed_Woodpecker,156,41,356,352,256,196,200,311
../../CUB_200_2011/images\191.Red_headed_Woodpecker/Red_Headed_Woodpecker_0108_183403.jpg,333,500,191.Red_headed_Woodpecker,39,130,169,344,104,237,130,214
../../CUB_200_2011/images\191.Red_headed_Woodpecker/Red_Headed_Woodpecker_0068_183662.jpg,500,375,191.Red_headed_Woodpecker,111,105,227,243,169,174,116,138
../../CUB_200_2011/images\191.Red_headed_Woodpecker/Red_Headed_Woodpecker_0049_183229.jpg,357,500,191.Red_headed_Woodpecker,53,163,267,340,160,251,214,177
../../CUB_200_2011/images\191.Red_headed_Woodpecker/Red_Headed_Woodpecker_0103_183571.jpg,335,500,191.Red_headed_Woodpecker,64,130,201,459,132,294,137,329
../../CUB_200_2011/images\191.Red_headed_Woodpecker/Red_Headed_Woodpecker_0097_182903.jpg,370,500,191.Red_headed_Woodpecker,38,136,317,350,177,243,279,214
../../CUB_200_2011/images\191.Red_headed_Woodpecker/Red_Headed_Woodpecker_0078_183427.jpg,279,500,191.Red_headed_Woodpecker,53,70,233,462,143,266,180,392
../../CUB_200_2011/images\191.Red_headed_Woodpecker/Red_Headed_Woodpecker_0095_183688.jpg,500,421,191.Red_headed_Woodpecker,88,49,283,365,185,207,195,316
../../CUB_200_2011/images\191.Red_headed_Woodpecker/Red_Headed_Woodpecker_0089_183435.jpg,372,500,191.Red_headed_Woodpecker,108,84,264,476,186,280,156,392
../../CUB_200_2011/images\191.Red_headed_Woodpecker/Red_Headed_Woodpecker_0093_182925.jpg,381,500,191.Red_headed_Woodpecker,55,93,269,380,162,236,214,287
../../CUB_200_2011/images\191.Red_headed_Woodpecker/Red_Headed_Woodpecker_0014_183701.jpg,500,353,191.Red_headed_Woodpecker,216,45,358,321,287,183,142,276
../../CUB_200_2011/images\191.Red_headed_Woodpecker/Red_Headed_Woodpecker_0039_183446.jpg,500,332,191.Red_headed_Woodpecker,183,113,294,251,238,182,111,138
../../CUB_200_2011/images\191.Red_headed_Woodpecker/Red_Headed_Woodpecker_0021_183454.jpg,333,500,191.Red_headed_Woodpecker,40,124,194,404,117,264,154,280
../../CUB_200_2011/images\191.Red_headed_Woodpecker/Red_Headed_Woodpecker_0018_183455.jpg,500,350,191.Red_headed_Woodpecker,264,72,382,301,323,186,118,229
../../CUB_200_2011/images\191.Red_headed_Woodpecker/Red_Headed_Woodpecker_0020_183255.jpg,464,397,191.Red_headed_Woodpecker,196,53,408,211,302,132,212,158
../../CUB_200_2011/images\191.Red_headed_Woodpecker/Red_Headed_Woodpecker_0052_182702.jpg,500,375,191.Red_headed_Woodpecker,58,72,339,354,198,213,281,282
../../CUB_200_2011/images\191.Red_headed_Woodpecker/Red_Headed_Woodpecker_0067_183710.jpg,378,500,191.Red_headed_Woodpecker,32,57,260,499,146,278,228,442
../../CUB_200_2011/images\191.Red_headed_Woodpecker/Red_Headed_Woodpecker_0032_182815.jpg,500,375,191.Red_headed_Woodpecker,1,105,301,337,151,221,300,232
../../CUB_200_2011/images\191.Red_headed_Woodpecker/Red_Headed_Woodpecker_0013_182721.jpg,335,500,191.Red_headed_Woodpecker,71,41,290,470,180,255,219,429
../../CUB_200_2011/images\191.Red_headed_Woodpecker/Red_Headed_Woodpecker_0057_183234.jpg,500,334,191.Red_headed_Woodpecker,143,103,283,269,213,186,140,166
../../CUB_200_2011/images\191.Red_headed_Woodpecker/Red_Headed_Woodpecker_0051_182724.jpg,254,356,191.Red_headed_Woodpecker,46,71,197,324,121,197,151,253
../../CUB_200_2011/images\191.Red_headed_Woodpecker/Red_Headed_Woodpecker_0005_183414.jpg,386,500,191.Red_headed_Woodpecker,80,68,239,444,159,256,159,376
../../CUB_200_2011/images\191.Red_headed_Woodpecker/Red_Headed_Woodpecker_0007_182728.jpg,500,400,191.Red_headed_Woodpecker,115,101,326,324,220,212,211,223
../../CUB_200_2011/images\191.Red_headed_Woodpecker/Red_Headed_Woodpecker_0098_182732.jpg,500,357,191.Red_headed_Woodpecker,140,115,332,282,236,198,192,167
../../CUB_200_2011/images\191.Red_headed_Woodpecker/Red_Headed_Woodpecker_0088_183246.jpg,403,500,191.Red_headed_Woodpecker,114,118,328,348,221,233,214,230
../../CUB_200_2011/images\191.Red_headed_Woodpecker/Red_Headed_Woodpecker_0085_182703.jpg,500,332,191.Red_headed_Woodpecker,186,55,320,322,253,188,134,267
../../CUB_200_2011/images\191.Red_headed_Woodpecker/Red_Headed_Woodpecker_0055_183515.jpg,333,500,191.Red_headed_Woodpecker,101,156,267,373,184,264,166,217
../../CUB_200_2011/images\191.Red_headed_Woodpecker/Red_Headed_Woodpecker_0084_183004.jpg,500,418,191.Red_headed_Woodpecker,99,70,484,317,291,193,385,247
../../CUB_200_2011/images\191.Red_headed_Woodpecker/Red_Headed_Woodpecker_0016_183007.jpg,359,500,191.Red_headed_Woodpecker,61,207,211,425,136,316,150,218
../../CUB_200_2011/images\191.Red_headed_Woodpecker/Red_Headed_Woodpecker_0017_183777.jpg,437,500,191.Red_headed_Woodpecker,112,160,295,369,203,264,183,209
../../CUB_200_2011/images\191.Red_headed_Woodpecker/Red_Headed_Woodpecker_0022_183010.jpg,373,500,191.Red_headed_Woodpecker,117,154,348,434,232,294,231,280
../../CUB_200_2011/images\191.Red_headed_Woodpecker/Red_Headed_Woodpecker_0099_183524.jpg,445,500,191.Red_headed_Woodpecker,97,90,353,497,225,293,256,407
../../CUB_200_2011/images\191.Red_headed_Woodpecker/Red_Headed_Woodpecker_0038_183280.jpg,387,500,191.Red_headed_Woodpecker,5,151,253,370,129,260,248,219
../../CUB_200_2011/images\191.Red_headed_Woodpecker/Red_Headed_Woodpecker_0027_183029.jpg,335,500,191.Red_headed_Woodpecker,45,48,270,477,157,262,225,429
../../CUB_200_2011/images\191.Red_headed_Woodpecker/Red_Headed_Woodpecker_0076_183288.jpg,500,375,191.Red_headed_Woodpecker,86,35,345,374,215,204,259,339
../../CUB_200_2011/images\191.Red_headed_Woodpecker/Red_Headed_Woodpecker_0107_183290.jpg,406,500,191.Red_headed_Woodpecker,91,96,239,335,165,215,148,239
../../CUB_200_2011/images\192.Downy_Woodpecker/Downy_Woodpecker_0116_184326.jpg,500,333,192.Downy_Woodpecker,52,23,340,311,196,167,288,288
../../CUB_200_2011/images\192.Downy_Woodpecker/Downy_Woodpecker_0062_184343.jpg,335,500,192.Downy_Woodpecker,31,86,181,461,106,273,150,375
../../CUB_200_2011/images\192.Downy_Woodpecker/Downy_Woodpecker_0075_184346.jpg,500,500,192.Downy_Woodpecker,59,40,371,448,215,244,312,408
../../CUB_200_2011/images\192.Downy_Woodpecker/Downy_Woodpecker_0124_184364.jpg,464,500,192.Downy_Woodpecker,164,71,387,489,275,280,223,418
../../CUB_200_2011/images\192.Downy_Woodpecker/Downy_Woodpecker_0030_184368.jpg,400,500,192.Downy_Woodpecker,71,211,307,440,189,325,236,229
../../CUB_200_2011/images\192.Downy_Woodpecker/Downy_Woodpecker_0078_184375.jpg,500,333,192.Downy_Woodpecker,178,70,317,288,247,179,139,218
../../CUB_200_2011/images\192.Downy_Woodpecker/Downy_Woodpecker_0138_184385.jpg,400,500,192.Downy_Woodpecker,129,64,348,485,238,274,219,421
../../CUB_200_2011/images\192.Downy_Woodpecker/Downy_Woodpecker_0059_184396.jpg,465,500,192.Downy_Woodpecker,24,39,441,495,232,267,417,456
../../CUB_200_2011/images\192.Downy_Woodpecker/Downy_Woodpecker_0072_184401.jpg,364,500,192.Downy_Woodpecker,81,100,296,423,188,261,215,323
../../CUB_200_2011/images\192.Downy_Woodpecker/Downy_Woodpecker_0132_184408.jpg,500,374,192.Downy_Woodpecker,150,29,411,289,280,159,261,260
../../CUB_200_2011/images\192.Downy_Woodpecker/Downy_Woodpecker_0113_184413.jpg,381,500,192.Downy_Woodpecker,70,90,284,424,177,257,214,334
../../CUB_200_2011/images\192.Downy_Woodpecker/Downy_Woodpecker_0038_184418.jpg,500,400,192.Downy_Woodpecker,179,93,307,347,243,220,128,254
../../CUB_200_2011/images\192.Downy_Woodpecker/Downy_Woodpecker_0074_183907.jpg,500,375,192.Downy_Woodpecker,111,78,404,306,257,192,293,228
../../CUB_200_2011/images\192.Downy_Woodpecker/Downy_Woodpecker_0056_183913.jpg,384,500,192.Downy_Woodpecker,30,128,240,358,135,243,210,230
../../CUB_200_2011/images\192.Downy_Woodpecker/Downy_Woodpecker_0073_184430.jpg,500,375,192.Downy_Woodpecker,122,77,412,332,267,204,290,255
../../CUB_200_2011/images\192.Downy_Woodpecker/Downy_Woodpecker_0049_183920.jpg,333,500,192.Downy_Woodpecker,87,79,208,417,147,248,121,338
../../CUB_200_2011/images\192.Downy_Woodpecker/Downy_Woodpecker_0082_183922.jpg,500,400,192.Downy_Woodpecker,53,78,402,277,227,177,349,199
../../CUB_200_2011/images\192.Downy_Woodpecker/Downy_Woodpecker_0120_183926.jpg,500,370,192.Downy_Woodpecker,25,25,268,323,146,174,243,298
../../CUB_200_2011/images\192.Downy_Woodpecker/Downy_Woodpecker_0003_183933.jpg,500,335,192.Downy_Woodpecker,125,76,380,291,252,183,255,215
../../CUB_200_2011/images\192.Downy_Woodpecker/Downy_Woodpecker_0011_183934.jpg,375,500,192.Downy_Woodpecker,78,79,255,442,166,260,177,363
../../CUB_200_2011/images\192.Downy_Woodpecker/Downy_Woodpecker_0027_183940.jpg,333,500,192.Downy_Woodpecker,47,80,278,499,162,289,231,419
../../CUB_200_2011/images\192.Downy_Woodpecker/Downy_Woodpecker_0066_183953.jpg,369,500,192.Downy_Woodpecker,62,49,275,482,168,265,213,433
../../CUB_200_2011/images\192.Downy_Woodpecker/Downy_Woodpecker_0090_183964.jpg,500,449,192.Downy_Woodpecker,101,65,405,378,253,221,304,313
../../CUB_200_2011/images\192.Downy_Woodpecker/Downy_Woodpecker_0094_184478.jpg,500,376,192.Downy_Woodpecker,65,194,373,339,219,266,308,145
../../CUB_200_2011/images\192.Downy_Woodpecker/Downy_Woodpecker_0037_183968.jpg,333,500,192.Downy_Woodpecker,62,35,283,466,172,250,221,431
../../CUB_200_2011/images\192.Downy_Woodpecker/Downy_Woodpecker_0001_184484.jpg,500,281,192.Downy_Woodpecker,144,2,373,264,258,133,229,262
../../CUB_200_2011/images\192.Downy_Woodpecker/Downy_Woodpecker_0014_183975.jpg,500,357,192.Downy_Woodpecker,176,91,309,297,242,194,133,206
../../CUB_200_2011/images\192.Downy_Woodpecker/Downy_Woodpecker_0121_184002.jpg,352,500,192.Downy_Woodpecker,88,113,291,452,189,282,203,339
../../CUB_200_2011/images\192.Downy_Woodpecker/Downy_Woodpecker_0058_184520.jpg,500,354,192.Downy_Woodpecker,137,61,267,336,202,198,130,275
../../CUB_200_2011/images\192.Downy_Woodpecker/Downy_Woodpecker_0096_184532.jpg,500,433,192.Downy_Woodpecker,152,85,289,403,220,244,137,318
../../CUB_200_2011/images\192.Downy_Woodpecker/Downy_Woodpecker_0136_184534.jpg,500,492,192.Downy_Woodpecker,171,101,403,479,287,290,232,378
../../CUB_200_2011/images\192.Downy_Woodpecker/Downy_Woodpecker_0091_184537.jpg,500,375,192.Downy_Woodpecker,150,59,489,336,319,197,339,277
../../CUB_200_2011/images\192.Downy_Woodpecker/Downy_Woodpecker_0006_184538.jpg,432,500,192.Downy_Woodpecker,89,114,220,337,154,225,131,223
../../CUB_200_2011/images\192.Downy_Woodpecker/Downy_Woodpecker_0041_184528.jpg,500,400,192.Downy_Woodpecker,159,74,334,382,246,228,175,308
../../CUB_200_2011/images\192.Downy_Woodpecker/Downy_Woodpecker_0029_184046.jpg,386,500,192.Downy_Woodpecker,106,79,322,376,214,227,216,297
../../CUB_200_2011/images\192.Downy_Woodpecker/Downy_Woodpecker_0036_184048.jpg,500,365,192.Downy_Woodpecker,148,21,292,346,220,183,144,325
../../CUB_200_2011/images\192.Downy_Woodpecker/Downy_Woodpecker_0007_184051.jpg,400,500,192.Downy_Woodpecker,61,61,210,436,135,248,149,375
../../CUB_200_2011/images\192.Downy_Woodpecker/Downy_Woodpecker_0131_184446.jpg,318,500,192.Downy_Woodpecker,79,111,232,405,155,258,153,294
../../CUB_200_2011/images\192.Downy_Woodpecker/Downy_Woodpecker_0098_184567.jpg,305,500,192.Downy_Woodpecker,43,66,223,476,133,271,180,410
../../CUB_200_2011/images\192.Downy_Woodpecker/Downy_Woodpecker_0040_184061.jpg,333,500,192.Downy_Woodpecker,71,104,273,476,172,290,202,372
../../CUB_200_2011/images\192.Downy_Woodpecker/Downy_Woodpecker_0100_184584.jpg,500,355,192.Downy_Woodpecker,274,116,488,344,381,230,214,228
../../CUB_200_2011/images\192.Downy_Woodpecker/Downy_Woodpecker_0115_184096.jpg,500,375,192.Downy_Woodpecker,181,42,318,296,249,169,137,254
../../CUB_200_2011/images\192.Downy_Woodpecker/Downy_Woodpecker_0005_184098.jpg,500,333,192.Downy_Woodpecker,110,90,348,316,229,203,238,226
../../CUB_200_2011/images\192.Downy_Woodpecker/Downy_Woodpecker_0032_184622.jpg,465,500,192.Downy_Woodpecker,48,83,441,481,244,282,393,398
../../CUB_200_2011/images\192.Downy_Woodpecker/Downy_Woodpecker_0031_184120.jpg,393,500,192.Downy_Woodpecker,36,41,247,490,141,265,211,449
../../CUB_200_2011/images\192.Downy_Woodpecker/Downy_Woodpecker_0033_184636.jpg,333,500,192.Downy_Woodpecker,108,92,313,372,210,232,205,280
../../CUB_200_2011/images\192.Downy_Woodpecker/Downy_Woodpecker_0028_184131.jpg,332,500,192.Downy_Woodpecker,78,72,243,424,160,248,165,352
../../CUB_200_2011/images\192.Downy_Woodpecker/Downy_Woodpecker_0025_184545.jpg,375,500,192.Downy_Woodpecker,11,45,369,470,190,257,358,425
../../CUB_200_2011/images\192.Downy_Woodpecker/Downy_Woodpecker_0004_184648.jpg,357,500,192.Downy_Woodpecker,109,135,217,406,163,270,108,271
../../CUB_200_2011/images\192.Downy_Woodpecker/Downy_Woodpecker_0101_184139.jpg,346,500,192.Downy_Woodpecker,89,133,276,420,182,276,187,287
../../CUB_200_2011/images\192.Downy_Woodpecker/Downy_Woodpecker_0042_184144.jpg,500,333,192.Downy_Woodpecker,158,29,450,307,304,168,292,278
../../CUB_200_2011/images\192.Downy_Woodpecker/Downy_Woodpecker_0048_184164.jpg,386,500,192.Downy_Woodpecker,26,100,373,457,199,278,347,357
../../CUB_200_2011/images\192.Downy_Woodpecker/Downy_Woodpecker_0044_184170.jpg,367,500,192.Downy_Woodpecker,80,40,270,465,175,252,190,425
../../CUB_200_2011/images\192.Downy_Woodpecker/Downy_Woodpecker_0123_184692.jpg,322,500,192.Downy_Woodpecker,7,32,318,498,162,265,311,466
../../CUB_200_2011/images\192.Downy_Woodpecker/Downy_Woodpecker_0080_184240.jpg,500,498,192.Downy_Woodpecker,112,28,371,465,241,246,259,437
../../CUB_200_2011/images\192.Downy_Woodpecker/Downy_Woodpecker_0039_184243.jpg,500,333,192.Downy_Woodpecker,81,76,459,244,270,160,378,168
../../CUB_200_2011/images\192.Downy_Woodpecker/Downy_Woodpecker_0102_184263.jpg,333,500,192.Downy_Woodpecker,45,60,247,459,146,259,202,399
../../CUB_200_2011/images\192.Downy_Woodpecker/Downy_Woodpecker_0061_184285.jpg,500,357,192.Downy_Woodpecker,188,78,349,352,268,215,161,274
../../CUB_200_2011/images\192.Downy_Woodpecker/Downy_Woodpecker_0125_184656.jpg,400,500,192.Downy_Woodpecker,102,113,378,499,240,306,276,386
../../CUB_200_2011/images\192.Downy_Woodpecker/Downy_Woodpecker_0043_184314.jpg,341,500,192.Downy_Woodpecker,135,109,307,477,221,293,172,368
../../CUB_200_2011/images\193.Bewick_Wren/Bewick_Wren_0056_184834.jpg,500,474,193.Bewick_Wren,71,114,365,343,218,228,294,229
../../CUB_200_2011/images\193.Bewick_Wren/Bewick_Wren_0087_184918.jpg,500,386,193.Bewick_Wren,137,87,413,270,275,178,276,183
../../CUB_200_2011/images\193.Bewick_Wren/Bewick_Wren_0139_184839.jpg,376,500,193.Bewick_Wren,52,161,371,444,211,302,319,283
../../CUB_200_2011/images\193.Bewick_Wren/Bewick_Wren_0097_185358.jpg,500,386,193.Bewick_Wren,111,35,406,333,258,184,295,298
../../CUB_200_2011/images\193.Bewick_Wren/Bewick_Wren_0060_185366.jpg,500,342,193.Bewick_Wren,102,77,476,339,289,208,374,262
../../CUB_200_2011/images\193.Bewick_Wren/Bewick_Wren_0032_184870.jpg,500,375,193.Bewick_Wren,152,88,284,288,218,188,132,200
../../CUB_200_2011/images\193.Bewick_Wren/Bewick_Wren_0042_184878.jpg,500,383,193.Bewick_Wren,59,11,389,338,224,174,330,327
../../CUB_200_2011/images\193.Bewick_Wren/Bewick_Wren_0023_185400.jpg,500,333,193.Bewick_Wren,218,47,328,238,273,142,110,191
../../CUB_200_2011/images\193.Bewick_Wren/Bewick_Wren_0070_184892.jpg,500,394,193.Bewick_Wren,11,99,358,297,184,198,347,198
../../CUB_200_2011/images\193.Bewick_Wren/Bewick_Wren_0068_184895.jpg,500,337,193.Bewick_Wren,23,87,340,254,181,170,317,167
../../CUB_200_2011/images\193.Bewick_Wren/Bewick_Wren_0061_184898.jpg,500,333,193.Bewick_Wren,91,58,431,310,261,184,340,252
../../CUB_200_2011/images\193.Bewick_Wren/Bewick_Wren_0092_184901.jpg,500,357,193.Bewick_Wren,107,64,408,303,257,183,301,239
../../CUB_200_2011/images\193.Bewick_Wren/Bewick_Wren_0054_184902.jpg,500,331,193.Bewick_Wren,35,109,389,303,212,206,354,194
../../CUB_200_2011/images\193.Bewick_Wren/Bewick_Wren_0132_184906.jpg,500,333,193.Bewick_Wren,1,44,496,326,248,185,495,282
../../CUB_200_2011/images\193.Bewick_Wren/Bewick_Wren_0107_184908.jpg,341,500,193.Bewick_Wren,80,173,242,370,161,271,162,197
../../CUB_200_2011/images\193.Bewick_Wren/Bewick_Wren_0051_185425.jpg,500,427,193.Bewick_Wren,48,86,456,332,252,209,408,246
../../CUB_200_2011/images\193.Bewick_Wren/Bewick_Wren_0050_184919.jpg,322,214,193.Bewick_Wren,52,17,293,192,172,104,241,175
../../CUB_200_2011/images\193.Bewick_Wren/Bewick_Wren_0066_184928.jpg,500,333,193.Bewick_Wren,197,67,472,277,334,172,275,210
../../CUB_200_2011/images\193.Bewick_Wren/Bewick_Wren_0025_184932.jpg,500,428,193.Bewick_Wren,44,39,476,401,260,220,432,362
../../CUB_200_2011/images\193.Bewick_Wren/Bewick_Wren_0121_184765.jpg,500,359,193.Bewick_Wren,15,89,277,231,146,160,262,142
../../CUB_200_2011/images\193.Bewick_Wren/Bewick_Wren_0112_184956.jpg,500,333,193.Bewick_Wren,112,34,460,310,286,172,348,276
../../CUB_200_2011/images\193.Bewick_Wren/Bewick_Wren_0085_185474.jpg,407,500,193.Bewick_Wren,123,100,309,495,216,297,186,395
../../CUB_200_2011/images\193.Bewick_Wren/Bewick_Wren_0015_184981.jpg,500,367,193.Bewick_Wren,229,50,421,231,325,140,192,181
../../CUB_200_2011/images\193.Bewick_Wren/Bewick_Wren_0039_184989.jpg,500,309,193.Bewick_Wren,54,115,256,243,155,179,202,128
../../CUB_200_2011/images\193.Bewick_Wren/Bewick_Wren_0016_184999.jpg,500,333,193.Bewick_Wren,233,93,473,232,353,162,240,139
../../CUB_200_2011/images\193.Bewick_Wren/Bewick_Wren_0106_185013.jpg,500,333,193.Bewick_Wren,132,62,352,259,242,160,220,197
../../CUB_200_2011/images\193.Bewick_Wren/Bewick_Wren_0082_185021.jpg,500,333,193.Bewick_Wren,90,130,265,267,177,198,175,137
../../CUB_200_2011/images\193.Bewick_Wren/Bewick_Wren_0075_185046.jpg,500,400,193.Bewick_Wren,48,100,309,354,178,227,261,254
../../CUB_200_2011/images\193.Bewick_Wren/Bewick_Wren_0073_185049.jpg,435,500,193.Bewick_Wren,182,250,315,373,248,311,133,123
../../CUB_200_2011/images\193.Bewick_Wren/Bewick_Wren_0062_185063.jpg,500,451,193.Bewick_Wren,9,2,474,438,241,220,465,436
../../CUB_200_2011/images\193.Bewick_Wren/Bewick_Wren_0123_185069.jpg,500,376,193.Bewick_Wren,43,69,390,315,216,192,347,246
../../CUB_200_2011/images\193.Bewick_Wren/Bewick_Wren_0003_185072.jpg,500,304,193.Bewick_Wren,165,93,422,253,293,173,257,160
../../CUB_200_2011/images\193.Bewick_Wren/Bewick_Wren_0081_185080.jpg,500,357,193.Bewick_Wren,37,37,388,315,212,176,351,278
../../CUB_200_2011/images\193.Bewick_Wren/Bewick_Wren_0113_185113.jpg,500,400,193.Bewick_Wren,45,34,277,251,161,142,232,217
../../CUB_200_2011/images\193.Bewick_Wren/Bewick_Wren_0017_185127.jpg,500,384,193.Bewick_Wren,95,92,371,292,233,192,276,200
../../CUB_200_2011/images\193.Bewick_Wren/Bewick_Wren_0034_185130.jpg,500,332,193.Bewick_Wren,72,51,310,276,191,163,238,225
../../CUB_200_2011/images\193.Bewick_Wren/Bewick_Wren_0096_185139.jpg,500,390,193.Bewick_Wren,34,106,465,372,249,239,431,266
../../CUB_200_2011/images\193.Bewick_Wren/Bewick_Wren_0010_185142.jpg,500,320,193.Bewick_Wren,136,99,320,254,228,176,184,155
../../CUB_200_2011/images\193.Bewick_Wren/Bewick_Wren_0118_185169.jpg,500,334,193.Bewick_Wren,76,35,318,297,197,166,242,262
../../CUB_200_2011/images\193.Bewick_Wren/Bewick_Wren_0109_185170.jpg,500,305,193.Bewick_Wren,98,130,253,232,175,181,155,102
../../CUB_200_2011/images\193.Bewick_Wren/Bewick_Wren_0083_185190.jpg,423,344,193.Bewick_Wren,75,49,399,259,237,154,324,210
../../CUB_200_2011/images\193.Bewick_Wren/Bewick_Wren_0004_185202.jpg,500,334,193.Bewick_Wren,89,76,353,264,221,170,264,188
../../CUB_200_2011/images\193.Bewick_Wren/Bewick_Wren_0005_184699.jpg,358,500,193.Bewick_Wren,55,148,336,415,195,281,281,267
../../CUB_200_2011/images\193.Bewick_Wren/Bewick_Wren_0027_185212.jpg,500,352,193.Bewick_Wren,112,102,447,309,279,205,335,207
../../CUB_200_2011/images\193.Bewick_Wren/Bewick_Wren_0110_185216.jpg,431,500,193.Bewick_Wren,52,118,325,265,188,191,273,147
../../CUB_200_2011/images\193.Bewick_Wren/Bewick_Wren_0047_184707.jpg,500,335,193.Bewick_Wren,102,23,288,283,195,153,186,260
../../CUB_200_2011/images\193.Bewick_Wren/Bewick_Wren_0084_184715.jpg,500,333,193.Bewick_Wren,161,69,374,293,267,181,213,224
../../CUB_200_2011/images\193.Bewick_Wren/Bewick_Wren_0055_185230.jpg,333,500,193.Bewick_Wren,23,90,274,434,148,262,251,344
../../CUB_200_2011/images\193.Bewick_Wren/Bewick_Wren_0088_184733.jpg,333,500,193.Bewick_Wren,56,160,206,321,131,240,150,161
../../CUB_200_2011/images\193.Bewick_Wren/Bewick_Wren_0065_185247.jpg,500,375,193.Bewick_Wren,130,65,314,185,222,125,184,120
../../CUB_200_2011/images\193.Bewick_Wren/Bewick_Wren_0135_185251.jpg,500,373,193.Bewick_Wren,69,129,326,260,197,194,257,131
../../CUB_200_2011/images\193.Bewick_Wren/Bewick_Wren_0127_184756.jpg,400,400,193.Bewick_Wren,59,115,247,341,153,228,188,226
../../CUB_200_2011/images\193.Bewick_Wren/Bewick_Wren_0052_184760.jpg,500,376,193.Bewick_Wren,13,89,328,351,170,220,315,262
../../CUB_200_2011/images\193.Bewick_Wren/Bewick_Wren_0124_184771.jpg,500,481,193.Bewick_Wren,112,177,373,296,242,236,261,119
../../CUB_200_2011/images\193.Bewick_Wren/Bewick_Wren_0099_185288.jpg,500,371,193.Bewick_Wren,246,44,416,297,331,170,170,253
../../CUB_200_2011/images\193.Bewick_Wren/Bewick_Wren_0014_184810.jpg,500,400,193.Bewick_Wren,208,125,365,234,286,179,157,109
../../CUB_200_2011/images\193.Bewick_Wren/Bewick_Wren_0067_184816.jpg,500,389,193.Bewick_Wren,34,59,487,345,260,202,453,286
../../CUB_200_2011/images\193.Bewick_Wren/Bewick_Wren_0104_185256.jpg,500,375,193.Bewick_Wren,121,136,278,247,199,191,157,111
../../CUB_200_2011/images\193.Bewick_Wren/Bewick_Wren_0037_185332.jpg,484,500,193.Bewick_Wren,11,176,311,390,161,283,300,214
../../CUB_200_2011/images\193.Bewick_Wren/Bewick_Wren_0049_185339.jpg,500,333,193.Bewick_Wren,178,55,447,280,312,167,269,225
../../CUB_200_2011/images\194.Cactus_Wren/Cactus_Wren_0040_185859.jpg,333,500,194.Cactus_Wren,19,72,332,468,175,270,313,396
../../CUB_200_2011/images\194.Cactus_Wren/Cactus_Wren_0009_185871.jpg,500,334,194.Cactus_Wren,15,127,293,251,154,189,278,124
../../CUB_200_2011/images\194.Cactus_Wren/Cactus_Wren_0088_185873.jpg,500,375,194.Cactus_Wren,71,104,365,259,218,181,294,155
../../CUB_200_2011/images\194.Cactus_Wren/Cactus_Wren_0056_185626.jpg,500,333,194.Cactus_Wren,228,77,443,251,335,164,215,174
../../CUB_200_2011/images\194.Cactus_Wren/Cactus_Wren_0101_185627.jpg,500,500,194.Cactus_Wren,72,47,436,466,254,256,364,419
../../CUB_200_2011/images\194.Cactus_Wren/Cactus_Wren_0086_185630.jpg,500,398,194.Cactus_Wren,174,87,461,343,317,215,287,256
../../CUB_200_2011/images\194.Cactus_Wren/Cactus_Wren_0108_185733.jpg,500,375,194.Cactus_Wren,181,69,334,273,257,171,153,204
../../CUB_200_2011/images\194.Cactus_Wren/Cactus_Wren_0095_185633.jpg,378,500,194.Cactus_Wren,8,62,311,494,159,278,303,432
../../CUB_200_2011/images\194.Cactus_Wren/Cactus_Wren_0007_185634.jpg,500,333,194.Cactus_Wren,161,80,287,290,224,185,126,210
../../CUB_200_2011/images\194.Cactus_Wren/Cactus_Wren_0027_185893.jpg,500,375,194.Cactus_Wren,170,78,499,270,334,174,329,192
../../CUB_200_2011/images\194.Cactus_Wren/Cactus_Wren_0115_185895.jpg,500,293,194.Cactus_Wren,155,155,326,274,240,214,171,119
../../CUB_200_2011/images\194.Cactus_Wren/Cactus_Wren_0096_185898.jpg,500,383,194.Cactus_Wren,152,68,339,345,245,206,187,277
../../CUB_200_2011/images\194.Cactus_Wren/Cactus_Wren_0078_185899.jpg,500,328,194.Cactus_Wren,67,45,393,308,230,176,326,263
../../CUB_200_2011/images\194.Cactus_Wren/Cactus_Wren_0080_185901.jpg,500,375,194.Cactus_Wren,213,117,348,339,280,228,135,222
../../CUB_200_2011/images\194.Cactus_Wren/Cactus_Wren_0102_185902.jpg,500,379,194.Cactus_Wren,36,66,368,318,202,192,332,252
../../CUB_200_2011/images\194.Cactus_Wren/Cactus_Wren_0058_185903.jpg,432,418,194.Cactus_Wren,37,83,371,313,204,198,334,230
../../CUB_200_2011/images\194.Cactus_Wren/Cactus_Wren_0125_185648.jpg,500,318,194.Cactus_Wren,11,113,343,276,177,194,332,163
../../CUB_200_2011/images\194.Cactus_Wren/Cactus_Wren_0073_185670.jpg,375,500,194.Cactus_Wren,77,117,277,423,177,270,200,306
../../CUB_200_2011/images\194.Cactus_Wren/Cactus_Wren_0116_185927.jpg,500,375,194.Cactus_Wren,154,61,370,371,262,216,216,310
../../CUB_200_2011/images\194.Cactus_Wren/Cactus_Wren_0002_185680.jpg,500,495,194.Cactus_Wren,94,152,309,351,201,251,215,199
../../CUB_200_2011/images\194.Cactus_Wren/Cactus_Wren_0041_185691.jpg,500,338,194.Cactus_Wren,242,45,384,194,313,119,142,149
../../CUB_200_2011/images\194.Cactus_Wren/Cactus_Wren_0118_185788.jpg,375,500,194.Cactus_Wren,118,80,330,195,224,137,212,115
../../CUB_200_2011/images\194.Cactus_Wren/Cactus_Wren_0060_185950.jpg,500,438,194.Cactus_Wren,17,31,483,402,250,216,466,371
../../CUB_200_2011/images\194.Cactus_Wren/Cactus_Wren_0092_185951.jpg,500,377,194.Cactus_Wren,109,36,430,361,269,198,321,325
../../CUB_200_2011/images\194.Cactus_Wren/Cactus_Wren_0025_185696.jpg,500,500,194.Cactus_Wren,119,129,321,423,220,276,202,294
../../CUB_200_2011/images\194.Cactus_Wren/Cactus_Wren_0120_185956.jpg,500,340,194.Cactus_Wren,154,92,445,301,299,196,291,209
../../CUB_200_2011/images\194.Cactus_Wren/Cactus_Wren_0075_186066.jpg,391,500,194.Cactus_Wren,32,77,282,376,157,226,250,299
../../CUB_200_2011/images\194.Cactus_Wren/Cactus_Wren_0001_185645.jpg,500,375,194.Cactus_Wren,99,51,455,333,277,192,356,282
../../CUB_200_2011/images\194.Cactus_Wren/Cactus_Wren_0014_185993.jpg,500,375,194.Cactus_Wren,161,37,331,322,246,179,170,285
../../CUB_200_2011/images\194.Cactus_Wren/Cactus_Wren_0017_185745.jpg,436,500,194.Cactus_Wren,144,48,294,209,219,128,150,161
../../CUB_200_2011/images\194.Cactus_Wren/Cactus_Wren_0077_186003.jpg,500,333,194.Cactus_Wren,107,75,455,256,281,165,348,181
../../CUB_200_2011/images\194.Cactus_Wren/Cactus_Wren_0044_185492.jpg,500,328,194.Cactus_Wren,170,120,300,326,235,223,130,206
../../CUB_200_2011/images\194.Cactus_Wren/Cactus_Wren_0124_185501.jpg,500,375,194.Cactus_Wren,22,94,459,324,240,209,437,230
../../CUB_200_2011/images\194.Cactus_Wren/Cactus_Wren_0033_186014.jpg,333,500,194.Cactus_Wren,76,125,322,328,199,226,246,203
../../CUB_200_2011/images\194.Cactus_Wren/Cactus_Wren_0046_186017.jpg,500,375,194.Cactus_Wren,217,133,334,255,275,194,117,122
../../CUB_200_2011/images\194.Cactus_Wren/Cactus_Wren_0103_185506.jpg,500,400,194.Cactus_Wren,20,68,412,258,216,163,392,190
../../CUB_200_2011/images\194.Cactus_Wren/Cactus_Wren_0030_185798.jpg,500,375,194.Cactus_Wren,75,59,275,335,175,197,200,276
../../CUB_200_2011/images\194.Cactus_Wren/Cactus_Wren_0089_186023.jpg,280,420,194.Cactus_Wren,35,10,245,416,140,213,210,406
../../CUB_200_2011/images\194.Cactus_Wren/Cactus_Wren_0020_186012.jpg,500,342,194.Cactus_Wren,42,68,420,277,231,172,378,209
../../CUB_200_2011/images\194.Cactus_Wren/Cactus_Wren_0042_185514.jpg,418,500,194.Cactus_Wren,115,60,357,457,236,258,242,397
../../CUB_200_2011/images\194.Cactus_Wren/Cactus_Wren_0085_185515.jpg,500,469,194.Cactus_Wren,13,23,482,448,247,235,469,425
../../CUB_200_2011/images\194.Cactus_Wren/Cactus_Wren_0066_186028.jpg,500,333,194.Cactus_Wren,109,51,366,185,237,118,257,134
../../CUB_200_2011/images\194.Cactus_Wren/Cactus_Wren_0069_186033.jpg,500,334,194.Cactus_Wren,115,36,414,289,264,162,299,253
../../CUB_200_2011/images\194.Cactus_Wren/Cactus_Wren_0067_186034.jpg,500,375,194.Cactus_Wren,72,65,498,363,285,214,426,298
../../CUB_200_2011/images\194.Cactus_Wren/Cactus_Wren_0097_186015.jpg,500,375,194.Cactus_Wren,79,133,333,370,206,251,254,237
../../CUB_200_2011/images\194.Cactus_Wren/Cactus_Wren_0114_185532.jpg,400,500,194.Cactus_Wren,200,105,344,481,272,293,144,376
../../CUB_200_2011/images\194.Cactus_Wren/Cactus_Wren_0028_185795.jpg,500,357,194.Cactus_Wren,73,91,292,285,182,188,219,194
../../CUB_200_2011/images\194.Cactus_Wren/Cactus_Wren_0004_185797.jpg,361,500,194.Cactus_Wren,21,63,257,424,139,243,236,361
../../CUB_200_2011/images\194.Cactus_Wren/Cactus_Wren_0076_186067.jpg,500,307,194.Cactus_Wren,88,88,404,243,246,165,316,155
../../CUB_200_2011/images\194.Cactus_Wren/Cactus_Wren_0045_185556.jpg,500,455,194.Cactus_Wren,224,102,391,373,307,237,167,271
../../CUB_200_2011/images\194.Cactus_Wren/Cactus_Wren_0079_185560.jpg,458,500,194.Cactus_Wren,76,106,294,468,185,287,218,362
../../CUB_200_2011/images\194.Cactus_Wren/Cactus_Wren_0034_185817.jpg,363,500,194.Cactus_Wren,5,60,355,373,180,216,350,313
../../CUB_200_2011/images\194.Cactus_Wren/Cactus_Wren_0036_185563.jpg,500,375,194.Cactus_Wren,107,166,461,360,284,263,354,194
../../CUB_200_2011/images\194.Cactus_Wren/Cactus_Wren_0098_185637.jpg,500,300,194.Cactus_Wren,14,26,368,221,191,123,354,195
../../CUB_200_2011/images\194.Cactus_Wren/Cactus_Wren_0064_185826.jpg,500,307,194.Cactus_Wren,183,82,359,303,271,192,176,221
../../CUB_200_2011/images\194.Cactus_Wren/Cactus_Wren_0008_186083.jpg,500,483,194.Cactus_Wren,88,116,354,401,221,258,266,285
../../CUB_200_2011/images\194.Cactus_Wren/Cactus_Wren_0016_185582.jpg,500,375,194.Cactus_Wren,0,80,386,374,193,227,386,294
../../CUB_200_2011/images\194.Cactus_Wren/Cactus_Wren_0063_185589.jpg,351,500,194.Cactus_Wren,95,164,300,415,197,289,205,251
../../CUB_200_2011/images\194.Cactus_Wren/Cactus_Wren_0117_185591.jpg,500,497,194.Cactus_Wren,136,40,484,457,310,248,348,417
../../CUB_200_2011/images\194.Cactus_Wren/Cactus_Wren_0123_186068.jpg,500,372,194.Cactus_Wren,8,119,280,338,144,228,272,219
../../CUB_200_2011/images\195.Carolina_Wren/Carolina_Wren_0130_186369.jpg,500,333,195.Carolina_Wren,91,92,306,207,198,149,215,115
../../CUB_200_2011/images\195.Carolina_Wren/Carolina_Wren_0024_186377.jpg,500,333,195.Carolina_Wren,152,58,489,271,320,164,337,213
../../CUB_200_2011/images\195.Carolina_Wren/Carolina_Wren_0062_186390.jpg,334,500,195.Carolina_Wren,53,139,224,317,138,228,171,178
../../CUB_200_2011/images\195.Carolina_Wren/Carolina_Wren_0117_186916.jpg,500,400,195.Carolina_Wren,200,140,394,286,297,213,194,146
../../CUB_200_2011/images\195.Carolina_Wren/Carolina_Wren_0080_186919.jpg,500,333,195.Carolina_Wren,16,73,458,288,237,180,442,215
../../CUB_200_2011/images\195.Carolina_Wren/Carolina_Wren_0058_186409.jpg,500,429,195.Carolina_Wren,26,86,396,388,211,237,370,302
../../CUB_200_2011/images\195.Carolina_Wren/Carolina_Wren_0047_186928.jpg,500,402,195.Carolina_Wren,63,75,443,388,253,231,380,313
../../CUB_200_2011/images\195.Carolina_Wren/Carolina_Wren_0082_186421.jpg,500,385,195.Carolina_Wren,37,63,388,288,212,175,351,225
../../CUB_200_2011/images\195.Carolina_Wren/Carolina_Wren_0090_186942.jpg,500,334,195.Carolina_Wren,133,36,437,288,285,162,304,252
../../CUB_200_2011/images\195.Carolina_Wren/Carolina_Wren_0086_186431.jpg,500,327,195.Carolina_Wren,170,111,377,270,273,190,207,159
../../CUB_200_2011/images\195.Carolina_Wren/Carolina_Wren_0038_186436.jpg,500,333,195.Carolina_Wren,31,68,423,322,227,195,392,254
../../CUB_200_2011/images\195.Carolina_Wren/Carolina_Wren_0142_186443.jpg,333,500,195.Carolina_Wren,73,116,287,458,180,287,214,342
../../CUB_200_2011/images\195.Carolina_Wren/Carolina_Wren_0001_186455.jpg,500,375,195.Carolina_Wren,217,69,360,338,288,203,143,269
../../CUB_200_2011/images\195.Carolina_Wren/Carolina_Wren_0091_186464.jpg,500,361,195.Carolina_Wren,143,140,297,283,220,211,154,143
../../CUB_200_2011/images\195.Carolina_Wren/Carolina_Wren_0125_187009.jpg,333,500,195.Carolina_Wren,48,114,219,443,133,278,171,329
../../CUB_200_2011/images\195.Carolina_Wren/Carolina_Wren_0002_186506.jpg,500,376,195.Carolina_Wren,61,38,486,369,273,203,425,331
../../CUB_200_2011/images\195.Carolina_Wren/Carolina_Wren_0051_186510.jpg,500,374,195.Carolina_Wren,14,76,450,359,232,217,436,283
../../CUB_200_2011/images\195.Carolina_Wren/Carolina_Wren_0065_186517.jpg,500,462,195.Carolina_Wren,119,195,351,417,235,306,232,222
../../CUB_200_2011/images\195.Carolina_Wren/Carolina_Wren_0014_186525.jpg,353,500,195.Carolina_Wren,50,38,313,484,181,261,263,446
../../CUB_200_2011/images\195.Carolina_Wren/Carolina_Wren_0028_186526.jpg,500,333,195.Carolina_Wren,61,98,329,283,195,190,268,185
../../CUB_200_2011/images\195.Carolina_Wren/Carolina_Wren_0019_186527.jpg,500,396,195.Carolina_Wren,74,52,451,334,262,193,377,282
../../CUB_200_2011/images\195.Carolina_Wren/Carolina_Wren_0095_186561.jpg,500,427,195.Carolina_Wren,132,171,343,334,237,252,211,163
../../CUB_200_2011/images\195.Carolina_Wren/Carolina_Wren_0112_186562.jpg,500,375,195.Carolina_Wren,30,164,330,370,180,267,300,206
../../CUB_200_2011/images\195.Carolina_Wren/Carolina_Wren_0032_186566.jpg,500,351,195.Carolina_Wren,267,97,477,307,372,202,210,210
../../CUB_200_2011/images\195.Carolina_Wren/Carolina_Wren_0078_186570.jpg,500,334,195.Carolina_Wren,126,95,284,260,205,177,158,165
../../CUB_200_2011/images\195.Carolina_Wren/Carolina_Wren_0013_187086.jpg,500,421,195.Carolina_Wren,100,122,344,307,222,214,244,185
../../CUB_200_2011/images\195.Carolina_Wren/Carolina_Wren_0128_186581.jpg,500,375,195.Carolina_Wren,191,132,459,348,325,240,268,216
../../CUB_200_2011/images\195.Carolina_Wren/Carolina_Wren_0073_186587.jpg,394,500,195.Carolina_Wren,31,153,315,393,173,273,284,240
../../CUB_200_2011/images\195.Carolina_Wren/Carolina_Wren_0108_186089.jpg,500,357,195.Carolina_Wren,195,119,422,241,308,180,227,122
../../CUB_200_2011/images\195.Carolina_Wren/Carolina_Wren_0005_186109.jpg,500,332,195.Carolina_Wren,111,25,425,317,268,171,314,292
../../CUB_200_2011/images\195.Carolina_Wren/Carolina_Wren_0049_186129.jpg,500,333,195.Carolina_Wren,22,4,449,328,235,166,427,324
../../CUB_200_2011/images\195.Carolina_Wren/Carolina_Wren_0044_186645.jpg,351,500,195.Carolina_Wren,49,70,217,423,133,246,168,353
../../CUB_200_2011/images\195.Carolina_Wren/Carolina_Wren_0126_186654.jpg,500,290,195.Carolina_Wren,107,46,283,230,195,138,176,184
../../CUB_200_2011/images\195.Carolina_Wren/Carolina_Wren_0119_186153.jpg,500,375,195.Carolina_Wren,48,89,402,315,225,202,354,226
../../CUB_200_2011/images\195.Carolina_Wren/Carolina_Wren_0055_186154.jpg,361,500,195.Carolina_Wren,114,102,250,222,182,162,136,120
../../CUB_200_2011/images\195.Carolina_Wren/Carolina_Wren_0113_186675.jpg,500,333,195.Carolina_Wren,175,58,299,217,237,137,124,159
../../CUB_200_2011/images\195.Carolina_Wren/Carolina_Wren_0045_186165.jpg,500,359,195.Carolina_Wren,105,11,314,348,209,179,209,337
../../CUB_200_2011/images\195.Carolina_Wren/Carolina_Wren_0021_186683.jpg,500,357,195.Carolina_Wren,62,71,298,278,180,174,236,207
../../CUB_200_2011/images\195.Carolina_Wren/Carolina_Wren_0020_186702.jpg,500,336,195.Carolina_Wren,38,62,409,327,223,194,371,265
../../CUB_200_2011/images\195.Carolina_Wren/Carolina_Wren_0031_186713.jpg,500,375,195.Carolina_Wren,58,67,407,327,232,197,349,260
../../CUB_200_2011/images\195.Carolina_Wren/Carolina_Wren_0036_186722.jpg,500,333,195.Carolina_Wren,196,71,390,256,293,163,194,185
../../CUB_200_2011/images\195.Carolina_Wren/Carolina_Wren_0029_186212.jpg,500,395,195.Carolina_Wren,63,65,441,344,252,204,378,279
../../CUB_200_2011/images\195.Carolina_Wren/Carolina_Wren_0069_186230.jpg,500,400,195.Carolina_Wren,18,72,447,358,232,215,429,286
../../CUB_200_2011/images\195.Carolina_Wren/Carolina_Wren_0099_186237.jpg,500,333,195.Carolina_Wren,75,95,493,317,284,206,418,222
../../CUB_200_2011/images\195.Carolina_Wren/Carolina_Wren_0107_186972.jpg,500,333,195.Carolina_Wren,201,110,351,214,276,162,150,104
../../CUB_200_2011/images\195.Carolina_Wren/Carolina_Wren_0043_186286.jpg,500,375,195.Carolina_Wren,92,4,412,370,252,187,320,366
../../CUB_200_2011/images\195.Carolina_Wren/Carolina_Wren_0077_186294.jpg,500,498,195.Carolina_Wren,82,119,373,365,227,242,291,246
../../CUB_200_2011/images\195.Carolina_Wren/Carolina_Wren_0060_186296.jpg,335,500,195.Carolina_Wren,17,151,306,412,161,281,289,261
../../CUB_200_2011/images\195.Carolina_Wren/Carolina_Wren_0066_186818.jpg,500,366,195.Carolina_Wren,153,138,310,363,231,250,157,225
../../CUB_200_2011/images\195.Carolina_Wren/Carolina_Wren_0072_186309.jpg,500,358,195.Carolina_Wren,124,83,327,313,225,198,203,230
../../CUB_200_2011/images\195.Carolina_Wren/Carolina_Wren_0056_186313.jpg,500,345,195.Carolina_Wren,71,89,358,286,214,187,287,197
../../CUB_200_2011/images\195.Carolina_Wren/Carolina_Wren_0068_186830.jpg,500,292,195.Carolina_Wren,231,89,400,250,315,169,169,161
../../CUB_200_2011/images\195.Carolina_Wren/Carolina_Wren_0083_186324.jpg,500,400,195.Carolina_Wren,58,68,361,308,209,188,303,240
../../CUB_200_2011/images\195.Carolina_Wren/Carolina_Wren_0102_186332.jpg,500,367,195.Carolina_Wren,16,74,337,302,176,188,321,228
../../CUB_200_2011/images\195.Carolina_Wren/Carolina_Wren_0033_186848.jpg,500,375,195.Carolina_Wren,155,132,412,293,283,212,257,161
../../CUB_200_2011/images\195.Carolina_Wren/Carolina_Wren_0141_186347.jpg,500,333,195.Carolina_Wren,0,112,359,332,179,222,359,220
../../CUB_200_2011/images\195.Carolina_Wren/Carolina_Wren_0006_186742.jpg,500,363,195.Carolina_Wren,138,90,328,284,233,187,190,194
../../CUB_200_2011/images\195.Carolina_Wren/Carolina_Wren_0035_186356.jpg,500,348,195.Carolina_Wren,104,108,358,302,231,205,254,194
../../CUB_200_2011/images\195.Carolina_Wren/Carolina_Wren_0011_186871.jpg,500,378,195.Carolina_Wren,108,52,384,314,246,183,276,262
../../CUB_200_2011/images\195.Carolina_Wren/Carolina_Wren_0122_186365.jpg,411,500,195.Carolina_Wren,36,34,371,486,203,260,335,452
../../CUB_200_2011/images\196.House_Wren/House_Wren_0055_187397.jpg,500,334,196.House_Wren,188,131,385,244,286,187,197,113
../../CUB_200_2011/images\196.House_Wren/House_Wren_0071_187399.jpg,500,372,196.House_Wren,135,135,319,246,227,190,184,111
../../CUB_200_2011/images\196.House_Wren/House_Wren_0083_187406.jpg,500,375,196.House_Wren,173,104,403,280,288,192,230,176
../../CUB_200_2011/images\196.House_Wren/House_Wren_0087_187946.jpg,500,357,196.House_Wren,93,54,386,337,239,195,293,283
../../CUB_200_2011/images\196.House_Wren/House_Wren_0061_187911.jpg,500,396,196.House_Wren,109,95,369,341,239,218,260,246
../../CUB_200_2011/images\196.House_Wren/House_Wren_0004_187448.jpg,500,365,196.House_Wren,141,118,398,284,269,201,257,166
../../CUB_200_2011/images\196.House_Wren/House_Wren_0012_187973.jpg,500,385,196.House_Wren,121,38,333,357,227,197,212,319
../../CUB_200_2011/images\196.House_Wren/House_Wren_0103_187466.jpg,500,388,196.House_Wren,56,104,347,331,201,217,291,227
../../CUB_200_2011/images\196.House_Wren/House_Wren_0046_187477.jpg,400,500,196.House_Wren,41,190,346,414,193,302,305,224
../../CUB_200_2011/images\196.House_Wren/House_Wren_0064_187489.jpg,500,407,196.House_Wren,157,145,354,256,255,200,197,111
../../CUB_200_2011/images\196.House_Wren/House_Wren_0117_187492.jpg,500,333,196.House_Wren,214,88,445,284,329,186,231,196
../../CUB_200_2011/images\196.House_Wren/House_Wren_0005_187493.jpg,500,403,196.House_Wren,280,87,425,275,352,181,145,188
../../CUB_200_2011/images\196.House_Wren/House_Wren_0016_188006.jpg,500,456,196.House_Wren,85,94,296,354,190,224,211,260
../../CUB_200_2011/images\196.House_Wren/House_Wren_0114_188016.jpg,500,320,196.House_Wren,88,99,461,303,274,201,373,204
../../CUB_200_2011/images\196.House_Wren/House_Wren_0057_187157.jpg,500,344,196.House_Wren,23,27,402,252,212,139,379,225
../../CUB_200_2011/images\196.House_Wren/House_Wren_0047_188036.jpg,500,448,196.House_Wren,97,133,314,293,205,213,217,160
../../CUB_200_2011/images\196.House_Wren/House_Wren_0091_188046.jpg,500,339,196.House_Wren,113,64,324,267,218,165,211,203
../../CUB_200_2011/images\196.House_Wren/House_Wren_0001_188047.jpg,500,402,196.House_Wren,2,45,450,391,226,218,448,346
../../CUB_200_2011/images\196.House_Wren/House_Wren_0011_187547.jpg,500,416,196.House_Wren,156,60,319,365,237,212,163,305
../../CUB_200_2011/images\196.House_Wren/House_Wren_0119_187552.jpg,500,353,196.House_Wren,155,54,432,281,293,167,277,227
../../CUB_200_2011/images\196.House_Wren/House_Wren_0063_188076.jpg,500,384,196.House_Wren,137,130,464,326,300,228,327,196
../../CUB_200_2011/images\196.House_Wren/House_Wren_0134_188077.jpg,500,404,196.House_Wren,153,107,397,238,275,172,244,131
../../CUB_200_2011/images\196.House_Wren/House_Wren_0116_187604.jpg,500,333,196.House_Wren,66,72,437,300,251,186,371,228
../../CUB_200_2011/images\196.House_Wren/House_Wren_0123_187095.jpg,500,400,196.House_Wren,78,49,292,264,185,156,214,215
../../CUB_200_2011/images\196.House_Wren/House_Wren_0042_187098.jpg,334,500,196.House_Wren,80,187,258,348,169,267,178,161
../../CUB_200_2011/images\196.House_Wren/House_Wren_0092_187100.jpg,500,332,196.House_Wren,126,78,309,265,217,171,183,187
../../CUB_200_2011/images\196.House_Wren/House_Wren_0133_187101.jpg,500,500,196.House_Wren,139,114,435,421,287,267,296,307
../../CUB_200_2011/images\196.House_Wren/House_Wren_0108_187102.jpg,500,330,196.House_Wren,125,82,473,300,299,191,348,218
../../CUB_200_2011/images\196.House_Wren/House_Wren_0130_187109.jpg,500,404,196.House_Wren,161,119,337,314,249,216,176,195
../../CUB_200_2011/images\196.House_Wren/House_Wren_0110_187111.jpg,500,386,196.House_Wren,54,133,360,333,207,233,306,200
../../CUB_200_2011/images\196.House_Wren/House_Wren_0034_187120.jpg,395,500,196.House_Wren,131,162,359,295,245,228,228,133
../../CUB_200_2011/images\196.House_Wren/House_Wren_0101_187133.jpg,500,281,196.House_Wren,125,57,436,259,280,158,311,202
../../CUB_200_2011/images\196.House_Wren/House_Wren_0126_187647.jpg,500,333,196.House_Wren,8,3,489,328,248,165,481,325
../../CUB_200_2011/images\196.House_Wren/House_Wren_0025_187160.jpg,389,500,196.House_Wren,68,55,325,360,196,207,257,305
../../CUB_200_2011/images\196.House_Wren/House_Wren_0112_187355.jpg,500,389,196.House_Wren,201,67,403,253,302,160,202,186
../../CUB_200_2011/images\196.House_Wren/House_Wren_0139_187177.jpg,500,356,196.House_Wren,140,92,451,342,295,217,311,250
../../CUB_200_2011/images\196.House_Wren/House_Wren_0137_187273.jpg,500,348,196.House_Wren,231,91,371,302,301,196,140,211
../../CUB_200_2011/images\196.House_Wren/House_Wren_0023_187192.jpg,500,375,196.House_Wren,130,58,378,333,254,195,248,275
../../CUB_200_2011/images\196.House_Wren/House_Wren_0062_187194.jpg,500,375,196.House_Wren,208,90,441,339,324,214,233,249
../../CUB_200_2011/images\196.House_Wren/House_Wren_0035_187708.jpg,375,500,196.House_Wren,34,210,317,362,175,286,283,152
../../CUB_200_2011/images\196.House_Wren/House_Wren_0085_187723.jpg,500,400,196.House_Wren,106,89,459,321,282,205,353,232
../../CUB_200_2011/images\196.House_Wren/House_Wren_0043_187224.jpg,500,307,196.House_Wren,50,12,445,281,247,146,395,269
../../CUB_200_2011/images\196.House_Wren/House_Wren_0094_187226.jpg,500,361,196.House_Wren,33,80,379,327,206,203,346,247
../../CUB_200_2011/images\196.House_Wren/House_Wren_0107_187230.jpg,500,405,196.House_Wren,124,46,338,303,231,174,214,257
../../CUB_200_2011/images\196.House_Wren/House_Wren_0099_187240.jpg,500,371,196.House_Wren,58,73,244,193,151,133,186,120
../../CUB_200_2011/images\196.House_Wren/House_Wren_0088_187243.jpg,500,333,196.House_Wren,150,91,278,265,214,178,128,174
../../CUB_200_2011/images\196.House_Wren/House_Wren_0097_187760.jpg,500,408,196.House_Wren,94,96,382,341,238,218,288,245
../../CUB_200_2011/images\196.House_Wren/House_Wren_0090_187762.jpg,500,375,196.House_Wren,178,114,382,340,280,227,204,226
../../CUB_200_2011/images\196.House_Wren/House_Wren_0125_187251.jpg,500,375,196.House_Wren,186,129,469,353,327,241,283,224
../../CUB_200_2011/images\196.House_Wren/House_Wren_0086_187815.jpg,500,375,196.House_Wren,78,36,403,322,240,179,325,286
../../CUB_200_2011/images\196.House_Wren/House_Wren_0127_187832.jpg,500,430,196.House_Wren,139,145,330,304,234,224,191,159
../../CUB_200_2011/images\196.House_Wren/House_Wren_0017_187330.jpg,500,375,196.House_Wren,148,89,450,348,299,218,302,259
../../CUB_200_2011/images\196.House_Wren/House_Wren_0122_187331.jpg,500,375,196.House_Wren,99,93,433,310,266,201,334,217
../../CUB_200_2011/images\196.House_Wren/House_Wren_0022_187848.jpg,500,333,196.House_Wren,28,66,232,252,130,159,204,186
../../CUB_200_2011/images\196.House_Wren/House_Wren_0098_187368.jpg,500,386,196.House_Wren,74,130,273,312,173,221,199,182
../../CUB_200_2011/images\196.House_Wren/House_Wren_0045_187374.jpg,500,337,196.House_Wren,172,99,390,217,281,158,218,118
../../CUB_200_2011/images\196.House_Wren/House_Wren_0129_187376.jpg,500,370,196.House_Wren,135,123,377,293,256,208,242,170
../../CUB_200_2011/images\196.House_Wren/House_Wren_0118_187383.jpg,500,375,196.House_Wren,178,125,328,300,253,212,150,175
../../CUB_200_2011/images\196.House_Wren/House_Wren_0072_187899.jpg,500,317,196.House_Wren,152,50,476,293,314,171,324,243
../../CUB_200_2011/images\197.Marsh_Wren/Marsh_Wren_0043_188426.jpg,360,500,197.Marsh_Wren,144,190,335,411,239,300,191,221
../../CUB_200_2011/images\197.Marsh_Wren/Marsh_Wren_0110_188434.jpg,324,500,197.Marsh_Wren,52,274,166,392,109,333,114,118
../../CUB_200_2011/images\197.Marsh_Wren/Marsh_Wren_0115_188443.jpg,500,375,197.Marsh_Wren,133,57,324,257,228,157,191,200
../../CUB_200_2011/images\197.Marsh_Wren/Marsh_Wren_0068_188446.jpg,500,354,197.Marsh_Wren,135,56,409,346,272,201,274,290
../../CUB_200_2011/images\197.Marsh_Wren/Marsh_Wren_0040_188252.jpg,500,333,197.Marsh_Wren,97,49,391,289,244,169,294,240
../../CUB_200_2011/images\197.Marsh_Wren/Marsh_Wren_0019_188460.jpg,500,333,197.Marsh_Wren,116,139,343,270,229,204,227,131
../../CUB_200_2011/images\197.Marsh_Wren/Marsh_Wren_0103_188483.jpg,324,500,197.Marsh_Wren,70,164,193,374,131,269,123,210
../../CUB_200_2011/images\197.Marsh_Wren/Marsh_Wren_0118_188512.jpg,500,410,197.Marsh_Wren,220,103,478,359,349,231,258,256
../../CUB_200_2011/images\197.Marsh_Wren/Marsh_Wren_0038_188530.jpg,413,500,197.Marsh_Wren,82,114,309,389,195,251,227,275
../../CUB_200_2011/images\197.Marsh_Wren/Marsh_Wren_0008_188533.jpg,395,500,197.Marsh_Wren,92,159,322,417,207,288,230,258
../../CUB_200_2011/images\197.Marsh_Wren/Marsh_Wren_0049_188540.jpg,333,500,197.Marsh_Wren,24,201,195,405,109,303,171,204
../../CUB_200_2011/images\197.Marsh_Wren/Marsh_Wren_0075_188549.jpg,500,360,197.Marsh_Wren,137,81,373,316,255,198,236,235
../../CUB_200_2011/images\197.Marsh_Wren/Marsh_Wren_0133_188565.jpg,500,435,197.Marsh_Wren,163,110,469,370,316,240,306,260
../../CUB_200_2011/images\197.Marsh_Wren/Marsh_Wren_0106_188100.jpg,500,333,197.Marsh_Wren,223,90,437,202,330,146,214,112
../../CUB_200_2011/images\197.Marsh_Wren/Marsh_Wren_0099_188579.jpg,350,500,197.Marsh_Wren,113,163,308,366,210,264,195,203
../../CUB_200_2011/images\197.Marsh_Wren/Marsh_Wren_0053_188276.jpg,500,333,197.Marsh_Wren,80,25,402,328,241,176,322,303
../../CUB_200_2011/images\197.Marsh_Wren/Marsh_Wren_0058_188107.jpg,500,375,197.Marsh_Wren,242,47,475,284,358,165,233,237
../../CUB_200_2011/images\197.Marsh_Wren/Marsh_Wren_0076_188108.jpg,500,375,197.Marsh_Wren,228,117,429,346,328,231,201,229
../../CUB_200_2011/images\197.Marsh_Wren/Marsh_Wren_0071_188111.jpg,500,374,197.Marsh_Wren,130,81,479,338,304,209,349,257
../../CUB_200_2011/images\197.Marsh_Wren/Marsh_Wren_0055_188123.jpg,500,333,197.Marsh_Wren,121,98,352,282,236,190,231,184
../../CUB_200_2011/images\197.Marsh_Wren/Marsh_Wren_0006_188126.jpg,500,314,197.Marsh_Wren,53,68,484,283,268,175,431,215
../../CUB_200_2011/images\197.Marsh_Wren/Marsh_Wren_0102_188654.jpg,500,500,197.Marsh_Wren,38,70,413,421,225,245,375,351
../../CUB_200_2011/images\197.Marsh_Wren/Marsh_Wren_0050_188657.jpg,500,333,197.Marsh_Wren,129,138,312,320,220,229,183,182
../../CUB_200_2011/images\197.Marsh_Wren/Marsh_Wren_0095_188371.jpg,500,332,197.Marsh_Wren,62,31,285,256,173,143,223,225
../../CUB_200_2011/images\197.Marsh_Wren/Marsh_Wren_0062_188158.jpg,500,354,197.Marsh_Wren,105,88,416,308,260,198,311,220
../../CUB_200_2011/images\197.Marsh_Wren/Marsh_Wren_0117_188676.jpg,485,500,197.Marsh_Wren,136,127,323,347,229,237,187,220
../../CUB_200_2011/images\197.Marsh_Wren/Marsh_Wren_0082_188699.jpg,500,397,197.Marsh_Wren,180,125,329,310,254,217,149,185
../../CUB_200_2011/images\197.Marsh_Wren/Marsh_Wren_0004_188188.jpg,500,377,197.Marsh_Wren,231,27,429,339,330,183,198,312
../../CUB_200_2011/images\197.Marsh_Wren/Marsh_Wren_0145_188193.jpg,386,500,197.Marsh_Wren,151,199,377,470,264,334,226,271
../../CUB_200_2011/images\197.Marsh_Wren/Marsh_Wren_0042_188195.jpg,500,442,197.Marsh_Wren,16,20,299,326,157,173,283,306
../../CUB_200_2011/images\197.Marsh_Wren/Marsh_Wren_0094_188710.jpg,500,481,197.Marsh_Wren,104,150,366,418,235,284,262,268
../../CUB_200_2011/images\197.Marsh_Wren/Marsh_Wren_0039_188201.jpg,400,500,197.Marsh_Wren,65,115,360,480,212,297,295,365
../../CUB_200_2011/images\197.Marsh_Wren/Marsh_Wren_0070_188205.jpg,500,356,197.Marsh_Wren,216,99,459,278,337,188,243,179
../../CUB_200_2011/images\197.Marsh_Wren/Marsh_Wren_0097_188214.jpg,357,500,197.Marsh_Wren,149,139,320,456,234,297,171,317
../../CUB_200_2011/images\197.Marsh_Wren/Marsh_Wren_0134_188213.jpg,500,333,197.Marsh_Wren,110,86,349,273,229,179,239,187
../../CUB_200_2011/images\197.Marsh_Wren/Marsh_Wren_0005_188235.jpg,479,500,197.Marsh_Wren,72,72,410,462,241,267,338,390
../../CUB_200_2011/images\197.Marsh_Wren/Marsh_Wren_0056_188241.jpg,500,400,197.Marsh_Wren,25,100,233,356,129,228,208,256
../../CUB_200_2011/images\197.Marsh_Wren/Marsh_Wren_0072_188764.jpg,448,500,197.Marsh_Wren,148,112,260,266,204,189,112,154
../../CUB_200_2011/images\197.Marsh_Wren/Marsh_Wren_0051_188260.jpg,500,386,197.Marsh_Wren,169,81,331,338,250,209,162,257
../../CUB_200_2011/images\197.Marsh_Wren/Marsh_Wren_0069_188776.jpg,500,333,197.Marsh_Wren,26,52,215,264,120,158,189,212
../../CUB_200_2011/images\197.Marsh_Wren/Marsh_Wren_0033_188778.jpg,500,333,197.Marsh_Wren,137,93,321,304,229,198,184,211
../../CUB_200_2011/images\197.Marsh_Wren/Marsh_Wren_0044_188270.jpg,500,337,197.Marsh_Wren,81,81,302,302,191,191,221,221
../../CUB_200_2011/images\197.Marsh_Wren/Marsh_Wren_0012_188275.jpg,379,500,197.Marsh_Wren,115,138,290,429,202,283,175,291
../../CUB_200_2011/images\197.Marsh_Wren/Marsh_Wren_0108_188788.jpg,500,333,197.Marsh_Wren,100,109,296,325,198,217,196,216
../../CUB_200_2011/images\197.Marsh_Wren/Marsh_Wren_0022_188280.jpg,500,455,197.Marsh_Wren,45,73,359,414,202,243,314,341
../../CUB_200_2011/images\197.Marsh_Wren/Marsh_Wren_0141_188796.jpg,500,375,197.Marsh_Wren,82,119,310,362,196,240,228,243
../../CUB_200_2011/images\197.Marsh_Wren/Marsh_Wren_0028_188797.jpg,500,407,197.Marsh_Wren,246,106,466,368,356,237,220,262
../../CUB_200_2011/images\197.Marsh_Wren/Marsh_Wren_0014_188802.jpg,500,375,197.Marsh_Wren,112,78,280,245,196,161,168,167
../../CUB_200_2011/images\197.Marsh_Wren/Marsh_Wren_0080_188812.jpg,400,267,197.Marsh_Wren,27,17,289,258,158,137,262,241
../../CUB_200_2011/images\197.Marsh_Wren/Marsh_Wren_0089_188318.jpg,500,395,197.Marsh_Wren,85,123,230,241,157,182,145,118
../../CUB_200_2011/images\197.Marsh_Wren/Marsh_Wren_0109_188329.jpg,500,422,197.Marsh_Wren,113,46,430,370,271,208,317,324
../../CUB_200_2011/images\197.Marsh_Wren/Marsh_Wren_0015_188852.jpg,458,500,197.Marsh_Wren,142,65,320,417,231,241,178,352
../../CUB_200_2011/images\197.Marsh_Wren/Marsh_Wren_0018_188363.jpg,500,333,197.Marsh_Wren,137,90,383,235,260,162,246,145
../../CUB_200_2011/images\197.Marsh_Wren/Marsh_Wren_0147_188367.jpg,500,333,197.Marsh_Wren,158,33,341,245,249,139,183,212
../../CUB_200_2011/images\197.Marsh_Wren/Marsh_Wren_0048_188370.jpg,500,375,197.Marsh_Wren,115,161,330,320,222,240,215,159
../../CUB_200_2011/images\197.Marsh_Wren/Marsh_Wren_0122_188323.jpg,500,332,197.Marsh_Wren,87,36,409,310,248,173,322,274
../../CUB_200_2011/images\197.Marsh_Wren/Marsh_Wren_0036_188374.jpg,357,500,197.Marsh_Wren,108,199,243,435,175,317,135,236
../../CUB_200_2011/images\197.Marsh_Wren/Marsh_Wren_0027_188376.jpg,500,333,197.Marsh_Wren,171,14,314,275,242,144,143,261
../../CUB_200_2011/images\197.Marsh_Wren/Marsh_Wren_0107_188390.jpg,500,333,197.Marsh_Wren,127,111,252,234,189,172,125,123
../../CUB_200_2011/images\197.Marsh_Wren/Marsh_Wren_0119_188404.jpg,500,375,197.Marsh_Wren,154,114,371,347,262,230,217,233
../../CUB_200_2011/images\198.Rock_Wren/Rock_Wren_0127_188931.jpg,500,338,198.Rock_Wren,182,107,304,228,243,167,122,121
../../CUB_200_2011/images\198.Rock_Wren/Rock_Wren_0043_188933.jpg,500,367,198.Rock_Wren,192,62,437,309,314,185,245,247
../../CUB_200_2011/images\198.Rock_Wren/Rock_Wren_0034_187656.jpg,500,400,198.Rock_Wren,251,132,410,243,330,187,159,111
../../CUB_200_2011/images\198.Rock_Wren/Rock_Wren_0059_188941.jpg,500,392,198.Rock_Wren,64,172,255,295,159,233,191,123
../../CUB_200_2011/images\198.Rock_Wren/Rock_Wren_0024_188942.jpg,421,500,198.Rock_Wren,47,42,392,390,219,216,345,348
../../CUB_200_2011/images\198.Rock_Wren/Rock_Wren_0086_188944.jpg,333,500,198.Rock_Wren,24,184,242,403,133,293,218,219
../../CUB_200_2011/images\198.Rock_Wren/Rock_Wren_0098_188947.jpg,500,375,198.Rock_Wren,76,82,357,350,216,216,281,268
../../CUB_200_2011/images\198.Rock_Wren/Rock_Wren_0113_189204.jpg,500,359,198.Rock_Wren,161,100,335,297,248,198,174,197
../../CUB_200_2011/images\198.Rock_Wren/Rock_Wren_0125_188951.jpg,500,333,198.Rock_Wren,165,70,432,300,298,185,267,230
../../CUB_200_2011/images\198.Rock_Wren/Rock_Wren_0073_188952.jpg,500,335,198.Rock_Wren,154,75,352,202,253,138,198,127
../../CUB_200_2011/images\198.Rock_Wren/Rock_Wren_0022_188958.jpg,500,333,198.Rock_Wren,16,19,287,257,151,138,271,238
../../CUB_200_2011/images\198.Rock_Wren/Rock_Wren_0078_188960.jpg,357,500,198.Rock_Wren,93,157,297,371,195,264,204,214
../../CUB_200_2011/images\198.Rock_Wren/Rock_Wren_0118_188964.jpg,500,333,198.Rock_Wren,116,85,358,276,237,180,242,191
../../CUB_200_2011/images\198.Rock_Wren/Rock_Wren_0096_188966.jpg,500,354,198.Rock_Wren,195,112,450,285,322,198,255,173
../../CUB_200_2011/images\198.Rock_Wren/Rock_Wren_0019_188968.jpg,500,333,198.Rock_Wren,95,122,321,310,208,216,226,188
../../CUB_200_2011/images\198.Rock_Wren/Rock_Wren_0069_188969.jpg,500,333,198.Rock_Wren,141,42,403,288,272,165,262,246
../../CUB_200_2011/images\198.Rock_Wren/Rock_Wren_0041_189227.jpg,500,334,198.Rock_Wren,100,55,431,286,265,170,331,231
../../CUB_200_2011/images\198.Rock_Wren/Rock_Wren_0121_188974.jpg,500,363,198.Rock_Wren,218,81,431,274,324,177,213,193
../../CUB_200_2011/images\198.Rock_Wren/Rock_Wren_0087_188988.jpg,500,334,198.Rock_Wren,189,81,349,230,269,155,160,149
../../CUB_200_2011/images\198.Rock_Wren/Rock_Wren_0065_188995.jpg,357,500,198.Rock_Wren,105,171,293,369,199,270,188,198
../../CUB_200_2011/images\198.Rock_Wren/Rock_Wren_0035_188998.jpg,500,365,198.Rock_Wren,73,39,392,320,232,179,319,281
../../CUB_200_2011/images\198.Rock_Wren/Rock_Wren_0025_188897.jpg,500,500,198.Rock_Wren,153,136,304,278,228,207,151,142
../../CUB_200_2011/images\198.Rock_Wren/Rock_Wren_0037_189256.jpg,500,333,198.Rock_Wren,128,74,456,327,292,200,328,253
../../CUB_200_2011/images\198.Rock_Wren/Rock_Wren_0042_189006.jpg,500,333,198.Rock_Wren,27,39,411,310,219,174,384,271
../../CUB_200_2011/images\198.Rock_Wren/Rock_Wren_0114_189283.jpg,500,333,198.Rock_Wren,79,68,342,311,210,189,263,243
../../CUB_200_2011/images\198.Rock_Wren/Rock_Wren_0027_189331.jpg,500,333,198.Rock_Wren,151,110,385,310,268,210,234,200
../../CUB_200_2011/images\198.Rock_Wren/Rock_Wren_0012_189021.jpg,426,500,198.Rock_Wren,82,62,358,421,220,241,276,359
../../CUB_200_2011/images\198.Rock_Wren/Rock_Wren_0001_189289.jpg,500,361,198.Rock_Wren,129,64,345,323,237,193,216,259
../../CUB_200_2011/images\198.Rock_Wren/Rock_Wren_0066_189034.jpg,500,387,198.Rock_Wren,230,146,442,308,336,227,212,162
../../CUB_200_2011/images\198.Rock_Wren/Rock_Wren_0094_189037.jpg,500,357,198.Rock_Wren,128,95,311,242,219,168,183,147
../../CUB_200_2011/images\198.Rock_Wren/Rock_Wren_0036_189245.jpg,500,357,198.Rock_Wren,126,88,362,347,244,217,236,259
../../CUB_200_2011/images\198.Rock_Wren/Rock_Wren_0122_189042.jpg,490,500,198.Rock_Wren,108,70,403,352,255,211,295,282
../../CUB_200_2011/images\198.Rock_Wren/Rock_Wren_0062_189045.jpg,500,333,198.Rock_Wren,139,46,325,290,232,168,186,244
../../CUB_200_2011/images\198.Rock_Wren/Rock_Wren_0004_189046.jpg,500,334,198.Rock_Wren,77,53,457,317,267,185,380,264
../../CUB_200_2011/images\198.Rock_Wren/Rock_Wren_0111_189443.jpg,500,357,198.Rock_Wren,61,128,426,273,243,200,365,145
../../CUB_200_2011/images\198.Rock_Wren/Rock_Wren_0050_189207.jpg,479,500,198.Rock_Wren,70,114,446,447,258,280,376,333
../../CUB_200_2011/images\198.Rock_Wren/Rock_Wren_0038_189328.jpg,500,357,198.Rock_Wren,289,159,436,275,362,217,147,116
../../CUB_200_2011/images\198.Rock_Wren/Rock_Wren_0023_189075.jpg,500,333,198.Rock_Wren,249,141,468,290,358,215,219,149
../../CUB_200_2011/images\198.Rock_Wren/Rock_Wren_0080_189340.jpg,500,375,198.Rock_Wren,262,63,434,237,348,150,172,174
../../CUB_200_2011/images\198.Rock_Wren/Rock_Wren_0109_189094.jpg,500,402,198.Rock_Wren,219,65,429,354,324,209,210,289
../../CUB_200_2011/images\198.Rock_Wren/Rock_Wren_0116_189101.jpg,500,455,198.Rock_Wren,128,84,360,331,244,207,232,247
../../CUB_200_2011/images\198.Rock_Wren/Rock_Wren_0071_189213.jpg,500,473,198.Rock_Wren,148,135,341,375,244,255,193,240
../../CUB_200_2011/images\198.Rock_Wren/Rock_Wren_0053_189112.jpg,500,439,198.Rock_Wren,173,147,390,263,281,205,217,116
../../CUB_200_2011/images\198.Rock_Wren/Rock_Wren_0063_189121.jpg,500,344,198.Rock_Wren,181,79,439,276,310,177,258,197
../../CUB_200_2011/images\198.Rock_Wren/Rock_Wren_0044_189127.jpg,500,333,198.Rock_Wren,57,28,310,313,183,170,253,285
../../CUB_200_2011/images\198.Rock_Wren/Rock_Wren_0058_189346.jpg,500,375,198.Rock_Wren,168,105,445,272,306,188,277,167
../../CUB_200_2011/images\198.Rock_Wren/Rock_Wren_0076_189141.jpg,500,414,198.Rock_Wren,208,124,396,328,302,226,188,204
../../CUB_200_2011/images\198.Rock_Wren/Rock_Wren_0029_189145.jpg,500,335,198.Rock_Wren,175,72,364,323,269,197,189,251
../../CUB_200_2011/images\198.Rock_Wren/Rock_Wren_0123_189405.jpg,500,333,198.Rock_Wren,176,101,398,300,287,200,222,199
../../CUB_200_2011/images\198.Rock_Wren/Rock_Wren_0020_188895.jpg,500,375,198.Rock_Wren,95,91,263,281,179,186,168,190
../../CUB_200_2011/images\198.Rock_Wren/Rock_Wren_0067_189152.jpg,500,370,198.Rock_Wren,113,81,250,208,181,144,137,127
../../CUB_200_2011/images\198.Rock_Wren/Rock_Wren_0045_189153.jpg,500,350,198.Rock_Wren,127,46,391,289,259,167,264,243
../../CUB_200_2011/images\198.Rock_Wren/Rock_Wren_0040_189159.jpg,500,374,198.Rock_Wren,112,129,258,269,185,199,146,140
../../CUB_200_2011/images\198.Rock_Wren/Rock_Wren_0104_189161.jpg,500,383,198.Rock_Wren,159,108,297,292,228,200,138,184
../../CUB_200_2011/images\198.Rock_Wren/Rock_Wren_0009_189162.jpg,437,500,198.Rock_Wren,132,203,289,361,210,282,157,158
../../CUB_200_2011/images\198.Rock_Wren/Rock_Wren_0003_189167.jpg,500,333,198.Rock_Wren,70,67,341,291,205,179,271,224
../../CUB_200_2011/images\198.Rock_Wren/Rock_Wren_0100_189426.jpg,500,325,198.Rock_Wren,136,91,347,225,241,158,211,134
../../CUB_200_2011/images\198.Rock_Wren/Rock_Wren_0021_189175.jpg,500,452,198.Rock_Wren,84,82,354,318,219,200,270,236
../../CUB_200_2011/images\198.Rock_Wren/Rock_Wren_0026_189181.jpg,445,500,198.Rock_Wren,21,95,275,338,148,216,254,243
../../CUB_200_2011/images\198.Rock_Wren/Rock_Wren_0033_189397.jpg,500,333,198.Rock_Wren,81,71,315,283,198,177,234,212
../../CUB_200_2011/images\199.Winter_Wren/Winter_Wren_0095_189985.jpg,500,357,199.Winter_Wren,54,33,371,257,212,145,317,224
../../CUB_200_2011/images\199.Winter_Wren/Winter_Wren_0122_189475.jpg,500,357,199.Winter_Wren,250,196,456,320,353,258,206,124
../../CUB_200_2011/images\199.Winter_Wren/Winter_Wren_0117_189999.jpg,500,375,199.Winter_Wren,126,73,376,341,251,207,250,268
../../CUB_200_2011/images\199.Winter_Wren/Winter_Wren_0013_189500.jpg,500,331,199.Winter_Wren,277,96,475,237,376,166,198,141
../../CUB_200_2011/images\199.Winter_Wren/Winter_Wren_0062_189501.jpg,500,333,199.Winter_Wren,166,16,397,308,281,162,231,292
../../CUB_200_2011/images\199.Winter_Wren/Winter_Wren_0049_189504.jpg,500,375,199.Winter_Wren,164,86,304,298,234,192,140,212
../../CUB_200_2011/images\199.Winter_Wren/Winter_Wren_0112_189507.jpg,350,500,199.Winter_Wren,78,76,294,350,186,213,216,274
../../CUB_200_2011/images\199.Winter_Wren/Winter_Wren_0056_189508.jpg,500,335,199.Winter_Wren,257,114,409,260,333,187,152,146
../../CUB_200_2011/images\199.Winter_Wren/Winter_Wren_0103_189509.jpg,500,333,199.Winter_Wren,30,6,446,330,238,168,416,324
../../CUB_200_2011/images\199.Winter_Wren/Winter_Wren_0038_189510.jpg,500,359,199.Winter_Wren,207,72,468,317,337,194,261,245
../../CUB_200_2011/images\199.Winter_Wren/Winter_Wren_0083_190025.jpg,500,368,199.Winter_Wren,150,124,399,290,274,207,249,166
../../CUB_200_2011/images\199.Winter_Wren/Winter_Wren_0050_189514.jpg,500,333,199.Winter_Wren,208,24,449,276,328,150,241,252
../../CUB_200_2011/images\199.Winter_Wren/Winter_Wren_0072_189521.jpg,500,373,199.Winter_Wren,64,77,337,310,200,193,273,233
../../CUB_200_2011/images\199.Winter_Wren/Winter_Wren_0130_189531.jpg,500,347,199.Winter_Wren,69,27,476,325,272,176,407,298
../../CUB_200_2011/images\199.Winter_Wren/Winter_Wren_0073_190044.jpg,500,333,199.Winter_Wren,100,5,355,309,227,157,255,304
../../CUB_200_2011/images\199.Winter_Wren/Winter_Wren_0019_189533.jpg,500,371,199.Winter_Wren,153,82,433,323,293,202,280,241
../../CUB_200_2011/images\199.Winter_Wren/Winter_Wren_0081_190049.jpg,500,332,199.Winter_Wren,96,105,348,297,222,201,252,192
../../CUB_200_2011/images\199.Winter_Wren/Winter_Wren_0007_190052.jpg,500,500,199.Winter_Wren,119,148,318,367,218,257,199,219
../../CUB_200_2011/images\199.Winter_Wren/Winter_Wren_0063_189543.jpg,500,335,199.Winter_Wren,294,90,412,192,353,141,118,102
../../CUB_200_2011/images\199.Winter_Wren/Winter_Wren_0119_189545.jpg,500,333,199.Winter_Wren,84,73,282,286,183,179,198,213
../../CUB_200_2011/images\199.Winter_Wren/Winter_Wren_0082_189549.jpg,500,400,199.Winter_Wren,83,51,420,339,251,195,337,288
../../CUB_200_2011/images\199.Winter_Wren/Winter_Wren_0044_190068.jpg,500,255,199.Winter_Wren,143,48,335,208,239,128,192,160
../../CUB_200_2011/images\199.Winter_Wren/Winter_Wren_0113_189558.jpg,500,333,199.Winter_Wren,185,32,393,290,289,161,208,258
../../CUB_200_2011/images\199.Winter_Wren/Winter_Wren_0102_189563.jpg,500,382,199.Winter_Wren,132,125,250,244,191,184,118,119
../../CUB_200_2011/images\199.Winter_Wren/Winter_Wren_0110_189569.jpg,500,403,199.Winter_Wren,109,44,462,368,285,206,353,324
../../CUB_200_2011/images\199.Winter_Wren/Winter_Wren_0075_189578.jpg,500,375,199.Winter_Wren,101,116,333,362,217,239,232,246
../../CUB_200_2011/images\199.Winter_Wren/Winter_Wren_0127_190091.jpg,500,325,199.Winter_Wren,228,85,460,294,344,189,232,209
../../CUB_200_2011/images\199.Winter_Wren/Winter_Wren_0128_190093.jpg,335,500,199.Winter_Wren,82,234,204,386,143,310,122,152
../../CUB_200_2011/images\199.Winter_Wren/Winter_Wren_0131_190061.jpg,500,333,199.Winter_Wren,107,69,425,296,266,182,318,227
../../CUB_200_2011/images\199.Winter_Wren/Winter_Wren_0015_190099.jpg,500,333,199.Winter_Wren,270,88,437,291,353,189,167,203
../../CUB_200_2011/images\199.Winter_Wren/Winter_Wren_0090_190104.jpg,500,335,199.Winter_Wren,185,66,409,269,297,167,224,203
../../CUB_200_2011/images\199.Winter_Wren/Winter_Wren_0111_189596.jpg,500,344,199.Winter_Wren,180,62,426,275,303,168,246,213
../../CUB_200_2011/images\199.Winter_Wren/Winter_Wren_0021_189597.jpg,500,333,199.Winter_Wren,102,57,396,249,249,153,294,192
../../CUB_200_2011/images\199.Winter_Wren/Winter_Wren_0037_190123.jpg,500,398,199.Winter_Wren,175,99,385,317,280,208,210,218
../../CUB_200_2011/images\199.Winter_Wren/Winter_Wren_0087_190135.jpg,500,375,199.Winter_Wren,54,42,338,328,196,185,284,286
../../CUB_200_2011/images\199.Winter_Wren/Winter_Wren_0097_190139.jpg,500,387,199.Winter_Wren,135,90,347,344,241,217,212,254
../../CUB_200_2011/images\199.Winter_Wren/Winter_Wren_0033_189635.jpg,500,334,199.Winter_Wren,208,77,418,258,313,167,210,181
../../CUB_200_2011/images\199.Winter_Wren/Winter_Wren_0066_189637.jpg,500,474,199.Winter_Wren,178,85,323,228,250,156,145,143
../../CUB_200_2011/images\199.Winter_Wren/Winter_Wren_0141_190152.jpg,500,464,199.Winter_Wren,141,124,427,374,284,249,286,250
../../CUB_200_2011/images\199.Winter_Wren/Winter_Wren_0051_189990.jpg,500,333,199.Winter_Wren,235,103,387,278,311,190,152,175
../../CUB_200_2011/images\199.Winter_Wren/Winter_Wren_0004_189670.jpg,500,332,199.Winter_Wren,243,82,483,301,363,191,240,219
../../CUB_200_2011/images\199.Winter_Wren/Winter_Wren_0065_189675.jpg,500,317,199.Winter_Wren,139,70,354,237,246,153,215,167
../../CUB_200_2011/images\199.Winter_Wren/Winter_Wren_0048_189683.jpg,500,405,199.Winter_Wren,110,107,426,330,268,218,316,223
../../CUB_200_2011/images\199.Winter_Wren/Winter_Wren_0093_189686.jpg,500,337,199.Winter_Wren,138,57,469,336,303,196,331,279
../../CUB_200_2011/images\199.Winter_Wren/Winter_Wren_0071_189689.jpg,500,337,199.Winter_Wren,258,64,440,267,349,165,182,203
../../CUB_200_2011/images\199.Winter_Wren/Winter_Wren_0086_189692.jpg,500,333,199.Winter_Wren,63,40,424,314,243,177,361,274
../../CUB_200_2011/images\199.Winter_Wren/Winter_Wren_0005_189750.jpg,500,375,199.Winter_Wren,52,80,294,302,173,191,242,222
../../CUB_200_2011/images\199.Winter_Wren/Winter_Wren_0030_190311.jpg,500,375,199.Winter_Wren,122,31,479,311,300,171,357,280
../../CUB_200_2011/images\199.Winter_Wren/Winter_Wren_0026_189816.jpg,500,356,199.Winter_Wren,36,30,314,330,175,180,278,300
../../CUB_200_2011/images\199.Winter_Wren/Winter_Wren_0126_190342.jpg,386,500,199.Winter_Wren,118,131,295,279,206,205,177,148
../../CUB_200_2011/images\199.Winter_Wren/Winter_Wren_0116_189834.jpg,500,334,199.Winter_Wren,70,120,238,270,154,195,168,150
../../CUB_200_2011/images\199.Winter_Wren/Winter_Wren_0003_189838.jpg,500,333,199.Winter_Wren,76,108,275,306,175,207,199,198
../../CUB_200_2011/images\199.Winter_Wren/Winter_Wren_0129_189843.jpg,500,436,199.Winter_Wren,110,107,387,299,248,203,277,192
../../CUB_200_2011/images\199.Winter_Wren/Winter_Wren_0109_189850.jpg,500,500,199.Winter_Wren,116,123,329,368,222,245,213,245
../../CUB_200_2011/images\199.Winter_Wren/Winter_Wren_0132_189861.jpg,500,333,199.Winter_Wren,127,29,292,293,209,161,165,264
../../CUB_200_2011/images\199.Winter_Wren/Winter_Wren_0029_190376.jpg,355,500,199.Winter_Wren,46,61,286,347,166,204,240,286
../../CUB_200_2011/images\199.Winter_Wren/Winter_Wren_0142_190379.jpg,500,333,199.Winter_Wren,190,104,333,232,261,168,143,128
../../CUB_200_2011/images\199.Winter_Wren/Winter_Wren_0077_190366.jpg,500,352,199.Winter_Wren,223,92,377,270,300,181,154,178
../../CUB_200_2011/images\199.Winter_Wren/Winter_Wren_0047_190390.jpg,432,500,199.Winter_Wren,109,139,359,368,234,253,250,229
../../CUB_200_2011/images\199.Winter_Wren/Winter_Wren_0118_189805.jpg,500,500,199.Winter_Wren,99,126,406,417,252,271,307,291
../../CUB_200_2011/images\200.Common_Yellowthroat/Common_Yellowthroat_0020_190720.jpg,414,500,200.Common_Yellowthroat,129,58,373,457,251,257,244,399
../../CUB_200_2011/images\200.Common_Yellowthroat/Common_Yellowthroat_0016_190986.jpg,397,500,200.Common_Yellowthroat,104,170,247,398,175,284,143,228
../../CUB_200_2011/images\200.Common_Yellowthroat/Common_Yellowthroat_0077_190990.jpg,500,383,200.Common_Yellowthroat,49,80,427,349,238,214,378,269
../../CUB_200_2011/images\200.Common_Yellowthroat/Common_Yellowthroat_0104_190489.jpg,419,500,200.Common_Yellowthroat,75,57,362,428,218,242,287,371
../../CUB_200_2011/images\200.Common_Yellowthroat/Common_Yellowthroat_0114_190501.jpg,465,500,200.Common_Yellowthroat,132,153,303,341,217,247,171,188
../../CUB_200_2011/images\200.Common_Yellowthroat/Common_Yellowthroat_0090_190503.jpg,500,333,200.Common_Yellowthroat,206,40,345,249,275,144,139,209
../../CUB_200_2011/images\200.Common_Yellowthroat/Common_Yellowthroat_0039_190513.jpg,500,388,200.Common_Yellowthroat,113,101,488,333,300,217,375,232
../../CUB_200_2011/images\200.Common_Yellowthroat/Common_Yellowthroat_0003_190521.jpg,500,369,200.Common_Yellowthroat,155,101,476,343,315,222,321,242
../../CUB_200_2011/images\200.Common_Yellowthroat/Common_Yellowthroat_0019_190524.jpg,500,373,200.Common_Yellowthroat,190,123,356,344,273,233,166,221
../../CUB_200_2011/images\200.Common_Yellowthroat/Common_Yellowthroat_0081_190525.jpg,500,400,200.Common_Yellowthroat,221,89,454,344,337,216,233,255
../../CUB_200_2011/images\200.Common_Yellowthroat/Common_Yellowthroat_0028_190527.jpg,500,493,200.Common_Yellowthroat,125,71,363,444,244,257,238,373
../../CUB_200_2011/images\200.Common_Yellowthroat/Common_Yellowthroat_0099_190531.jpg,500,395,200.Common_Yellowthroat,242,128,429,239,335,183,187,111
../../CUB_200_2011/images\200.Common_Yellowthroat/Common_Yellowthroat_0125_190902.jpg,500,400,200.Common_Yellowthroat,59,104,457,347,258,225,398,243
../../CUB_200_2011/images\200.Common_Yellowthroat/Common_Yellowthroat_0050_190535.jpg,500,416,200.Common_Yellowthroat,139,73,476,355,307,214,337,282
../../CUB_200_2011/images\200.Common_Yellowthroat/Common_Yellowthroat_0106_190989.jpg,500,334,200.Common_Yellowthroat,131,82,307,280,219,181,176,198
../../CUB_200_2011/images\200.Common_Yellowthroat/Common_Yellowthroat_0025_190547.jpg,500,375,200.Common_Yellowthroat,143,107,327,271,235,189,184,164
../../CUB_200_2011/images\200.Common_Yellowthroat/Common_Yellowthroat_0118_190805.jpg,500,333,200.Common_Yellowthroat,70,86,279,272,174,179,209,186
../../CUB_200_2011/images\200.Common_Yellowthroat/Common_Yellowthroat_0015_190556.jpg,500,335,200.Common_Yellowthroat,190,74,363,258,276,166,173,184
../../CUB_200_2011/images\200.Common_Yellowthroat/Common_Yellowthroat_0045_190563.jpg,500,332,200.Common_Yellowthroat,77,66,408,331,242,198,331,265
../../CUB_200_2011/images\200.Common_Yellowthroat/Common_Yellowthroat_0035_190567.jpg,500,407,200.Common_Yellowthroat,62,94,396,353,229,223,334,259
../../CUB_200_2011/images\200.Common_Yellowthroat/Common_Yellowthroat_0111_190569.jpg,500,332,200.Common_Yellowthroat,90,6,497,273,293,139,407,267
../../CUB_200_2011/images\200.Common_Yellowthroat/Common_Yellowthroat_0122_190570.jpg,357,500,200.Common_Yellowthroat,22,190,227,438,124,314,205,248
../../CUB_200_2011/images\200.Common_Yellowthroat/Common_Yellowthroat_0112_190571.jpg,500,385,200.Common_Yellowthroat,95,51,293,336,194,193,198,285
../../CUB_200_2011/images\200.Common_Yellowthroat/Common_Yellowthroat_0010_190572.jpg,500,338,200.Common_Yellowthroat,142,57,357,278,249,167,215,221
../../CUB_200_2011/images\200.Common_Yellowthroat/Common_Yellowthroat_0092_190573.jpg,375,500,200.Common_Yellowthroat,88,123,352,371,220,247,264,248
../../CUB_200_2011/images\200.Common_Yellowthroat/Common_Yellowthroat_0006_190576.jpg,500,389,200.Common_Yellowthroat,187,113,388,294,287,203,201,181
../../CUB_200_2011/images\200.Common_Yellowthroat/Common_Yellowthroat_0009_190578.jpg,500,309,200.Common_Yellowthroat,8,51,388,278,198,164,380,227
../../CUB_200_2011/images\200.Common_Yellowthroat/Common_Yellowthroat_0031_190582.jpg,500,332,200.Common_Yellowthroat,276,66,400,263,338,164,124,197
../../CUB_200_2011/images\200.Common_Yellowthroat/Common_Yellowthroat_0059_190584.jpg,500,340,200.Common_Yellowthroat,227,54,342,255,284,154,115,201
../../CUB_200_2011/images\200.Common_Yellowthroat/Common_Yellowthroat_0032_190592.jpg,500,333,200.Common_Yellowthroat,146,84,434,297,290,190,288,213
../../CUB_200_2011/images\200.Common_Yellowthroat/Common_Yellowthroat_0088_190594.jpg,500,375,200.Common_Yellowthroat,36,40,462,374,249,207,426,334
../../CUB_200_2011/images\200.Common_Yellowthroat/Common_Yellowthroat_0121_190597.jpg,500,361,200.Common_Yellowthroat,39,99,352,305,195,202,313,206
../../CUB_200_2011/images\200.Common_Yellowthroat/Common_Yellowthroat_0046_190446.jpg,500,334,200.Common_Yellowthroat,127,51,404,308,265,179,277,257
../../CUB_200_2011/images\200.Common_Yellowthroat/Common_Yellowthroat_0004_190606.jpg,500,398,200.Common_Yellowthroat,149,159,367,273,258,216,218,114
../../CUB_200_2011/images\200.Common_Yellowthroat/Common_Yellowthroat_0093_190609.jpg,500,400,200.Common_Yellowthroat,51,111,375,332,213,221,324,221
../../CUB_200_2011/images\200.Common_Yellowthroat/Common_Yellowthroat_0027_190869.jpg,500,386,200.Common_Yellowthroat,203,138,401,292,302,215,198,154
../../CUB_200_2011/images\200.Common_Yellowthroat/Common_Yellowthroat_0126_190407.jpg,500,333,200.Common_Yellowthroat,49,27,367,268,208,147,318,241
../../CUB_200_2011/images\200.Common_Yellowthroat/Common_Yellowthroat_0086_190639.jpg,500,334,200.Common_Yellowthroat,40,70,282,268,161,169,242,198
../../CUB_200_2011/images\200.Common_Yellowthroat/Common_Yellowthroat_0075_190900.jpg,500,333,200.Common_Yellowthroat,177,18,378,281,277,149,201,263
../../CUB_200_2011/images\200.Common_Yellowthroat/Common_Yellowthroat_0066_190646.jpg,500,333,200.Common_Yellowthroat,192,66,412,258,302,162,220,192
../../CUB_200_2011/images\200.Common_Yellowthroat/Common_Yellowthroat_0018_190904.jpg,500,389,200.Common_Yellowthroat,100,115,318,246,209,180,218,131
../../CUB_200_2011/images\200.Common_Yellowthroat/Common_Yellowthroat_0054_190398.jpg,334,500,200.Common_Yellowthroat,71,37,242,249,156,143,171,212
../../CUB_200_2011/images\200.Common_Yellowthroat/Common_Yellowthroat_0021_190655.jpg,500,281,200.Common_Yellowthroat,168,107,413,254,290,180,245,147
../../CUB_200_2011/images\200.Common_Yellowthroat/Common_Yellowthroat_0069_190400.jpg,500,500,200.Common_Yellowthroat,272,72,427,460,349,266,155,388
../../CUB_200_2011/images\200.Common_Yellowthroat/Common_Yellowthroat_0011_190401.jpg,400,500,200.Common_Yellowthroat,59,48,247,420,153,234,188,372
../../CUB_200_2011/images\200.Common_Yellowthroat/Common_Yellowthroat_0072_190402.jpg,500,375,200.Common_Yellowthroat,95,17,410,367,252,192,315,350
../../CUB_200_2011/images\200.Common_Yellowthroat/Common_Yellowthroat_0029_190403.jpg,500,333,200.Common_Yellowthroat,59,85,344,245,201,165,285,160
../../CUB_200_2011/images\200.Common_Yellowthroat/Common_Yellowthroat_0080_190663.jpg,500,333,200.Common_Yellowthroat,11,89,394,260,202,174,383,171
../../CUB_200_2011/images\200.Common_Yellowthroat/Common_Yellowthroat_0071_190665.jpg,414,500,200.Common_Yellowthroat,121,168,405,316,263,242,284,148
../../CUB_200_2011/images\200.Common_Yellowthroat/Common_Yellowthroat_0087_190414.jpg,400,500,200.Common_Yellowthroat,35,115,325,312,180,213,290,197
../../CUB_200_2011/images\200.Common_Yellowthroat/Common_Yellowthroat_0070_190678.jpg,400,500,200.Common_Yellowthroat,211,79,340,358,275,218,129,279
../../CUB_200_2011/images\200.Common_Yellowthroat/Common_Yellowthroat_0040_190427.jpg,500,400,200.Common_Yellowthroat,44,114,313,344,178,229,269,230
../../CUB_200_2011/images\200.Common_Yellowthroat/Common_Yellowthroat_0098_190430.jpg,483,500,200.Common_Yellowthroat,41,33,420,459,230,246,379,426
../../CUB_200_2011/images\200.Common_Yellowthroat/Common_Yellowthroat_0094_190690.jpg,500,333,200.Common_Yellowthroat,140,125,284,297,212,211,144,172
../../CUB_200_2011/images\200.Common_Yellowthroat/Common_Yellowthroat_0063_190440.jpg,500,333,200.Common_Yellowthroat,96,71,339,287,217,179,243,216
../../CUB_200_2011/images\200.Common_Yellowthroat/Common_Yellowthroat_0037_190698.jpg,469,407,200.Common_Yellowthroat,89,95,443,345,266,220,354,250
../../CUB_200_2011/images\200.Common_Yellowthroat/Common_Yellowthroat_0058_190958.jpg,500,333,200.Common_Yellowthroat,157,62,341,281,249,171,184,219
../../CUB_200_2011/images\200.Common_Yellowthroat/Common_Yellowthroat_0008_190703.jpg,500,379,200.Common_Yellowthroat,190,102,388,304,289,203,198,202
../../CUB_200_2011/images\200.Common_Yellowthroat/Common_Yellowthroat_0049_190708.jpg,500,333,200.Common_Yellowthroat,3,20,411,327,207,173,408,307
../../CUB_200_2011/images\200.Common_Yellowthroat/Common_Yellowthroat_0055_190967.jpg,357,500,200.Common_Yellowthroat,20,113,197,376,108,244,177,263
